position	chr	start	end	length	nick_coordinates
chr1:74897-76697	chr1	74897	76697	1800	75150
chr1:440935-447357	chr1	440935	447357	6422	444812
chr1:675911-682333	chr1	675911	682333	6422	679788
chr1:11164354-11167257	chr1	11164354	11167257	2903	11164669
chr1:12907697-12910276	chr1	12907697	12910276	2579	12908791
chr1:13187504-13190819	chr1	13187504	13190819	3315	13188236
chr1:13333268-13336570	chr1	13333268	13336570	3302	13334003
chr1:13999377-14000782	chr1	13999377	14000782	1405	14000123
chr1:25058186-25061055	chr1	25058186	25061055	2869	25058487
chr1:25506585-25512707	chr1	25506585	25512707	6122	25510127
chr1:30438491-30444125	chr1	30438491	30444125	5634	30441534
chr1:30493389-30499556	chr1	30493389	30499556	6167	30496969
chr1:33671997-33678118	chr1	33671997	33678118	6121	33675532
chr1:33829520-33835665	chr1	33829520	33835665	6145	33833075
chr1:34092394-34098413	chr1	34092394	34098413	6019	34095834
chr1:34250741-34256767	chr1	34250741	34256767	6026	34254180
chr1:34955161-34957849	chr1	34955161	34957849	2688	34955229
chr1:37208029-37213389	chr1	37208029	37213389	5360	37210983
chr1:38768417-38771351	chr1	38768417	38771351	2934	38768762
chr1:40365613-40370869	chr1	40365613	40370869	5256	40368277
chr1:41133321-41134597	chr1	41133321	41134597	1276	41133857
chr1:41176264-41182362	chr1	41176264	41182362	6098	41179788
chr1:41208441-41210813	chr1	41208441	41210813	2372	41209290
chr1:41966780-41970695	chr1	41966780	41970695	3915	41968122
chr1:41990365-41994163	chr1	41990365	41994163	3798	41991572
chr1:45098521-45102052	chr1	45098521	45102052	3531	45099473
chr1:45162354-45168482	chr1	45162354	45168482	6128	45165891
chr1:45182438-45186414	chr1	45182438	45186414	3976	45183823
chr1:45284565-45290711	chr1	45284565	45290711	6146	45288125
chr1:46014596-46017900	chr1	46014596	46017900	3304	46015749
chr1:46731576-46734655	chr1	46731576	46734655	3079	46732094
chr1:46846137-46850891	chr1	46846137	46850891	4754	46849742
chr1:46879344-46882220	chr1	46879344	46882220	2876	46879639
chr1:46975973-46982143	chr1	46975973	46982143	6170	46979550
chr1:46985352-46991053	chr1	46985352	46991053	5701	46988459
chr1:47006446-47012568	chr1	47006446	47012568	6122	47009985
chr1:47153053-47158095	chr1	47153053	47158095	5042	47156622
chr1:47165924-47172061	chr1	47165924	47172061	6137	47169476
chr1:47956240-47962375	chr1	47956240	47962375	6135	47959786
chr1:48150125-48156157	chr1	48150125	48156157	6032	48153565
chr1:48277194-48283343	chr1	48277194	48283343	6149	48280757
chr1:48311588-48317689	chr1	48311588	48317689	6101	48315116
chr1:49006012-49012044	chr1	49006012	49012044	6032	49009452
chr1:49257808-49263310	chr1	49257808	49263310	5502	49260732
chr1:49618378-49620602	chr1	49618378	49620602	2224	49618541
chr1:49656160-49659021	chr1	49656160	49659021	2861	49656430
chr1:49737846-49744064	chr1	49737846	49744064	6218	49741475
chr1:49915108-49921256	chr1	49915108	49921256	6148	49918660
chr1:49934841-49940864	chr1	49934841	49940864	6023	49938420
chr1:50360654-50365607	chr1	50360654	50365607	4953	50362996
chr1:50760095-50762948	chr1	50760095	50762948	2853	50761262
chr1:51386447-51391454	chr1	51386447	51391454	5007	51388892
chr1:53004662-53010782	chr1	53004662	53010782	6120	53008203
chr1:55113127-55115236	chr1	55113127	55115236	2109	55113456
chr1:55430256-55436824	chr1	55430256	55436824	6568	55432913
chr1:55459380-55462272	chr1	55459380	55462272	2892	55459686
chr1:55763036-55766057	chr1	55763036	55766057	3021	55763470
chr1:56271000-56274836	chr1	56271000	56274836	3836	56272244
chr1:56365452-56369282	chr1	56365452	56369282	3830	56366690
chr1:56610383-56614148	chr1	56610383	56614148	3765	56611585
chr1:57563313-57568976	chr1	57563313	57568976	5663	57566850
chr1:58491106-58495424	chr1	58491106	58495424	4318	58492840
chr1:58958128-58964283	chr1	58958128	58964283	6155	58961692
chr1:59250823-59256962	chr1	59250823	59256962	6139	59254374
chr1:59368923-59375078	chr1	59368923	59375078	6155	59372483
chr1:59532995-59539008	chr1	59532995	59539008	6013	59536403
chr1:59584001-59586670	chr1	59584001	59586670	2669	59584088
chr1:59586803-59592948	chr1	59586803	59592948	6145	59590362
chr1:59610536-59616642	chr1	59610536	59616642	6106	59614072
chr1:60380609-60382800	chr1	60380609	60382800	2191	60381990
chr1:60437174-60440692	chr1	60437174	60440692	3518	60438108
chr1:60490132-60496149	chr1	60490132	60496149	6017	60493558
chr1:60511790-60514443	chr1	60511790	60514443	2653	60512719
chr1:60640012-60646037	chr1	60640012	60646037	6025	60643445
chr1:60778680-60782971	chr1	60778680	60782971	4291	60780397
chr1:63240555-63242477	chr1	63240555	63242477	1922	63240699
chr1:64273426-64279586	chr1	64273426	64279586	6160	64276995
chr1:65651682-65658083	chr1	65651682	65658083	6401	65655531
chr1:66480923-66486952	chr1	66480923	66486952	6029	66484360
chr1:66780142-66786326	chr1	66780142	66786326	6184	66783735
chr1:68893582-68896207	chr1	68893582	68896207	2625	68893642
chr1:68923486-68926929	chr1	68923486	68926929	3443	68926926
chr1:68997421-68998786	chr1	68997421	68998786	1365	68998006
chr1:69417534-69419427	chr1	69417534	69419427	1893	69419050
chr1:69445535-69448452	chr1	69445535	69448452	2917	69445881
chr1:69856212-69858412	chr1	69856212	69858412	2200	69856687
chr1:70098248-70099568	chr1	70098248	70099568	1320	70098895
chr1:70471505-70475001	chr1	70471505	70475001	3496	70472402
chr1:71109039-71112365	chr1	71109039	71112365	3326	71109777
chr1:71122338-71125014	chr1	71122338	71125014	2676	71122428
chr1:71149706-71152449	chr1	71149706	71152449	2743	71149855
chr1:71215919-71221356	chr1	71215919	71221356	5437	71218742
chr1:71513698-71519742	chr1	71513698	71519742	6044	71517150
chr1:71888203-71894235	chr1	71888203	71894235	6032	71891643
chr1:72213654-72216365	chr1	72213654	72216365	2711	72213790
chr1:72390035-72391898	chr1	72390035	72391898	1863	72391462
chr1:72815279-72815521	chr1	72815279	72815521	242	72815360
chr1:72830446-72836616	chr1	72830446	72836616	6170	72834052
chr1:72900782-72905092	chr1	72900782	72905092	4310	72902506
chr1:73102204-73104789	chr1	73102204	73104789	2585	73103769
chr1:73431081-73431475	chr1	73431081	73431475	394	73431207
chr1:73619298-73621164	chr1	73619298	73621164	1866	73620858
chr1:74097120-74102071	chr1	74097120	74102071	4951	74099480
chr1:74130755-74133873	chr1	74130755	74133873	3118	74131299
chr1:74442729-74445205	chr1	74442729	74445205	2476	74443583
chr1:74554017-74558575	chr1	74554017	74558575	4558	74555993
chr1:74877120-74883155	chr1	74877120	74883155	6035	74880563
chr1:74986518-74992624	chr1	74986518	74992624	6106	74990045
chr1:75383477-75388208	chr1	75383477	75388208	4731	75385632
chr1:75402384-75408862	chr1	75402384	75408862	6478	75406286
chr1:75476261-75482430	chr1	75476261	75482430	6169	75479825
chr1:75666262-75667599	chr1	75666262	75667599	1337	75666513
chr1:75677750-75683758	chr1	75677750	75683758	6008	75681186
chr1:75697639-75703674	chr1	75697639	75703674	6035	75701081
chr1:75777591-75782997	chr1	75777591	75782997	5406	75781159
chr1:75828831-75834934	chr1	75828831	75834934	6103	75832359
chr1:76536663-76540492	chr1	76536663	76540492	3829	76537943
chr1:76738636-76739653	chr1	76738636	76739653	1017	76739651
chr1:77109002-77111770	chr1	77109002	77111770	2768	77109183
chr1:77745607-77746897	chr1	77745607	77746897	1290	77746452
chr1:78161479-78164098	chr1	78161479	78164098	2619	78161526
chr1:78344182-78345304	chr1	78344182	78345304	1122	78344561
chr1:78483572-78489062	chr1	78483572	78489062	5490	78487401
chr1:79414188-79420301	chr1	79414188	79420301	6113	79417711
chr1:79999288-80002427	chr1	79999288	80002427	3139	79999841
chr1:80333819-80335677	chr1	80333819	80335677	1858	80335566
chr1:80406795-80410258	chr1	80406795	80410258	3463	80407661
chr1:80732822-80736238	chr1	80732822	80736238	3416	80733651
chr1:80785627-80789665	chr1	80785627	80789665	4038	80787082
chr1:80946147-80951553	chr1	80946147	80951553	5406	80948962
chr1:82250044-82256069	chr1	82250044	82256069	6025	82253482
chr1:83167420-83173581	chr1	83167420	83173581	6161	83170994
chr1:83182174-83188201	chr1	83182174	83188201	6027	83185612
chr1:83263607-83269631	chr1	83263607	83269631	6024	83267040
chr1:83341258-83341957	chr1	83341258	83341957	699	83341597
chr1:84591914-84592667	chr1	84591914	84592667	753	84592442
chr1:85508351-85514542	chr1	85508351	85514542	6191	85511923
chr1:85641866-85648024	chr1	85641866	85648024	6158	85645423
chr1:85748519-85754548	chr1	85748519	85754548	6029	85751958
chr1:85869317-85873838	chr1	85869317	85873838	4521	85871271
chr1:85921432-85926818	chr1	85921432	85926818	5386	85924244
chr1:85927067-85933100	chr1	85927067	85933100	6033	85930508
chr1:86242534-86245288	chr1	86242534	86245288	2754	86242703
chr1:86330246-86334976	chr1	86330246	86334976	4730	86332387
chr1:86657442-86663611	chr1	86657442	86663611	6169	86661023
chr1:86817814-86820482	chr1	86817814	86820482	2668	86817893
chr1:88341842-88347867	chr1	88341842	88347867	6025	88345279
chr1:88584950-88588781	chr1	88584950	88588781	3831	88586233
chr1:88816885-88817333	chr1	88816885	88817333	448	88816973
chr1:89071603-89077988	chr1	89071603	89077988	6385	89075411
chr1:89154817-89160368	chr1	89154817	89160368	5551	89157782
chr1:89244954-89248158	chr1	89244954	89248158	3204	89246723
chr1:89328275-89331595	chr1	89328275	89331595	3320	89329008
chr1:89353251-89353965	chr1	89353251	89353965	714	89353622
chr1:89371198-89373819	chr1	89371198	89373819	2621	89371234
chr1:89490988-89497136	chr1	89490988	89497136	6148	89494541
chr1:90166845-90172987	chr1	90166845	90172987	6142	90170402
chr1:90247584-90252823	chr1	90247584	90252823	5239	90250562
chr1:90553372-90557318	chr1	90553372	90557318	3946	90554674
chr1:90598133-90601997	chr1	90598133	90601997	3864	90599425
chr1:90997570-91003696	chr1	90997570	91003696	6126	91001109
chr1:91211587-91216947	chr1	91211587	91216947	5360	91214355
chr1:91289893-91294212	chr1	91289893	91294212	4319	91291626
chr1:91296806-91302949	chr1	91296806	91302949	6143	91300358
chr1:91366637-91372747	chr1	91366637	91372747	6110	91370164
chr1:92253216-92258906	chr1	92253216	92258906	5690	92256327
chr1:92279485-92285624	chr1	92279485	92285624	6139	92283051
chr1:92530204-92535921	chr1	92530204	92535921	5717	92533361
chr1:92546712-92550501	chr1	92546712	92550501	3789	92547921
chr1:92592264-92595578	chr1	92592264	92595578	3314	92592994
chr1:92715488-92721678	chr1	92715488	92721678	6190	92719119
chr1:92891523-92897666	chr1	92891523	92897666	6143	92895078
chr1:93265657-93269422	chr1	93265657	93269422	3765	93266868
chr1:93511988-93515927	chr1	93511988	93515927	3939	93513343
chr1:93855732-93861872	chr1	93855732	93861872	6140	93859293
chr1:94134119-94140257	chr1	94134119	94140257	6138	94137676
chr1:94759818-94764614	chr1	94759818	94764614	4796	94762044
chr1:96604386-96610400	chr1	96604386	96610400	6014	96607806
chr1:96651258-96657410	chr1	96651258	96657410	6152	96654841
chr1:97287875-97291846	chr1	97287875	97291846	3971	97289261
chr1:97317944-97322243	chr1	97317944	97322243	4299	97319656
chr1:97357837-97363959	chr1	97357837	97363959	6122	97361378
chr1:98301863-98302392	chr1	98301863	98302392	529	98302073
chr1:99043156-99044702	chr1	99043156	99044702	1546	99043224
chr1:100199602-100206088	chr1	100199602	100206088	6486	100203524
chr1:100819961-100826211	chr1	100819961	100826211	6250	100823523
chr1:102356479-102358956	chr1	102356479	102358956	2477	102357217
chr1:102385624-102386688	chr1	102385624	102386688	1064	102386064
chr1:102442083-102448229	chr1	102442083	102448229	6146	102445638
chr1:103377216-103383340	chr1	103377216	103383340	6124	103380766
chr1:103483369-103487470	chr1	103483369	103487470	4101	103484886
chr1:103511161-103512990	chr1	103511161	103512990	1829	103512306
chr1:103922065-103925398	chr1	103922065	103925398	3333	103924916
chr1:104372112-104376684	chr1	104372112	104376684	4572	104374103
chr1:104587914-104591072	chr1	104587914	104591072	3158	104588545
chr1:104820216-104821822	chr1	104820216	104821822	1606	104821321
chr1:105574943-105579442	chr1	105574943	105579442	4499	105576845
chr1:106163919-106169407	chr1	106163919	106169407	5488	106166706
chr1:106329424-106335537	chr1	106329424	106335537	6113	106332952
chr1:106552725-106553570	chr1	106552725	106553570	845	106553375
chr1:106852954-106859362	chr1	106852954	106859362	6408	106856789
chr1:107844024-107848032	chr1	107844024	107848032	4008	107847844
chr1:108287721-108289537	chr1	108287721	108289537	1816	108288205
chr1:108490892-108495190	chr1	108490892	108495190	4298	108492601
chr1:108542343-108548024	chr1	108542343	108548024	5681	108545434
chr1:111010842-111013395	chr1	111010842	111013395	2553	111011564
chr1:111025717-111027521	chr1	111025717	111027521	1804	111026863
chr1:111092064-111095988	chr1	111092064	111095988	3924	111093403
chr1:111335211-111341371	chr1	111335211	111341371	6160	111338778
chr1:111681258-111686272	chr1	111681258	111686272	5014	111683735
chr1:112221418-112227438	chr1	112221418	112227438	6020	112224847
chr1:112288052-112292483	chr1	112288052	112292483	4431	112291546
chr1:113497220-113503257	chr1	113497220	113503257	6037	113500639
chr1:113560403-113562123	chr1	113560403	113562123	1720	113561190
chr1:113598330-113602232	chr1	113598330	113602232	3902	113599645
chr1:114303991-114309368	chr1	114303991	114309368	5377	114307527
chr1:115147821-115153959	chr1	115147821	115153959	6138	115151251
chr1:116051913-116058065	chr1	116051913	116058065	6152	116055479
chr1:116135021-116135555	chr1	116135021	116135555	534	116135552
chr1:116213734-116216393	chr1	116213734	116216393	2659	116213810
chr1:117217595-117223765	chr1	117217595	117223765	6170	117221175
chr1:117316909-117317469	chr1	117316909	117317469	560	117316984
chr1:117477045-117478110	chr1	117477045	117478110	1065	117477206
chr1:117722787-117726833	chr1	117722787	117726833	4046	117724241
chr1:118280887-118286905	chr1	118280887	118286905	6018	118284326
chr1:118349384-118354904	chr1	118349384	118354904	5520	118352318
chr1:118522016-118522638	chr1	118522016	118522638	622	118522526
chr1:118575347-118578116	chr1	118575347	118578116	2769	118575525
chr1:118637753-118643915	chr1	118637753	118643915	6162	118641313
chr1:118694626-118697732	chr1	118694626	118697732	3106	118695147
chr1:118831438-118837580	chr1	118831438	118837580	6142	118834996
chr1:118852351-118858380	chr1	118852351	118858380	6029	118855790
chr1:119020631-119026648	chr1	119020631	119026648	6017	119024057
chr1:119497647-119503803	chr1	119497647	119503803	6156	119501225
chr1:119521857-119525813	chr1	119521857	119525813	3956	119523225
chr1:120480723-120486850	chr1	120480723	120486850	6127	120484275
chr1:120673290-120679429	chr1	120673290	120679429	6139	120676836
chr1:121401447-121407469	chr1	121401447	121407469	6022	121404886
chr1:121477124-121483277	chr1	121477124	121483277	6153	121480677
chr1:121574289-121580421	chr1	121574289	121580421	6132	121577836
chr1:125007731-125013058	chr1	125007731	125013058	5327	125011148
chr1:125015251-125021207	chr1	125015251	125021207	5956	125018615
chr1:125122961-125129081	chr1	125122961	125129081	6120	125126496
chr1:144965215-144970658	chr1	144965215	144970658	5443	144968066
chr1:146769793-146770576	chr1	146769793	146770576	783	146769813
chr1:146868403-146872517	chr1	146868403	146872517	4114	146869928
chr1:147008641-147012672	chr1	147008641	147012672	4031	147010095
chr1:147012699-147016632	chr1	147012699	147016632	3933	147014060
chr1:147063913-147070066	chr1	147063913	147070066	6153	147067481
chr1:147306195-147308808	chr1	147306195	147308808	2613	147306242
chr1:147308818-147310670	chr1	147308818	147310670	1852	147309999
chr1:147327825-147330711	chr1	147327825	147330711	2886	147328168
chr1:147342997-147349114	chr1	147342997	147349114	6117	147346523
chr1:147402384-147408529	chr1	147402384	147408529	6145	147405942
chr1:147423218-147429241	chr1	147423218	147429241	6023	147426654
chr1:149293675-149299816	chr1	149293675	149299816	6141	149297221
chr1:152262817-152267407	chr1	152262817	152267407	4590	152264824
chr1:152614571-152617575	chr1	152614571	152617575	3004	152615013
chr1:152689415-152691383	chr1	152689415	152691383	1968	152689781
chr1:152691596-152695731	chr1	152691596	152695731	4135	152694444
chr1:152830284-152836378	chr1	152830284	152836378	6094	152833788
chr1:152938968-152940515	chr1	152938968	152940515	1547	152939998
chr1:153406996-153413138	chr1	153406996	153413138	6142	153410554
chr1:154066636-154068403	chr1	154066636	154068403	1767	154067016
chr1:157253907-157260060	chr1	157253907	157260060	6153	157257477
chr1:157293974-157300373	chr1	157293974	157300373	6399	157297804
chr1:157901878-157907242	chr1	157901878	157907242	5364	157905405
chr1:158234186-158235312	chr1	158234186	158235312	1126	158235118
chr1:158237269-158242661	chr1	158237269	158242661	5392	158240070
chr1:158303954-158309994	chr1	158303954	158309994	6040	158307508
chr1:158336097-158342236	chr1	158336097	158342236	6139	158339644
chr1:158866577-158870814	chr1	158866577	158870814	4237	158868279
chr1:158886103-158892114	chr1	158886103	158892114	6011	158889539
chr1:158952740-158958797	chr1	158952740	158958797	6057	158956177
chr1:159323636-159328450	chr1	159323636	159328450	4814	159326380
chr1:159452953-159458976	chr1	159452953	159458976	6023	159456384
chr1:159538219-159544248	chr1	159538219	159544248	6029	159541669
chr1:159603762-159609902	chr1	159603762	159609902	6140	159607309
chr1:160511704-160518027	chr1	160511704	160518027	6323	160515431
chr1:160783080-160788385	chr1	160783080	160788385	5305	160786619
chr1:160896563-160900271	chr1	160896563	160900271	3708	160897683
chr1:161692858-161699312	chr1	161692858	161699312	6454	161696729
chr1:162451678-162455318	chr1	162451678	162455318	3640	162452730
chr1:163077782-163080993	chr1	163077782	163080993	3211	163078406
chr1:163255349-163256407	chr1	163255349	163256407	1058	163255535
chr1:163760343-163764470	chr1	163760343	163764470	4127	163761874
chr1:163953935-163954026	chr1	163953935	163954026	91	163953984
chr1:164118145-164121631	chr1	164118145	164121631	3486	164120196
chr1:164166560-164172086	chr1	164166560	164172086	5526	164169513
chr1:164216021-164222185	chr1	164216021	164222185	6164	164219596
chr1:164459203-164465253	chr1	164459203	164465253	6050	164462661
chr1:165084965-165091110	chr1	165084965	165091110	6145	165088525
chr1:165801828-165804063	chr1	165801828	165804063	2235	165802148
chr1:165967579-165970216	chr1	165967579	165970216	2637	165967640
chr1:166226463-166227549	chr1	166226463	166227549	1086	166226749
chr1:166267053-166270459	chr1	166267053	166270459	3406	166267865
chr1:168546557-168550699	chr1	168546557	168550699	4142	168548093
chr1:168746940-168747785	chr1	168746940	168747785	845	168747500
chr1:168886085-168886685	chr1	168886085	168886685	600	168886172
chr1:168927875-168929938	chr1	168927875	168929938	2063	168928140
chr1:169400697-169406797	chr1	169400697	169406797	6100	169404236
chr1:169500279-169504186	chr1	169500279	169504186	3907	169501257
chr1:169712588-169715636	chr1	169712588	169715636	3048	169713046
chr1:170048537-170054984	chr1	170048537	170054984	6447	170052416
chr1:170058902-170062171	chr1	170058902	170062171	3269	170059590
chr1:170279629-170283699	chr1	170279629	170283699	4070	170281108
chr1:170428555-170432585	chr1	170428555	170432585	4030	170430004
chr1:170463885-170470037	chr1	170463885	170470037	6152	170467442
chr1:170568879-170575370	chr1	170568879	170575370	6491	170572794
chr1:170835582-170835848	chr1	170835582	170835848	266	170835770
chr1:171373586-171379567	chr1	171373586	171379567	5981	171376992
chr1:172027618-172031572	chr1	172027618	172031572	3954	172028983
chr1:172055829-172061861	chr1	172055829	172061861	6032	172059269
chr1:172232031-172235994	chr1	172232031	172235994	3963	172233464
chr1:172301908-172308031	chr1	172301908	172308031	6123	172305456
chr1:172314246-172319643	chr1	172314246	172319643	5397	172317813
chr1:172431615-172437728	chr1	172431615	172437728	6113	172435171
chr1:173033116-173035889	chr1	173033116	173035889	2773	173033424
chr1:173153744-173159905	chr1	173153744	173159905	6161	173157318
chr1:173227437-173231885	chr1	173227437	173231885	4448	173231019
chr1:173258181-173262595	chr1	173258181	173262595	4414	173261905
chr1:173322401-173328514	chr1	173322401	173328514	6113	173325940
chr1:173696805-173701825	chr1	173696805	173701825	5020	173699246
chr1:173725764-173731872	chr1	173725764	173731872	6108	173729297
chr1:173811694-173816857	chr1	173811694	173816857	5163	173815260
chr1:174146166-174148480	chr1	174146166	174148480	2314	174146823
chr1:175290181-175293394	chr1	175290181	175293394	3213	175290863
chr1:175436506-175440540	chr1	175436506	175440540	4034	175437952
chr1:175992256-175998501	chr1	175992256	175998501	6245	175995821
chr1:177633927-177639946	chr1	177633927	177639946	6019	177637358
chr1:177692529-177698661	chr1	177692529	177698661	6132	177696079
chr1:177714289-177717574	chr1	177714289	177717574	3285	177714980
chr1:177759403-177765545	chr1	177759403	177765545	6142	177762954
chr1:177986027-177992195	chr1	177986027	177992195	6168	177989607
chr1:178837547-178843666	chr1	178837547	178843666	6119	178841074
chr1:179434202-179436866	chr1	179434202	179436866	2664	179434276
chr1:179694053-179700429	chr1	179694053	179700429	6376	179697884
chr1:180302603-180306261	chr1	180302603	180306261	3658	180303680
chr1:180333571-180339694	chr1	180333571	180339694	6123	180337078
chr1:180452476-180455529	chr1	180452476	180455529	3053	180452990
chr1:180758817-180762284	chr1	180758817	180762284	3467	180759689
chr1:181197443-181201740	chr1	181197443	181201740	4297	181199168
chr1:181275862-181281995	chr1	181275862	181281995	6133	181279403
chr1:181884334-181886068	chr1	181884334	181886068	1734	181885785
chr1:181921352-181924621	chr1	181921352	181924621	3269	181922082
chr1:181977201-181981507	chr1	181977201	181981507	4306	181978859
chr1:182221081-182225372	chr1	182221081	182225372	4291	182222788
chr1:183397301-183402079	chr1	183397301	183402079	4778	183399485
chr1:183658067-183664223	chr1	183658067	183664223	6156	183661632
chr1:184845616-184851641	chr1	184845616	184851641	6025	184849051
chr1:185001530-185007555	chr1	185001530	185007555	6025	185004967
chr1:185234803-185237699	chr1	185234803	185237699	2896	185235138
chr1:185586404-185592491	chr1	185586404	185592491	6087	185589961
chr1:185639337-185644066	chr1	185639337	185644066	4729	185641473
chr1:185707397-185713577	chr1	185707397	185713577	6180	185710992
chr1:186637331-186643356	chr1	186637331	186643356	6025	186640768
chr1:187398139-187401483	chr1	187398139	187401483	3344	187398918
chr1:187597671-187603699	chr1	187597671	187603699	6028	187601107
chr1:189210437-189211567	chr1	189210437	189211567	1130	189210956
chr1:189754801-189760951	chr1	189754801	189760951	6150	189758363
chr1:191029564-191032604	chr1	191029564	191032604	3040	191030746
chr1:192500584-192506612	chr1	192500584	192506612	6028	192504021
chr1:193871969-193877011	chr1	193871969	193877011	5042	193874444
chr1:194780869-194782337	chr1	194780869	194782337	1468	194781905
chr1:195107721-195111807	chr1	195107721	195111807	4086	195109218
chr1:196106615-196108731	chr1	196106615	196108731	2116	196107848
chr1:196515649-196520574	chr1	196515649	196520574	4925	196519870
chr1:196698163-196699105	chr1	196698163	196699105	942	196698649
chr1:197044342-197048136	chr1	197044342	197048136	3794	197045584
chr1:197291873-197295067	chr1	197291873	197295067	3194	197292483
chr1:197532240-197534154	chr1	197532240	197534154	1914	197532351
chr1:197624580-197629687	chr1	197624580	197629687	5107	197627102
chr1:197707714-197713746	chr1	197707714	197713746	6032	197711155
chr1:197829755-197835283	chr1	197829755	197835283	5528	197832695
chr1:199364767-199367605	chr1	199364767	199367605	2838	199365015
chr1:199601585-199604799	chr1	199601585	199604799	3214	199603090
chr1:199604783-199607813	chr1	199604783	199607813	3030	199605245
chr1:199647362-199653472	chr1	199647362	199653472	6110	199650890
chr1:200185367-200191509	chr1	200185367	200191509	6142	200188927
chr1:203259376-203262990	chr1	203259376	203262990	3614	203261528
chr1:203414978-203418131	chr1	203414978	203418131	3153	203415542
chr1:205901346-205905618	chr1	205901346	205905618	4272	205903055
chr1:207196003-207202062	chr1	207196003	207202062	6059	207199483
chr1:207206734-207212907	chr1	207206734	207212907	6173	207210313
chr1:207590582-207594612	chr1	207590582	207594612	4030	207592019
chr1:207730466-207736495	chr1	207730466	207736495	6029	207733902
chr1:208702694-208709029	chr1	208702694	208709029	6335	208706257
chr1:208991457-208997579	chr1	208991457	208997579	6122	208994998
chr1:210844383-210847740	chr1	210844383	210847740	3357	210845152
chr1:210885126-210890802	chr1	210885126	210890802	5676	210888978
chr1:210964444-210967331	chr1	210964444	210967331	2887	210964676
chr1:210995996-211001425	chr1	210995996	211001425	5429	210999588
chr1:211031094-211033914	chr1	211031094	211033914	2820	211031317
chr1:211078945-211081974	chr1	211078945	211081974	3029	211079391
chr1:211453401-211459510	chr1	211453401	211459510	6109	211456922
chr1:212390465-212396588	chr1	212390465	212396588	6123	212394011
chr1:212658025-212664183	chr1	212658025	212664183	6158	212661603
chr1:213213891-213220019	chr1	213213891	213220019	6128	213217446
chr1:213632373-213637025	chr1	213632373	213637025	4652	213635196
chr1:214781766-214785307	chr1	214781766	214785307	3541	214782729
chr1:215532201-215538371	chr1	215532201	215538371	6170	215535783
chr1:216339591-216343003	chr1	216339591	216343003	3412	216340415
chr1:216485645-216491614	chr1	216485645	216491614	5969	216489023
chr1:217381734-217385828	chr1	217381734	217385828	4094	217383265
chr1:217438857-217442503	chr1	217438857	217442503	3646	217439939
chr1:218820965-218822996	chr1	218820965	218822996	2031	218821967
chr1:219116344-219118515	chr1	219116344	219118515	2171	219117402
chr1:219839330-219845537	chr1	219839330	219845537	6207	219842900
chr1:219863570-219869595	chr1	219863570	219869595	6025	219867002
chr1:219887336-219892836	chr1	219887336	219892836	5500	219890259
chr1:221047132-221053554	chr1	221047132	221053554	6422	221050998
chr1:222145502-222151825	chr1	222145502	222151825	6323	222149269
chr1:222406471-222409632	chr1	222406471	222409632	3161	222407924
chr1:222959751-222961726	chr1	222959751	222961726	1975	222961042
chr1:223167652-223173641	chr1	223167652	223173641	5989	223171051
chr1:223278088-223284243	chr1	223278088	223284243	6155	223281662
chr1:223446992-223453023	chr1	223446992	223453023	6031	223450432
chr1:225168188-225174275	chr1	225168188	225174275	6087	225171694
chr1:225218027-225221659	chr1	225218027	225221659	3632	225219732
chr1:225384368-225387385	chr1	225384368	225387385	3017	225384802
chr1:226926834-226930252	chr1	226926834	226930252	3418	226927677
chr1:227473587-227477577	chr1	227473587	227477577	3990	227477466
chr1:228707410-228712807	chr1	228707410	228712807	5397	228710234
chr1:231944783-231948615	chr1	231944783	231948615	3832	231946035
chr1:237075264-237081293	chr1	237075264	237081293	6029	237078701
chr1:237603458-237607585	chr1	237603458	237607585	4127	237604996
chr1:237820213-237826650	chr1	237820213	237826650	6437	237824102
chr1:242169140-242174310	chr1	242169140	242174310	5170	242172954
chr1:242172924-242175053	chr1	242172924	242175053	2129	242172954
chr1:242481073-242487222	chr1	242481073	242487222	6149	242484633
chr1:242586642-242593092	chr1	242586642	242593092	6450	242590501
chr1:242614956-242618314	chr1	242614956	242618314	3358	242616178
chr1:243653009-243653517	chr1	243653009	243653517	508	243653420
chr1:243807047-243813190	chr1	243807047	243813190	6143	243810600
chr1:243820218-243825405	chr1	243820218	243825405	5187	243822854
chr1:244491012-244494613	chr1	244491012	244494613	3601	244492018
chr1:244521906-244525502	chr1	244521906	244525502	3596	244522909
chr1:245627324-245628191	chr1	245627324	245628191	867	245628055
chr1:245726401-245727741	chr1	245726401	245727741	1340	245727590
chr1:245816539-245822560	chr1	245816539	245822560	6021	245819969
chr1:246714715-246719911	chr1	246714715	246719911	5196	246717760
chr1:247018054-247019561	chr1	247018054	247019561	1507	247018882
chr1:247687173-247693204	chr1	247687173	247693204	6031	247690612
chr1:247727449-247728670	chr1	247727449	247728670	1221	247727997
chr1:248067512-248073636	chr1	248067512	248073636	6124	248071050
chr1:248188797-248194431	chr1	248188797	248194431	5634	248192526
chr1:248236042-248237372	chr1	248236042	248237372	1330	248236988
chr1:248252861-248258877	chr1	248252861	248258877	6016	248256289
chr1:248527957-248533197	chr1	248527957	248533197	5240	248531371
chr1:248763748-248767795	chr1	248763748	248767795	4047	248765204
chr10:35477-41492	chr10	35477	41492	6015	38900
chr10:464769-467542	chr10	464769	467542	2773	464961
chr10:746475-750115	chr10	746475	750115	3640	747524
chr10:1258280-1262287	chr10	1258280	1262287	4007	1259724
chr10:1276569-1277928	chr10	1276569	1277928	1359	1277678
chr10:1302016-1308092	chr10	1302016	1308092	6076	1305476
chr10:4862731-4864819	chr10	4862731	4864819	2088	4864035
chr10:5110412-5114093	chr10	5110412	5114093	3681	5111509
chr10:5222679-5228851	chr10	5222679	5228851	6172	5226249
chr10:5234497-5240880	chr10	5234497	5240880	6383	5238374
chr10:5245354-5251383	chr10	5245354	5251383	6029	5248793
chr10:6448785-6454084	chr10	6448785	6454084	5299	6451501
chr10:6858693-6862066	chr10	6858693	6862066	3373	6859614
chr10:7137522-7142956	chr10	7137522	7142956	5434	7140364
chr10:9519878-9526029	chr10	9519878	9526029	6151	9523439
chr10:9957942-9963738	chr10	9957942	9963738	5796	9961153
chr10:10650857-10656884	chr10	10650857	10656884	6027	10654292
chr10:12856454-12861757	chr10	12856454	12861757	5303	12859175
chr10:13029256-13034503	chr10	13029256	13034503	5247	13031915
chr10:16218516-16219806	chr10	16218516	16219806	1290	16219485
chr10:17163364-17166531	chr10	17163364	17166531	3167	17163942
chr10:18587488-18593887	chr10	18587488	18593887	6399	18591307
chr10:18627418-18633448	chr10	18627418	18633448	6030	18630827
chr10:18970454-18975400	chr10	18970454	18975400	4946	18972816
chr10:18993141-18998592	chr10	18993141	18998592	5451	18996009
chr10:19286543-19287041	chr10	19286543	19287041	498	19286744
chr10:20555404-20561597	chr10	20555404	20561597	6193	20558983
chr10:20568508-20572895	chr10	20568508	20572895	4387	20570305
chr10:20937453-20943602	chr10	20937453	20943602	6149	20941010
chr10:21781742-21785063	chr10	21781742	21785063	3321	21782465
chr10:21838642-21842264	chr10	21838642	21842264	3622	21839675
chr10:22060724-22066859	chr10	22060724	22066859	6135	22064275
chr10:22089277-22095453	chr10	22089277	22095453	6176	22092880
chr10:22744433-22749078	chr10	22744433	22749078	4645	22746471
chr10:22857417-22861432	chr10	22857417	22861432	4015	22858841
chr10:22882937-22885649	chr10	22882937	22885649	2712	22883014
chr10:22885657-22889387	chr10	22885657	22889387	3730	22889203
chr10:23224131-23229595	chr10	23224131	23229595	5464	23227014
chr10:25185853-25186960	chr10	25185853	25186960	1107	25186797
chr10:25619185-25625436	chr10	25619185	25625436	6251	25623100
chr10:26006128-26009393	chr10	26006128	26009393	3265	26006805
chr10:27418271-27424390	chr10	27418271	27424390	6119	27421812
chr10:27430945-27432141	chr10	27430945	27432141	1196	27431926
chr10:27845022-27849555	chr10	27845022	27849555	4533	27846997
chr10:27899017-27903737	chr10	27899017	27903737	4720	27902872
chr10:30274231-30278235	chr10	30274231	30278235	4004	30275707
chr10:30948036-30953410	chr10	30948036	30953410	5374	30950822
chr10:31284309-31288047	chr10	31284309	31288047	3738	31285457
chr10:31453629-31456408	chr10	31453629	31456408	2779	31453833
chr10:31469210-31475223	chr10	31469210	31475223	6013	31472632
chr10:31892060-31896243	chr10	31892060	31896243	4183	31893670
chr10:32558677-32564814	chr10	32558677	32564814	6137	32562225
chr10:32705155-32709480	chr10	32705155	32709480	4325	32706894
chr10:32754652-32760755	chr10	32754652	32760755	6103	32758174
chr10:32815863-32821973	chr10	32815863	32821973	6110	32819389
chr10:32858714-32862570	chr10	32858714	32862570	3856	32859987
chr10:34067490-34073605	chr10	34067490	34073605	6115	34071054
chr10:35473782-35479771	chr10	35473782	35479771	5989	35477211
chr10:35858668-35864695	chr10	35858668	35864695	6027	35862103
chr10:36161183-36163879	chr10	36161183	36163879	2696	36161277
chr10:36401090-36405575	chr10	36401090	36405575	4485	36402994
chr10:37202227-37205611	chr10	37202227	37205611	3384	37203059
chr10:37537981-37544103	chr10	37537981	37544103	6122	37541515
chr10:37605685-37608520	chr10	37605685	37608520	2835	37605932
chr10:37693432-37698964	chr10	37693432	37698964	5532	37696393
chr10:37765638-37771784	chr10	37765638	37771784	6146	37769196
chr10:37778697-37780539	chr10	37778697	37780539	1842	37779088
chr10:37896970-37902986	chr10	37896970	37902986	6016	37900401
chr10:37995443-38001451	chr10	37995443	38001451	6008	37998875
chr10:38106141-38111494	chr10	38106141	38111494	5353	38108907
chr10:38187522-38192988	chr10	38187522	38192988	5466	38190400
chr10:38216268-38222400	chr10	38216268	38222400	6132	38219829
chr10:38264454-38265664	chr10	38264454	38265664	1210	38264555
chr10:38659189-38665330	chr10	38659189	38665330	6141	38662749
chr10:38706484-38708721	chr10	38706484	38708721	2237	38708416
chr10:38724322-38727432	chr10	38724322	38727432	3110	38724844
chr10:39025250-39029116	chr10	39025250	39029116	3866	39026526
chr10:39164852-39167897	chr10	39164852	39167897	3045	39165308
chr10:39182459-39183199	chr10	39182459	39183199	740	39183141
chr10:39259306-39265413	chr10	39259306	39265413	6107	39262836
chr10:39356881-39358109	chr10	39356881	39358109	1228	39357951
chr10:39508152-39514160	chr10	39508152	39514160	6008	39511569
chr10:41749414-41755349	chr10	41749414	41755349	5935	41752769
chr10:42435381-42441412	chr10	42435381	42441412	6031	42438821
chr10:42447197-42450618	chr10	42447197	42450618	3421	42448027
chr10:42665128-42671301	chr10	42665128	42671301	6173	42668710
chr10:43716710-43722840	chr10	43716710	43722840	6130	43720255
chr10:44138851-44142823	chr10	44138851	44142823	3972	44140244
chr10:44268315-44274469	chr10	44268315	44274469	6154	44271879
chr10:44488522-44492311	chr10	44488522	44492311	3789	44489732
chr10:44593833-44600332	chr10	44593833	44600332	6499	44597750
chr10:45265801-45271952	chr10	45265801	45271952	6151	45269368
chr10:45341485-45346129	chr10	45341485	45346129	4644	45345035
chr10:45362159-45368173	chr10	45362159	45368173	6014	45365588
chr10:45392724-45395618	chr10	45392724	45395618	2894	45393027
chr10:45668594-45670225	chr10	45668594	45670225	1631	45669454
chr10:48348882-48351272	chr10	48348882	48351272	2390	48350192
chr10:48372220-48377370	chr10	48372220	48377370	5150	48374812
chr10:49246227-49251637	chr10	49246227	49251637	5410	49249047
chr10:49714954-49721059	chr10	49714954	49721059	6105	49718483
chr10:50267345-50271003	chr10	50267345	50271003	3658	50268425
chr10:50352774-50355273	chr10	50352774	50355273	2499	50353012
chr10:50483379-50485619	chr10	50483379	50485619	2240	50484470
chr10:50760321-50763460	chr10	50760321	50763460	3139	50760886
chr10:51210054-51213477	chr10	51210054	51213477	3423	51210888
chr10:52233328-52239334	chr10	52233328	52239334	6006	52236741
chr10:53111286-53115307	chr10	53111286	53115307	4021	53114853
chr10:53370120-53376230	chr10	53370120	53376230	6110	53373669
chr10:53970434-53973451	chr10	53970434	53973451	3017	53970863
chr10:54514987-54521225	chr10	54514987	54521225	6238	54518635
chr10:55070983-55073550	chr10	55070983	55073550	2567	55072672
chr10:55601875-55607910	chr10	55601875	55607910	6035	55605320
chr10:55899641-55905708	chr10	55899641	55905708	6067	55903077
chr10:56129025-56129859	chr10	56129025	56129859	834	56129224
chr10:56186332-56192251	chr10	56186332	56192251	5919	56189672
chr10:56528068-56529319	chr10	56528068	56529319	1251	56528704
chr10:56642162-56643866	chr10	56642162	56643866	1704	56643602
chr10:56683821-56689958	chr10	56683821	56689958	6137	56687373
chr10:57717577-57722170	chr10	57717577	57722170	4593	57719655
chr10:57778846-57784971	chr10	57778846	57784971	6125	57782403
chr10:58229727-58235826	chr10	58229727	58235826	6099	58233245
chr10:58522302-58525717	chr10	58522302	58525717	3415	58523128
chr10:58655904-58656658	chr10	58655904	58656658	754	58656273
chr10:58675842-58681636	chr10	58675842	58681636	5794	58679610
chr10:59528201-59534363	chr10	59528201	59534363	6162	59531770
chr10:59659381-59662354	chr10	59659381	59662354	2973	59660577
chr10:60640114-60642788	chr10	60640114	60642788	2674	60640212
chr10:60692960-60698897	chr10	60692960	60698897	5937	60696326
chr10:61056438-61058136	chr10	61056438	61058136	1698	61057761
chr10:61551969-61553906	chr10	61551969	61553906	1937	61553600
chr10:62701706-62704656	chr10	62701706	62704656	2950	62702067
chr10:62785944-62788799	chr10	62785944	62788799	2855	62786206
chr10:62949626-62955767	chr10	62949626	62955767	6141	62953183
chr10:63967677-63970176	chr10	63967677	63970176	2499	63967852
chr10:64120283-64126312	chr10	64120283	64126312	6029	64123724
chr10:64836999-64839082	chr10	64836999	64839082	2083	64838159
chr10:64924285-64930261	chr10	64924285	64930261	5976	64927669
chr10:65101638-65105891	chr10	65101638	65105891	4253	65103322
chr10:65524706-65528375	chr10	65524706	65528375	3669	65525788
chr10:66381963-66388105	chr10	66381963	66388105	6142	66385515
chr10:66690979-66694606	chr10	66690979	66694606	3627	66694536
chr10:67230665-67236674	chr10	67230665	67236674	6009	67234087
chr10:67387044-67393069	chr10	67387044	67393069	6025	67390479
chr10:67560609-67564644	chr10	67560609	67564644	4035	67562063
chr10:67635019-67636671	chr10	67635019	67636671	1652	67635247
chr10:67636668-67642016	chr10	67636668	67642016	5348	67639430
chr10:67699632-67705791	chr10	67699632	67705791	6159	67703200
chr10:67741361-67745670	chr10	67741361	67745670	4309	67743076
chr10:72395313-72399147	chr10	72395313	72399147	3834	72398867
chr10:72435420-72441564	chr10	72435420	72441564	6144	72438974
chr10:73323334-73329500	chr10	73323334	73329500	6166	73326911
chr10:73391954-73394871	chr10	73391954	73394871	2917	73392274
chr10:74216880-74223021	chr10	74216880	74223021	6141	74220444
chr10:74347140-74353587	chr10	74347140	74353587	6447	74351002
chr10:74456690-74457411	chr10	74456690	74457411	721	74457404
chr10:76219056-76223274	chr10	76219056	76223274	4218	76220695
chr10:76475371-76479052	chr10	76475371	76479052	3681	76476474
chr10:76586841-76591752	chr10	76586841	76591752	4911	76589162
chr10:76608512-76614828	chr10	76608512	76614828	6316	76612090
chr10:76846210-76852331	chr10	76846210	76852331	6121	76849787
chr10:77567955-77570750	chr10	77567955	77570750	2795	77568158
chr10:77994510-77999308	chr10	77994510	77999308	4798	77996736
chr10:78088450-78094479	chr10	78088450	78094479	6029	78091888
chr10:78099595-78100983	chr10	78099595	78100983	1388	78100229
chr10:78667062-78671797	chr10	78667062	78671797	4735	78669957
chr10:79570393-79576489	chr10	79570393	79576489	6096	79573903
chr10:79589541-79592602	chr10	79589541	79592602	3061	79590029
chr10:79956165-79962310	chr10	79956165	79962310	6145	79959719
chr10:80306152-80309812	chr10	80306152	80309812	3660	80307596
chr10:80830406-80833600	chr10	80830406	80833600	3194	80831007
chr10:80881468-80887604	chr10	80881468	80887604	6136	80885021
chr10:81709615-81715642	chr10	81709615	81715642	6027	81713050
chr10:81734955-81741067	chr10	81734955	81741067	6112	81738476
chr10:82782712-82785364	chr10	82782712	82785364	2652	82782782
chr10:83088894-83095334	chr10	83088894	83095334	6440	83092749
chr10:83294485-83297600	chr10	83294485	83297600	3115	83295011
chr10:83375905-83378446	chr10	83375905	83378446	2541	83375927
chr10:83899820-83903205	chr10	83899820	83903205	3385	83900615
chr10:84279967-84286006	chr10	84279967	84286006	6039	84283427
chr10:84639669-84643031	chr10	84639669	84643031	3362	84640417
chr10:84746875-84749566	chr10	84746875	84749566	2691	84746977
chr10:85125746-85131881	chr10	85125746	85131881	6135	85129312
chr10:85355506-85361538	chr10	85355506	85361538	6032	85358946
chr10:85415261-85418007	chr10	85415261	85418007	2746	85415318
chr10:85518626-85520014	chr10	85518626	85520014	1388	85519126
chr10:85704050-85708126	chr10	85704050	85708126	4076	85705532
chr10:85769340-85775490	chr10	85769340	85775490	6150	85772897
chr10:85876618-85882780	chr10	85876618	85882780	6162	85880196
chr10:89316102-89322227	chr10	89316102	89322227	6125	89319636
chr10:90012225-90015592	chr10	90012225	90015592	3367	90013006
chr10:90184890-90186178	chr10	90184890	90186178	1288	90185963
chr10:90250613-90256635	chr10	90250613	90256635	6022	90254050
chr10:91026528-91029934	chr10	91026528	91029934	3406	91027349
chr10:91363405-91366452	chr10	91363405	91366452	3047	91363869
chr10:91445578-91451529	chr10	91445578	91451529	5951	91448951
chr10:91503263-91509287	chr10	91503263	91509287	6024	91506698
chr10:91531179-91535779	chr10	91531179	91535779	4600	91533207
chr10:91643839-91650295	chr10	91643839	91650295	6456	91647736
chr10:91749615-91755638	chr10	91749615	91755638	6023	91753043
chr10:92132613-92136173	chr10	92132613	92136173	3560	92133589
chr10:93520973-93527095	chr10	93520973	93527095	6122	93524513
chr10:93537467-93541422	chr10	93537467	93541422	3955	93538813
chr10:93927699-93933826	chr10	93927699	93933826	6127	93931237
chr10:94621435-94622182	chr10	94621435	94622182	747	94621567
chr10:94695556-94701636	chr10	94695556	94701636	6080	94699053
chr10:94818908-94820369	chr10	94818908	94820369	1461	94819814
chr10:95079215-95085109	chr10	95079215	95085109	5894	95082654
chr10:95138102-95141282	chr10	95138102	95141282	3180	95139467
chr10:95149484-95153532	chr10	95149484	95153532	4048	95150939
chr10:95153714-95157035	chr10	95153714	95157035	3321	95154458
chr10:98222717-98223373	chr10	98222717	98223373	656	98223113
chr10:98544741-98547818	chr10	98544741	98547818	3077	98545228
chr10:98697861-98701637	chr10	98697861	98701637	3776	98699065
chr10:98701674-98705934	chr10	98701674	98705934	4260	98703356
chr10:98937100-98943241	chr10	98937100	98943241	6141	98940657
chr10:98983670-98989658	chr10	98983670	98989658	5988	98987067
chr10:99099016-99105074	chr10	99099016	99105074	6058	99102556
chr10:99132445-99138883	chr10	99132445	99138883	6438	99136314
chr10:99152737-99158758	chr10	99152737	99158758	6021	99156174
chr10:99412518-99418062	chr10	99412518	99418062	5544	99415516
chr10:100406330-100412500	chr10	100406330	100412500	6170	100409892
chr10:100454490-100460565	chr10	100454490	100460565	6075	100458015
chr10:100702883-100704222	chr10	100702883	100704222	1339	100703026
chr10:105550208-105556235	chr10	105550208	105556235	6027	105553640
chr10:105735717-105741873	chr10	105735717	105741873	6156	105739283
chr10:105893558-105898025	chr10	105893558	105898025	4467	105897003
chr10:106114388-106120778	chr10	106114388	106120778	6390	106118200
chr10:106221261-106224391	chr10	106221261	106224391	3130	106221812
chr10:106467234-106473304	chr10	106467234	106473304	6070	106470731
chr10:107464698-107468022	chr10	107464698	107468022	3324	107465430
chr10:108023852-108026603	chr10	108023852	108026603	2751	108024604
chr10:108113943-108120006	chr10	108113943	108120006	6063	108117415
chr10:108504410-108510526	chr10	108504410	108510526	6116	108507945
chr10:108724800-108726687	chr10	108724800	108726687	1887	108725440
chr10:108949691-108954697	chr10	108949691	108954697	5006	108952102
chr10:108993267-108998371	chr10	108993267	108998371	5104	108995786
chr10:109223621-109229635	chr10	109223621	109229635	6014	109227047
chr10:109367269-109373405	chr10	109367269	109373405	6136	109370812
chr10:109605538-109610974	chr10	109605538	109610974	5436	109608379
chr10:109652357-109658473	chr10	109652357	109658473	6116	109655924
chr10:109825817-109831846	chr10	109825817	109831846	6029	109829264
chr10:111043140-111049281	chr10	111043140	111049281	6141	111046701
chr10:111583927-111589948	chr10	111583927	111589948	6021	111587356
chr10:111637108-111643242	chr10	111637108	111643242	6134	111640672
chr10:111813807-111819830	chr10	111813807	111819830	6023	111817242
chr10:112041352-112044777	chr10	112041352	112044777	3425	112042159
chr10:112062391-112068402	chr10	112062391	112068402	6011	112065827
chr10:112103925-112109951	chr10	112103925	112109951	6026	112107361
chr10:112250899-112257061	chr10	112250899	112257061	6162	112254472
chr10:113672008-113677564	chr10	113672008	113677564	5556	113674977
chr10:115133360-115135788	chr10	115133360	115135788	2428	115134609
chr10:115821426-115825440	chr10	115821426	115825440	4014	115822855
chr10:115925308-115927349	chr10	115925308	115927349	2041	115926835
chr10:118864071-118865108	chr10	118864071	118865108	1037	118864245
chr10:120445068-120451214	chr10	120445068	120451214	6146	120448615
chr10:120671008-120677312	chr10	120671008	120677312	6304	120674813
chr10:120910959-120916980	chr10	120910959	120916980	6021	120914394
chr10:120919373-120922376	chr10	120919373	120922376	3003	120919784
chr10:122867240-122872946	chr10	122867240	122872946	5706	122870360
chr10:125647551-125653649	chr10	125647551	125653649	6098	125651071
chr10:125716861-125717592	chr10	125716861	125717592	731	125717300
chr10:125945237-125951250	chr10	125945237	125951250	6013	125948687
chr10:126587907-126593709	chr10	126587907	126593709	5802	126591120
chr10:126676471-126682458	chr10	126676471	126682458	5987	126679884
chr10:129575054-129578695	chr10	129575054	129578695	3641	129576109
chr10:129738697-129739427	chr10	129738697	129739427	730	129738728
chr10:130094030-130096863	chr10	130094030	130096863	2833	130094300
chr10:133505361-133506240	chr10	133505361	133506240	879	133505551
chr10:133547174-133550018	chr10	133547174	133550018	2844	133548654
chr10:133580555-133586707	chr10	133580555	133586707	6152	133584119
chr10_GL383546v1_alt:90569-96720	chr10_GL383546v1_alt	90569	96720	6151	94136
chr10_GL383546v1_alt:166239-169822	chr10_GL383546v1_alt	166239	169822	3583	169791
chr10_GL383546v1_alt:182273-186925	chr10_GL383546v1_alt	182273	186925	4652	185831
chr10_GL383546v1_alt:202994-209003	chr10_GL383546v1_alt	202994	209003	6009	206418
chr10_GL383546v1_alt:233555-236449	chr10_GL383546v1_alt	233555	236449	2894	233858
chr11:76846-83269	chr11	76846	83269	6423	80724
chr11:3999589-4005742	chr11	3999589	4005742	6153	4003162
chr11:4263628-4268509	chr11	4263628	4268509	4881	4265931
chr11:4535011-4537858	chr11	4535011	4537858	2847	4535320
chr11:4854097-4859276	chr11	4854097	4859276	5179	4857649
chr11:5355904-5361151	chr11	5355904	5361151	5247	5358567
chr11:5373345-5379500	chr11	5373345	5379500	6155	5376884
chr11:5412302-5418416	chr11	5412302	5418416	6114	5415850
chr11:5477498-5483520	chr11	5477498	5483520	6022	5480932
chr11:5714687-5717583	chr11	5714687	5717583	2896	5714916
chr11:5914493-5918448	chr11	5914493	5918448	3955	5917905
chr11:6119733-6121147	chr11	6119733	6121147	1414	6119992
chr11:6143657-6149454	chr11	6143657	6149454	5797	6147085
chr11:6185350-6191366	chr11	6185350	6191366	6016	6188786
chr11:6729873-6733131	chr11	6729873	6733131	3258	6730544
chr11:6904588-6910721	chr11	6904588	6910721	6133	6908139
chr11:6982220-6983553	chr11	6982220	6983553	1333	6983332
chr11:7177887-7181190	chr11	7177887	7181190	3303	7178610
chr11:7734499-7740482	chr11	7734499	7740482	5983	7737894
chr11:7764360-7768664	chr11	7764360	7768664	4304	7767713
chr11:7788380-7791205	chr11	7788380	7791205	2825	7788615
chr11:8140813-8145223	chr11	8140813	8145223	4410	8142601
chr11:8396496-8402628	chr11	8396496	8402628	6132	8400043
chr11:8516379-8522468	chr11	8516379	8522468	6089	8519917
chr11:8889267-8895401	chr11	8889267	8895401	6134	8892821
chr11:9934103-9936891	chr11	9934103	9936891	2788	9934380
chr11:10173147-10179353	chr11	10173147	10179353	6206	10176765
chr11:10466277-10469757	chr11	10466277	10469757	3480	10469570
chr11:10963805-10967417	chr11	10963805	10967417	3612	10966810
chr11:11885232-11891149	chr11	11885232	11891149	5917	11888626
chr11:13085841-13089538	chr11	13085841	13089538	3697	13086953
chr11:13479955-13483886	chr11	13479955	13483886	3931	13483540
chr11:13507194-13510245	chr11	13507194	13510245	3051	13507656
chr11:13569850-13575921	chr11	13569850	13575921	6071	13573336
chr11:13584000-13588734	chr11	13584000	13588734	4734	13586199
chr11:13651253-13657406	chr11	13651253	13657406	6153	13654822
chr11:14429804-14435088	chr11	14429804	14435088	5284	14432497
chr11:14571362-14573817	chr11	14571362	14573817	2455	14573089
chr11:14661315-14666695	chr11	14661315	14666695	5380	14664841
chr11:14715908-14721938	chr11	14715908	14721938	6030	14719346
chr11:14777675-14783773	chr11	14777675	14783773	6098	14781237
chr11:14844351-14850498	chr11	14844351	14850498	6147	14847912
chr11:14961775-14964943	chr11	14961775	14964943	3168	14962353
chr11:14993518-14998320	chr11	14993518	14998320	4802	14995738
chr11:16141388-16147513	chr11	16141388	16147513	6125	16144924
chr11:16496332-16502471	chr11	16496332	16502471	6139	16499884
chr11:16516450-16517441	chr11	16516450	16517441	991	16516752
chr11:16520489-16526642	chr11	16520489	16526642	6153	16524052
chr11:16538447-16542473	chr11	16538447	16542473	4026	16539893
chr11:16678482-16682222	chr11	16678482	16682222	3740	16682036
chr11:16727981-16733739	chr11	16727981	16733739	5758	16731172
chr11:18159897-18163940	chr11	18159897	18163940	4043	18161354
chr11:18837341-18844027	chr11	18837341	18844027	6686	18841421
chr11:18898002-18900116	chr11	18898002	18900116	2114	18899724
chr11:18920795-18927373	chr11	18920795	18927373	6578	18924778
chr11:18942942-18948653	chr11	18942942	18948653	5711	18946730
chr11:19135060-19141079	chr11	19135060	19141079	6019	19138487
chr11:19270698-19274012	chr11	19270698	19274012	3314	19271423
chr11:19412119-19418134	chr11	19412119	19418134	6015	19415518
chr11:20342378-20348768	chr11	20342378	20348768	6390	20346202
chr11:20575359-20578922	chr11	20575359	20578922	3563	20576341
chr11:21271922-21278061	chr11	21271922	21278061	6139	21275474
chr11:21849037-21851063	chr11	21849037	21851063	2026	21850246
chr11:22024989-22031095	chr11	22024989	22031095	6106	22028513
chr11:22284807-22290788	chr11	22284807	22290788	5981	22288201
chr11:22698076-22698761	chr11	22698076	22698761	685	22698443
chr11:22908776-22911722	chr11	22908776	22911722	2946	22909133
chr11:23217394-23220757	chr11	23217394	23220757	3363	23218178
chr11:23433712-23435376	chr11	23433712	23435376	1664	23434707
chr11:23483717-23490185	chr11	23483717	23490185	6468	23487603
chr11:23792098-23793412	chr11	23792098	23793412	1314	23792220
chr11:24071413-24074110	chr11	24071413	24074110	2697	24071542
chr11:24217113-24223257	chr11	24217113	24223257	6144	24220659
chr11:24327951-24334001	chr11	24327951	24334001	6050	24331389
chr11:25281775-25282639	chr11	25281775	25282639	864	25282180
chr11:25425132-25431158	chr11	25425132	25431158	6026	25428569
chr11:25758052-25764454	chr11	25758052	25764454	6402	25761871
chr11:25831294-25837418	chr11	25831294	25837418	6124	25834845
chr11:25878633-25879290	chr11	25878633	25879290	657	25878800
chr11:26113513-26119647	chr11	26113513	26119647	6134	26117066
chr11:26171047-26174939	chr11	26171047	26174939	3892	26172351
chr11:26451095-26457233	chr11	26451095	26457233	6138	26454651
chr11:26884216-26888652	chr11	26884216	26888652	4436	26886074
chr11:26965118-26970390	chr11	26965118	26970390	5272	26968554
chr11:27219703-27225732	chr11	27219703	27225732	6029	27223141
chr11:27322937-27327597	chr11	27322937	27327597	4660	27325020
chr11:27665301-27671022	chr11	27665301	27671022	5721	27668837
chr11:27939073-27945209	chr11	27939073	27945209	6136	27942635
chr11:28028159-28031692	chr11	28028159	28031692	3533	28029103
chr11:28395457-28398232	chr11	28395457	28398232	2775	28395670
chr11:28641709-28647430	chr11	28641709	28647430	5721	28644845
chr11:29398532-29401723	chr11	29398532	29401723	3191	29399140
chr11:29416191-29421628	chr11	29416191	29421628	5437	29419040
chr11:29664690-29668806	chr11	29664690	29668806	4116	29666219
chr11:29794460-29798913	chr11	29794460	29798913	4453	29798036
chr11:30178430-30184610	chr11	30178430	30184610	6180	30182015
chr11:30673605-30679948	chr11	30673605	30679948	6343	30677357
chr11:30690687-30693646	chr11	30690687	30693646	2959	30691045
chr11:31356256-31359595	chr11	31356256	31359595	3339	31357011
chr11:31544010-31550144	chr11	31544010	31550144	6134	31547560
chr11:31574193-31579944	chr11	31574193	31579944	5751	31577359
chr11:31740753-31746893	chr11	31740753	31746893	6140	31744316
chr11:31908168-31910986	chr11	31908168	31910986	2818	31908402
chr11:32730794-32734419	chr11	32730794	32734419	3625	32734345
chr11:32762628-32768484	chr11	32762628	32768484	5856	32765881
chr11:33725828-33729678	chr11	33725828	33729678	3850	33727098
chr11:34737532-34742533	chr11	34737532	34742533	5001	34741353
chr11:34952033-34953486	chr11	34952033	34953486	1453	34952264
chr11:34982328-34984096	chr11	34982328	34984096	1768	34982847
chr11:35021978-35028532	chr11	35021978	35028532	6554	35025547
chr11:35053688-35054763	chr11	35053688	35054763	1075	35053952
chr11:35091075-35096771	chr11	35091075	35096771	5696	35094204
chr11:35702778-35708923	chr11	35702778	35708923	6145	35706336
chr11:36528006-36529741	chr11	36528006	36529741	1735	36529066
chr11:36547109-36550276	chr11	36547109	36550276	3167	36547699
chr11:36642088-36644993	chr11	36642088	36644993	2905	36642431
chr11:36676706-36680076	chr11	36676706	36680076	3370	36677300
chr11:38191740-38197885	chr11	38191740	38197885	6145	38195307
chr11:39032080-39034701	chr11	39032080	39034701	2621	39032122
chr11:39603153-39607121	chr11	39603153	39607121	3968	39604538
chr11:39755039-39761185	chr11	39755039	39761185	6146	39758596
chr11:39799211-39800864	chr11	39799211	39800864	1653	39800024
chr11:39809685-39814719	chr11	39809685	39814719	5034	39813501
chr11:39846656-39852654	chr11	39846656	39852654	5998	39850084
chr11:39881060-39887029	chr11	39881060	39887029	5969	39884460
chr11:39888257-39893401	chr11	39888257	39893401	5144	39890816
chr11:39984014-39990193	chr11	39984014	39990193	6179	39987624
chr11:40472304-40475612	chr11	40472304	40475612	3308	40473029
chr11:40910564-40916694	chr11	40910564	40916694	6130	40914121
chr11:41544729-41550920	chr11	41544729	41550920	6191	41548336
chr11:41599627-41603691	chr11	41599627	41603691	4064	41602461
chr11:41741105-41744911	chr11	41741105	41744911	3806	41742329
chr11:42205072-42211284	chr11	42205072	42211284	6212	42208943
chr11:42376823-42382954	chr11	42376823	42382954	6131	42380375
chr11:42457509-42460258	chr11	42457509	42460258	2749	42457666
chr11:42688027-42694165	chr11	42688027	42694165	6138	42691570
chr11:42940332-42946342	chr11	42940332	42946342	6010	42943748
chr11:43777781-43778814	chr11	43777781	43778814	1033	43778409
chr11:44437893-44443444	chr11	44437893	44443444	5551	44440875
chr11:45835877-45839173	chr11	45835877	45839173	3296	45836590
chr11:48292435-48297811	chr11	48292435	48297811	5376	48295994
chr11:48402546-48408474	chr11	48402546	48408474	5928	48405886
chr11:48683044-48689146	chr11	48683044	48689146	6102	48686573
chr11:48733988-48740021	chr11	48733988	48740021	6033	48737456
chr11:48772239-48774452	chr11	48772239	48774452	2213	48772425
chr11:48928309-48931169	chr11	48928309	48931169	2860	48928582
chr11:49139561-49143280	chr11	49139561	49143280	3719	49142237
chr11:49462826-49464580	chr11	49462826	49464580	1754	49462845
chr11:49725283-49731317	chr11	49725283	49731317	6034	49728727
chr11:49866277-49871055	chr11	49866277	49871055	4778	49868468
chr11:49966137-49969290	chr11	49966137	49969290	3153	49967044
chr11:50007064-50009194	chr11	50007064	50009194	2130	50008521
chr11:50148851-50154997	chr11	50148851	50154997	6146	50152414
chr11:50386583-50390022	chr11	50386583	50390022	3439	50387422
chr11:50694434-50700606	chr11	50694434	50700606	6172	50698005
chr11:51120021-51120633	chr11	51120021	51120633	612	51120210
chr11:54552037-54554802	chr11	54552037	54554802	2765	54552226
chr11:54573828-54579737	chr11	54573828	54579737	5909	54577166
chr11:54787353-54790601	chr11	54787353	54790601	3248	54788105
chr11:54833381-54837299	chr11	54833381	54837299	3918	54834720
chr11:54872594-54873594	chr11	54872594	54873594	1000	54872881
chr11:54946966-54952988	chr11	54946966	54952988	6022	54950403
chr11:55084368-55090518	chr11	55084368	55090518	6150	55087944
chr11:55108793-55111876	chr11	55108793	55111876	3083	55109287
chr11:55132715-55138846	chr11	55132715	55138846	6131	55136266
chr11:55374644-55379427	chr11	55374644	55379427	4783	55376850
chr11:55459916-55465937	chr11	55459916	55465937	6021	55463353
chr11:55685640-55691667	chr11	55685640	55691667	6027	55689080
chr11:55747450-55753529	chr11	55747450	55753529	6079	55750957
chr11:55986261-55992017	chr11	55986261	55992017	5756	55989442
chr11:56219465-56225626	chr11	56219465	56225626	6161	56223025
chr11:56508726-56509482	chr11	56508726	56509482	756	56508857
chr11:57062752-57068922	chr11	57062752	57068922	6170	57066325
chr11:57847857-57853995	chr11	57847857	57853995	6138	57851416
chr11:58048699-58051607	chr11	58048699	58051607	2908	58049020
chr11:58413685-58416298	chr11	58413685	58416298	2613	58413717
chr11:58533240-58537670	chr11	58533240	58537670	4430	58535094
chr11:58680860-58684647	chr11	58680860	58684647	3787	58682180
chr11:58752283-58755992	chr11	58752283	58755992	3709	58753405
chr11:58815978-58822098	chr11	58815978	58822098	6120	58819520
chr11:58883251-58884516	chr11	58883251	58884516	1265	58883641
chr11:59015244-59021381	chr11	59015244	59021381	6137	59018803
chr11:60154562-60155664	chr11	60154562	60155664	1102	60154652
chr11:60435417-60441441	chr11	60435417	60441441	6024	60438848
chr11:60472455-60475942	chr11	60472455	60475942	3487	60473353
chr11:60532161-60538190	chr11	60532161	60538190	6029	60535598
chr11:60550393-60556514	chr11	60550393	60556514	6121	60553932
chr11:60602526-60603955	chr11	60602526	60603955	1429	60602955
chr11:60881327-60884732	chr11	60881327	60884732	3405	60884320
chr11:61988536-61991425	chr11	61988536	61991425	2889	61988867
chr11:62288947-62292821	chr11	62288947	62292821	3874	62290250
chr11:63090692-63093863	chr11	63090692	63093863	3171	63091329
chr11:63194685-63198730	chr11	63194685	63198730	4045	63196177
chr11:63201843-63207573	chr11	63201843	63207573	5730	63205728
chr11:63252672-63255207	chr11	63252672	63255207	2535	63254443
chr11:63320932-63326604	chr11	63320932	63326604	5672	63324011
chr11:63418731-63424919	chr11	63418731	63424919	6188	63422304
chr11:63432410-63435303	chr11	63432410	63435303	2893	63433863
chr11:63435303-63441326	chr11	63435303	63441326	6023	63438734
chr11:66093257-66095463	chr11	66093257	66095463	2206	66094620
chr11:71511047-71517198	chr11	71511047	71517198	6151	71514608
chr11:71723727-71729843	chr11	71723727	71729843	6116	71727260
chr11:72990373-72993909	chr11	72990373	72993909	3536	72991286
chr11:73061019-73067491	chr11	73061019	73067491	6472	73064931
chr11:73502118-73505135	chr11	73502118	73505135	3017	73502568
chr11:74059664-74063902	chr11	74059664	74063902	4238	74063202
chr11:74887437-74893565	chr11	74887437	74893565	6128	74890977
chr11:75119297-75125466	chr11	75119297	75125466	6169	75122882
chr11:75748616-75754649	chr11	75748616	75754649	6033	75752053
chr11:76484943-76485722	chr11	76484943	76485722	779	76485122
chr11:76963833-76969955	chr11	76963833	76969955	6122	76967382
chr11:77326704-77331796	chr11	77326704	77331796	5092	77329208
chr11:78482231-78485415	chr11	78482231	78485415	3184	78482815
chr11:79552653-79558680	chr11	79552653	79558680	6027	79556089
chr11:79586089-79591129	chr11	79586089	79591129	5040	79589675
chr11:79791242-79793546	chr11	79791242	79793546	2304	79792996
chr11:80109374-80115526	chr11	80109374	80115526	6152	80112932
chr11:80505265-80511240	chr11	80505265	80511240	5975	80508662
chr11:80792594-80793907	chr11	80792594	80793907	1313	80793583
chr11:81902310-81904448	chr11	81902310	81904448	2138	81903603
chr11:82119965-82126106	chr11	82119965	82126106	6141	82123516
chr11:82155865-82161891	chr11	82155865	82161891	6026	82159299
chr11:82278300-82283489	chr11	82278300	82283489	5189	82280901
chr11:82343196-82345921	chr11	82343196	82345921	2725	82345191
chr11:82578244-82581134	chr11	82578244	82581134	2890	82579086
chr11:83266134-83272255	chr11	83266134	83272255	6121	83269731
chr11:83395764-83397298	chr11	83395764	83397298	1534	83396813
chr11:83587648-83593656	chr11	83587648	83593656	6008	83591065
chr11:83883955-83890123	chr11	83883955	83890123	6168	83887523
chr11:85067563-85070299	chr11	85067563	85070299	2736	85067710
chr11:85324758-85330821	chr11	85324758	85330821	6063	85328198
chr11:85395285-85398909	chr11	85395285	85398909	3624	85398850
chr11:85425651-85429354	chr11	85425651	85429354	3703	85429202
chr11:85728961-85732753	chr11	85728961	85732753	3792	85730167
chr11:86365785-86366957	chr11	86365785	86366957	1172	86365938
chr11:86525882-86531985	chr11	86525882	86531985	6103	86529431
chr11:86540838-86546956	chr11	86540838	86546956	6118	86544732
chr11:86597959-86604108	chr11	86597959	86604108	6149	86601527
chr11:86647504-86650611	chr11	86647504	86650611	3107	86648893
chr11:86650612-86656759	chr11	86650612	86656759	6147	86654170
chr11:86841369-86844421	chr11	86841369	86844421	3052	86841856
chr11:87047304-87053192	chr11	87047304	87053192	5888	87050739
chr11:87796719-87797764	chr11	87796719	87797764	1045	87797415
chr11:88027243-88033390	chr11	88027243	88033390	6147	88030802
chr11:88240494-88246620	chr11	88240494	88246620	6126	88244035
chr11:88322536-88324327	chr11	88322536	88324327	1791	88322843
chr11:88747848-88753722	chr11	88747848	88753722	5874	88751529
chr11:88986995-88993027	chr11	88986995	88993027	6032	88990436
chr11:89208969-89214719	chr11	89208969	89214719	5750	89212511
chr11:89396490-89398473	chr11	89396490	89398473	1983	89397890
chr11:89426247-89432359	chr11	89426247	89432359	6112	89429778
chr11:89685485-89686885	chr11	89685485	89686885	1400	89685676
chr11:89744187-89750239	chr11	89744187	89750239	6052	89747626
chr11:89789780-89795896	chr11	89789780	89795896	6116	89793307
chr11:90878701-90883582	chr11	90878701	90883582	4881	90881022
chr11:90973126-90977675	chr11	90973126	90977675	4549	90975699
chr11:91580022-91583073	chr11	91580022	91583073	3051	91580514
chr11:91681688-91684669	chr11	91681688	91684669	2981	91682082
chr11:91916333-91919003	chr11	91916333	91919003	2670	91916416
chr11:92026888-92033124	chr11	92026888	92033124	6236	92030316
chr11:92072534-92078671	chr11	92072534	92078671	6137	92076092
chr11:92093884-92096693	chr11	92093884	92096693	2809	92094075
chr11:92169399-92175577	chr11	92169399	92175577	6178	92172987
chr11:92563648-92568055	chr11	92563648	92568055	4407	92565461
chr11:93042915-93048028	chr11	93042915	93048028	5113	93046461
chr11:93136638-93142673	chr11	93136638	93142673	6035	93140081
chr11:93416132-93419195	chr11	93416132	93419195	3063	93416603
chr11:93419892-93420986	chr11	93419892	93420986	1094	93419988
chr11:93420986-93427031	chr11	93420986	93427031	6045	93424415
chr11:93458095-93464200	chr11	93458095	93464200	6105	93461629
chr11:94036857-94042888	chr11	94036857	94042888	6031	94040296
chr11:94191483-94192297	chr11	94191483	94192297	814	94191588
chr11:94248082-94254191	chr11	94248082	94254191	6109	94251605
chr11:94317027-94319200	chr11	94317027	94319200	2173	94317370
chr11:94358728-94364906	chr11	94358728	94364906	6178	94362323
chr11:94370376-94376521	chr11	94370376	94376521	6145	94373928
chr11:94383179-94384356	chr11	94383179	94384356	1177	94383907
chr11:94386320-94390332	chr11	94386320	94390332	4012	94387752
chr11:95436216-95442246	chr11	95436216	95442246	6030	95439654
chr11:95806256-95810906	chr11	95806256	95810906	4650	95809774
chr11:96486837-96493112	chr11	96486837	96493112	6275	96490523
chr11:96545004-96551177	chr11	96545004	96551177	6173	96548592
chr11:96555590-96561739	chr11	96555590	96561739	6149	96559150
chr11:96910223-96914059	chr11	96910223	96914059	3836	96911490
chr11:97052841-97055788	chr11	97052841	97055788	2947	97053220
chr11:97301459-97304111	chr11	97301459	97304111	2652	97301534
chr11:97438273-97441150	chr11	97438273	97441150	2877	97438639
chr11:97539143-97543225	chr11	97539143	97543225	4082	97540636
chr11:97924357-97927400	chr11	97924357	97927400	3043	97924830
chr11:98202165-98203701	chr11	98202165	98203701	1536	98202484
chr11:98275428-98276845	chr11	98275428	98276845	1417	98275769
chr11:98996452-99002585	chr11	98996452	99002585	6133	99000002
chr11:99602687-99608113	chr11	99602687	99608113	5426	99605520
chr11:99997348-100000168	chr11	99997348	100000168	2820	99997579
chr11:100256503-100262951	chr11	100256503	100262951	6448	100260369
chr11:100285746-100291751	chr11	100285746	100291751	6005	100289183
chr11:100387927-100390279	chr11	100387927	100390279	2352	100388355
chr11:100409041-100415069	chr11	100409041	100415069	6028	100412485
chr11:100451858-100457873	chr11	100451858	100457873	6015	100455294
chr11:100490805-100494812	chr11	100490805	100494812	4007	100492253
chr11:100653110-100658521	chr11	100653110	100658521	5411	100655932
chr11:101070024-101076471	chr11	101070024	101076471	6447	101073905
chr11:101566590-101573018	chr11	101566590	101573018	6428	101570447
chr11:101638966-101645043	chr11	101638966	101645043	6077	101642462
chr11:101645061-101647532	chr11	101645061	101647532	2471	101645631
chr11:101852489-101858627	chr11	101852489	101858627	6138	101856053
chr11:102438621-102443957	chr11	102438621	102443957	5336	102442125
chr11:103261140-103265032	chr11	103261140	103265032	3892	103264279
chr11:103418550-103422959	chr11	103418550	103422959	4409	103422265
chr11:103501413-103506608	chr11	103501413	103506608	5195	103504050
chr11:103611231-103617451	chr11	103611231	103617451	6220	103614916
chr11:103739706-103743731	chr11	103739706	103743731	4025	103741102
chr11:103757743-103759733	chr11	103757743	103759733	1990	103759675
chr11:103914366-103917094	chr11	103914366	103917094	2728	103914523
chr11:103976890-103977501	chr11	103976890	103977501	611	103977266
chr11:104100240-104103062	chr11	104100240	104103062	2822	104100538
chr11:104211624-104212491	chr11	104211624	104212491	867	104212355
chr11:105016295-105022323	chr11	105016295	105022323	6028	105019730
chr11:105725600-105732037	chr11	105725600	105732037	6437	105729428
chr11:106797352-106800899	chr11	106797352	106800899	3547	106798338
chr11:107293729-107299820	chr11	107293729	107299820	6091	107297266
chr11:107361810-107367839	chr11	107361810	107367839	6029	107365248
chr11:107372762-107378780	chr11	107372762	107378780	6018	107376188
chr11:108260626-108266643	chr11	108260626	108266643	6017	108264055
chr11:108356931-108362967	chr11	108356931	108362967	6036	108360370
chr11:108373536-108379636	chr11	108373536	108379636	6100	108377054
chr11:108424481-108427439	chr11	108424481	108427439	2958	108425571
chr11:108440855-108444618	chr11	108440855	108444618	3763	108444392
chr11:108446754-108450784	chr11	108446754	108450784	4030	108448208
chr11:109401913-109405316	chr11	109401913	109405316	3403	109402728
chr11:109446515-109450777	chr11	109446515	109450777	4262	109448181
chr11:109468118-109471142	chr11	109468118	109471142	3024	109468601
chr11:109540689-109544320	chr11	109540689	109544320	3631	109541736
chr11:109571832-109577059	chr11	109571832	109577059	5227	109574478
chr11:110208986-110215001	chr11	110208986	110215001	6015	110212409
chr11:110594653-110597292	chr11	110594653	110597292	2639	110594713
chr11:110650950-110654211	chr11	110650950	110654211	3261	110651812
chr11:113223947-113230094	chr11	113223947	113230094	6147	113227506
chr11:113656606-113662757	chr11	113656606	113662757	6151	113660167
chr11:114488448-114490880	chr11	114488448	114490880	2432	114489283
chr11:114533301-114539446	chr11	114533301	114539446	6145	114536856
chr11:114625663-114631683	chr11	114625663	114631683	6020	114629096
chr11:114805224-114811348	chr11	114805224	114811348	6124	114808767
chr11:115966933-115973116	chr11	115966933	115973116	6183	115970497
chr11:116004927-116011056	chr11	116004927	116011056	6129	116008459
chr11:116570827-116576273	chr11	116570827	116576273	5446	116573694
chr11:116666718-116672862	chr11	116666718	116672862	6144	116670286
chr11:117567574-117569403	chr11	117567574	117569403	1829	117567797
chr11:121823853-121827182	chr11	121823853	121827182	3329	121827154
chr11:121858390-121861346	chr11	121858390	121861346	2956	121858764
chr11:124391167-124394260	chr11	124391167	124394260	3093	124391686
chr11:124505575-124506734	chr11	124505575	124506734	1159	124505648
chr11:124553981-124555672	chr11	124553981	124555672	1691	124554502
chr11:125536609-125542640	chr11	125536609	125542640	6031	125540048
chr11:125705267-125711134	chr11	125705267	125711134	5867	125708533
chr11:125755621-125761159	chr11	125755621	125761159	5538	125759521
chr11:125781612-125784694	chr11	125781612	125784694	3082	125782115
chr11:125817651-125824101	chr11	125817651	125824101	6450	125821504
chr11:125847556-125849255	chr11	125847556	125849255	1699	125848462
chr11:125857351-125862216	chr11	125857351	125862216	4865	125860895
chr11:127363161-127369219	chr11	127363161	127369219	6058	127366601
chr11:128107858-128112890	chr11	128107858	128112890	5032	128110659
chr11:128140057-128146214	chr11	128140057	128146214	6157	128143626
chr11:129173064-129173934	chr11	129173064	129173934	870	129173393
chr11:129173931-129179956	chr11	129173931	129179956	6025	129177361
chr11:129466752-129472373	chr11	129466752	129472373	5621	129470613
chr11:129712548-129718661	chr11	129712548	129718661	6113	129716089
chr11:129754066-129756932	chr11	129754066	129756932	2866	129754369
chr11:130984263-130990292	chr11	130984263	130990292	6029	130987701
chr11:131312995-131318678	chr11	131312995	131318678	5683	131316097
chr11:132320160-132326183	chr11	132320160	132326183	6023	132323600
chr11:132383419-132389564	chr11	132383419	132389564	6145	132386978
chr11:132479021-132485078	chr11	132479021	132485078	6057	132482494
chr11:133640803-133646828	chr11	133640803	133646828	6025	133644236
chr11:134102196-134107483	chr11	134102196	134107483	5287	134104930
chr11:135013698-135015059	chr11	135013698	135015059	1361	135015039
chr11_GL383547v1_alt:117102-117966	chr11_GL383547v1_alt	117102	117966	864	117507
chr11_JH159136v1_alt:30214-36375	chr11_JH159136v1_alt	30214	36375	6161	33774
chr11_KI270829v1_alt:9248-12073	chr11_KI270829v1_alt	9248	12073	2825	9483
chr11_KI270829v1_alt:92539-98571	chr11_KI270829v1_alt	92539	98571	6032	95978
chr12:297986-303663	chr12	297986	303663	5677	301102
chr12:342806-348918	chr12	342806	348918	6112	346337
chr12:1941788-1946024	chr12	1941788	1946024	4236	1943361
chr12:2699497-2705642	chr12	2699497	2705642	6145	2703063
chr12:3400018-3400864	chr12	3400018	3400864	846	3400583
chr12:3851135-3857278	chr12	3851135	3857278	6143	3854704
chr12:4341374-4346760	chr12	4341374	4346760	5386	4344301
chr12:4508895-4514901	chr12	4508895	4514901	6006	4512314
chr12:7251131-7257263	chr12	7251131	7257263	6132	7254677
chr12:7333084-7336673	chr12	7333084	7336673	3589	7334064
chr12:7391623-7395604	chr12	7391623	7395604	3981	7392996
chr12:7471615-7477767	chr12	7471615	7477767	6152	7475162
chr12:7528950-7533889	chr12	7528950	7533889	4939	7532060
chr12:7547024-7550091	chr12	7547024	7550091	3067	7547503
chr12:7550835-7555334	chr12	7550835	7555334	4499	7552756
chr12:7593929-7600343	chr12	7593929	7600343	6414	7597747
chr12:9579440-9582450	chr12	9579440	9582450	3010	9579870
chr12:9612436-9615106	chr12	9612436	9615106	2670	9613877
chr12:10481371-10487825	chr12	10481371	10487825	6454	10485244
chr12:11108364-11114661	chr12	11108364	11114661	6297	11112227
chr12:11290236-11296361	chr12	11290236	11296361	6125	11293795
chr12:11297656-11303685	chr12	11297656	11303685	6029	11301093
chr12:11314839-11320374	chr12	11314839	11320374	5535	11317780
chr12:11377197-11383318	chr12	11377197	11383318	6121	11380728
chr12:11416212-11422143	chr12	11416212	11422143	5931	11419723
chr12:11909149-11915316	chr12	11909149	11915316	6167	11912728
chr12:11937474-11938770	chr12	11937474	11938770	1296	11937833
chr12:14035475-14041916	chr12	14035475	14041916	6441	14039351
chr12:14080059-14085561	chr12	14080059	14085561	5502	14082982
chr12:16998318-17004469	chr12	16998318	17004469	6151	17001881
chr12:17048924-17052207	chr12	17048924	17052207	3283	17049642
chr12:17099469-17102612	chr12	17099469	17102612	3143	17100058
chr12:17116319-17121003	chr12	17116319	17121003	4684	17119921
chr12:17175732-17179669	chr12	17175732	17179669	3937	17177108
chr12:17805863-17808540	chr12	17805863	17808540	2677	17808055
chr12:17822598-17824584	chr12	17822598	17824584	1986	17824193
chr12:17855568-17861565	chr12	17855568	17861565	5997	17858980
chr12:18023799-18029914	chr12	18023799	18029914	6115	18027334
chr12:18092478-18094314	chr12	18092478	18094314	1836	18094171
chr12:18760652-18767006	chr12	18760652	18767006	6354	18764426
chr12:18785211-18791371	chr12	18785211	18791371	6160	18788782
chr12:18832232-18835217	chr12	18832232	18835217	2985	18832468
chr12:19566569-19569155	chr12	19566569	19569155	2586	19567639
chr12:20667835-20673859	chr12	20667835	20673859	6024	20671273
chr12:20769060-20775103	chr12	20769060	20775103	6043	20772516
chr12:20951885-20957242	chr12	20951885	20957242	5357	20954673
chr12:21004485-21008832	chr12	21004485	21008832	4347	21006255
chr12:21284395-21288024	chr12	21284395	21288024	3629	21285432
chr12:21360435-21366557	chr12	21360435	21366557	6122	21363971
chr12:21395009-21401039	chr12	21395009	21401039	6030	21398449
chr12:21419215-21425234	chr12	21419215	21425234	6019	21422643
chr12:21899335-21905423	chr12	21899335	21905423	6088	21902865
chr12:21962207-21968366	chr12	21962207	21968366	6159	21965784
chr12:22136530-22141795	chr12	22136530	22141795	5265	22139958
chr12:22147464-22152713	chr12	22147464	22152713	5249	22150126
chr12:22341807-22346899	chr12	22341807	22346899	5092	22344312
chr12:22365617-22372074	chr12	22365617	22372074	6457	22369492
chr12:22400101-22406177	chr12	22400101	22406177	6076	22403663
chr12:23092101-23092812	chr12	23092101	23092812	711	23092782
chr12:23145836-23152003	chr12	23145836	23152003	6167	23149408
chr12:23263444-23267142	chr12	23263444	23267142	3698	23264657
chr12:23390815-23395133	chr12	23390815	23395133	4318	23392550
chr12:25536714-25542734	chr12	25536714	25542734	6020	25540149
chr12:26669557-26675709	chr12	26669557	26675709	6152	26673118
chr12:27404617-27410753	chr12	27404617	27410753	6136	27408167
chr12:28274908-28276092	chr12	28274908	28276092	1184	28275545
chr12:28476162-28479631	chr12	28476162	28479631	3469	28477047
chr12:28637770-28639858	chr12	28637770	28639858	2088	28637937
chr12:28668130-28672944	chr12	28668130	28672944	4814	28671989
chr12:28761118-28766054	chr12	28761118	28766054	4936	28763532
chr12:29094457-29098318	chr12	29094457	29098318	3861	29095738
chr12:29323061-29328907	chr12	29323061	29328907	5846	29326326
chr12:29809726-29815750	chr12	29809726	29815750	6024	29813163
chr12:29848460-29853868	chr12	29848460	29853868	5408	29852028
chr12:29909925-29916045	chr12	29909925	29916045	6120	29913461
chr12:29975439-29977229	chr12	29975439	29977229	1790	29976464
chr12:30289976-30294305	chr12	30289976	30294305	4329	30291715
chr12:30588353-30594511	chr12	30588353	30594511	6158	30591923
chr12:31163074-31169094	chr12	31163074	31169094	6020	31166507
chr12:32956152-32962330	chr12	32956152	32962330	6178	32959742
chr12:33167081-33170215	chr12	33167081	33170215	3134	33167638
chr12:33227564-33233714	chr12	33227564	33233714	6150	33231120
chr12:33244058-33245429	chr12	33244058	33245429	1371	33244341
chr12:33331933-33337877	chr12	33331933	33337877	5944	33335288
chr12:33462452-33468881	chr12	33462452	33468881	6429	33466296
chr12:33492257-33496422	chr12	33492257	33496422	4165	33496195
chr12:33520769-33526864	chr12	33520769	33526864	6095	33524294
chr12:33737922-33743488	chr12	33737922	33743488	5566	33738010
chr12:33772866-33779014	chr12	33772866	33779014	6148	33776428
chr12:33930454-33936566	chr12	33930454	33936566	6112	33933988
chr12:34072846-34077155	chr12	34072846	34077155	4309	34074578
chr12:34083240-34089338	chr12	34083240	34089338	6098	34086759
chr12:34136935-34138002	chr12	34136935	34138002	1067	34137237
chr12:34430990-34436376	chr12	34430990	34436376	5386	34434563
chr12:34476303-34482455	chr12	34476303	34482455	6152	34479867
chr12:34575279-34578355	chr12	34575279	34578355	3076	34575787
chr12:34639544-34645673	chr12	34639544	34645673	6129	34643088
chr12:37681608-37687760	chr12	37681608	37687760	6152	37685177
chr12:37761699-37767610	chr12	37761699	37767610	5911	37765271
chr12:37786910-37793054	chr12	37786910	37793054	6144	37790483
chr12:37866398-37869113	chr12	37866398	37869113	2715	37866654
chr12:37892404-37898542	chr12	37892404	37898542	6138	37895956
chr12:38091335-38097473	chr12	38091335	38097473	6138	38094889
chr12:38207327-38213335	chr12	38207327	38213335	6008	38210767
chr12:38383679-38384834	chr12	38383679	38384834	1155	38384325
chr12:38510610-38512091	chr12	38510610	38512091	1481	38511899
chr12:38534032-38538270	chr12	38534032	38538270	4238	38535706
chr12:38801629-38805673	chr12	38801629	38805673	4044	38803081
chr12:38987676-38992577	chr12	38987676	38992577	4901	38991241
chr12:39263041-39265885	chr12	39263041	39265885	2844	39263298
chr12:39699134-39705085	chr12	39699134	39705085	5951	39702508
chr12:39745958-39752060	chr12	39745958	39752060	6102	39749494
chr12:39978316-39984339	chr12	39978316	39984339	6023	39981750
chr12:41281820-41286015	chr12	41281820	41286015	4195	41283435
chr12:41672452-41678469	chr12	41672452	41678469	6017	41675883
chr12:41806941-41809755	chr12	41806941	41809755	2814	41807148
chr12:42062980-42069120	chr12	42062980	42069120	6140	42066533
chr12:42111145-42117288	chr12	42111145	42117288	6143	42114704
chr12:42707902-42714407	chr12	42707902	42714407	6505	42711858
chr12:43227726-43233750	chr12	43227726	43233750	6024	43231162
chr12:43470973-43477008	chr12	43470973	43477008	6035	43474413
chr12:43609486-43612980	chr12	43609486	43612980	3494	43610398
chr12:43906481-43912505	chr12	43906481	43912505	6024	43909918
chr12:43950844-43957315	chr12	43950844	43957315	6471	43954706
chr12:44559048-44563322	chr12	44559048	44563322	4274	44560755
chr12:44741317-44747454	chr12	44741317	44747454	6137	44744877
chr12:44901020-44904044	chr12	44901020	44904044	3024	44901473
chr12:44931705-44937883	chr12	44931705	44937883	6178	44935266
chr12:44950958-44956988	chr12	44950958	44956988	6030	44954396
chr12:45370846-45376865	chr12	45370846	45376865	6019	45374277
chr12:45391883-45397988	chr12	45391883	45397988	6105	45395415
chr12:46249179-46252485	chr12	46249179	46252485	3306	46249912
chr12:46283516-46289653	chr12	46283516	46289653	6137	46287065
chr12:46617497-46623643	chr12	46617497	46623643	6146	46621055
chr12:46736988-46743143	chr12	46736988	46743143	6155	46740548
chr12:46848914-46854701	chr12	46848914	46854701	5787	46852123
chr12:46878360-46881844	chr12	46878360	46881844	3484	46879283
chr12:46991807-46997956	chr12	46991807	46997956	6149	46995373
chr12:47056718-47062860	chr12	47056718	47062860	6142	47060274
chr12:47426904-47432928	chr12	47426904	47432928	6024	47430338
chr12:47497429-47503706	chr12	47497429	47503706	6277	47501126
chr12:47623858-47630302	chr12	47623858	47630302	6444	47627709
chr12:47674233-47679408	chr12	47674233	47679408	5175	47676815
chr12:48433779-48439935	chr12	48433779	48439935	6156	48437325
chr12:48450208-48453519	chr12	48450208	48453519	3311	48450901
chr12:48474255-48478717	chr12	48474255	48478717	4462	48477821
chr12:48575797-48578483	chr12	48575797	48578483	2686	48575891
chr12:50972506-50978654	chr12	50972506	50978654	6148	50976066
chr12:54715264-54715435	chr12	54715264	54715435	171	54715317
chr12:54776760-54782882	chr12	54776760	54782882	6122	54780301
chr12:54788573-54794627	chr12	54788573	54794627	6054	54792010
chr12:55212275-55215393	chr12	55212275	55215393	3118	55212804
chr12:55344249-55350274	chr12	55344249	55350274	6025	55347688
chr12:55354942-55361385	chr12	55354942	55361385	6443	55358804
chr12:55459311-55465456	chr12	55459311	55465456	6145	55462885
chr12:55484008-55490018	chr12	55484008	55490018	6010	55487447
chr12:55560427-55566502	chr12	55560427	55566502	6075	55563911
chr12:55589937-55595956	chr12	55589937	55595956	6019	55593369
chr12:55600175-55604209	chr12	55600175	55604209	4034	55601630
chr12:56958252-56962811	chr12	56958252	56962811	4559	56961818
chr12:56969220-56973772	chr12	56969220	56973772	4552	56971866
chr12:57646479-57652498	chr12	57646479	57652498	6019	57649907
chr12:58059698-58064020	chr12	58059698	58064020	4322	58061432
chr12:58426228-58431150	chr12	58426228	58431150	4922	58429419
chr12:59480490-59481230	chr12	59480490	59481230	740	59480510
chr12:59751112-59757266	chr12	59751112	59757266	6154	59754681
chr12:59795551-59800630	chr12	59795551	59800630	5079	59799443
chr12:59947857-59950273	chr12	59947857	59950273	2416	59950214
chr12:60009851-60010208	chr12	60009851	60010208	357	60010139
chr12:60234374-60240763	chr12	60234374	60240763	6389	60238201
chr12:60621863-60623523	chr12	60621863	60623523	1660	60623300
chr12:60726550-60729353	chr12	60726550	60729353	2803	60726781
chr12:61076642-61080156	chr12	61076642	61080156	3514	61077570
chr12:61293783-61299916	chr12	61293783	61299916	6133	61297329
chr12:61316746-61322871	chr12	61316746	61322871	6125	61320279
chr12:61922302-61926790	chr12	61922302	61926790	4488	61926268
chr12:61941440-61947489	chr12	61941440	61947489	6049	61944879
chr12:62819802-62825895	chr12	62819802	62825895	6093	62823318
chr12:63196230-63201619	chr12	63196230	63201619	5389	63199784
chr12:63240421-63246538	chr12	63240421	63246538	6117	63243947
chr12:63336890-63343011	chr12	63336890	63343011	6121	63340437
chr12:63377801-63382834	chr12	63377801	63382834	5033	63380524
chr12:63634328-63640363	chr12	63634328	63640363	6035	63637782
chr12:64195587-64201638	chr12	64195587	64201638	6051	64199026
chr12:65350357-65353035	chr12	65350357	65353035	2678	65351887
chr12:65979436-65983361	chr12	65979436	65983361	3925	65980792
chr12:66474950-66479034	chr12	66474950	66479034	4084	66476440
chr12:66521519-66527684	chr12	66521519	66527684	6165	66525104
chr12:66578267-66584409	chr12	66578267	66584409	6142	66581829
chr12:67176333-67179977	chr12	67176333	67179977	3644	67177376
chr12:67900208-67906224	chr12	67900208	67906224	6016	67903637
chr12:68991049-68997194	chr12	68991049	68997194	6145	68994595
chr12:69938700-69944697	chr12	69938700	69944697	5997	69942109
chr12:70013065-70019080	chr12	70013065	70019080	6015	70016491
chr12:70629203-70632590	chr12	70629203	70632590	3387	70630019
chr12:70765020-70771163	chr12	70765020	70771163	6143	70768583
chr12:70865932-70869194	chr12	70865932	70869194	3262	70866606
chr12:71098373-71103641	chr12	71098373	71103641	5268	71101049
chr12:71118072-71124103	chr12	71118072	71124103	6031	71121511
chr12:72363161-72364213	chr12	72363161	72364213	1052	72363196
chr12:73394809-73400830	chr12	73394809	73400830	6021	73398242
chr12:73605703-73611829	chr12	73605703	73611829	6126	73609255
chr12:73671102-73676670	chr12	73671102	73676670	5568	73674954
chr12:73704838-73706621	chr12	73704838	73706621	1783	73706045
chr12:73924144-73928591	chr12	73924144	73928591	4447	73927705
chr12:73977927-73983898	chr12	73977927	73983898	5971	73981308
chr12:74057874-74061703	chr12	74057874	74061703	3829	74059122
chr12:74676081-74682532	chr12	74676081	74682532	6451	74679962
chr12:74874868-74880901	chr12	74874868	74880901	6033	74878313
chr12:76319624-76325685	chr12	76319624	76325685	6061	76323105
chr12:77289627-77292683	chr12	77289627	77292683	3056	77290111
chr12:77459286-77464442	chr12	77459286	77464442	5156	77462836
chr12:77653964-77660122	chr12	77653964	77660122	6158	77657531
chr12:78071769-78073881	chr12	78071769	78073881	2112	78072610
chr12:78506430-78512587	chr12	78506430	78512587	6157	78509993
chr12:79861341-79867483	chr12	79861341	79867483	6142	79864892
chr12:80386465-80391946	chr12	80386465	80391946	5481	80389366
chr12:80461876-80468017	chr12	80461876	80468017	6141	80465429
chr12:80477525-80483539	chr12	80477525	80483539	6014	80480948
chr12:81066507-81070729	chr12	81066507	81070729	4222	81068153
chr12:81242146-81243735	chr12	81242146	81243735	1589	81242432
chr12:81659078-81665195	chr12	81659078	81665195	6117	81662625
chr12:82049319-82051986	chr12	82049319	82051986	2667	82049412
chr12:82421549-82424541	chr12	82421549	82424541	2992	82421971
chr12:82586785-82591325	chr12	82586785	82591325	4540	82588750
chr12:83584266-83590245	chr12	83584266	83590245	5979	83587651
chr12:83591424-83595687	chr12	83591424	83595687	4263	83593133
chr12:83681244-83687694	chr12	83681244	83687694	6450	83685115
chr12:83870966-83874655	chr12	83870966	83874655	3689	83874521
chr12:83902895-83903384	chr12	83902895	83903384	489	83903172
chr12:84020771-84024813	chr12	84020771	84024813	4042	84022223
chr12:84372282-84374137	chr12	84372282	84374137	1855	84373588
chr12:85193158-85197837	chr12	85193158	85197837	4679	85195247
chr12:85785425-85791541	chr12	85785425	85791541	6116	85788972
chr12:86064408-86067714	chr12	86064408	86067714	3306	86065135
chr12:86356355-86362494	chr12	86356355	86362494	6139	86359904
chr12:86491085-86493794	chr12	86491085	86493794	2709	86491219
chr12:86588200-86589822	chr12	86588200	86589822	1622	86589477
chr12:86626745-86632913	chr12	86626745	86632913	6168	86630327
chr12:86844303-86847823	chr12	86844303	86847823	3520	86845237
chr12:86917616-86921015	chr12	86917616	86921015	3399	86918431
chr12:86970395-86976516	chr12	86970395	86976516	6121	86973962
chr12:87098406-87104423	chr12	87098406	87104423	6017	87101841
chr12:87171407-87177572	chr12	87171407	87177572	6165	87175001
chr12:87393951-87400055	chr12	87393951	87400055	6104	87397480
chr12:87530986-87537086	chr12	87530986	87537086	6100	87534498
chr12:87543527-87547642	chr12	87543527	87547642	4115	87545040
chr12:87631494-87633787	chr12	87631494	87633787	2293	87633089
chr12:87680999-87683689	chr12	87680999	87683689	2690	87681876
chr12:87946095-87949350	chr12	87946095	87949350	3255	87946760
chr12:88241440-88242089	chr12	88241440	88242089	649	88241696
chr12:88402508-88406728	chr12	88402508	88406728	4220	88404143
chr12:88605044-88609438	chr12	88605044	88609438	4394	88607912
chr12:88667150-88673604	chr12	88667150	88673604	6454	88671028
chr12:88846991-88853008	chr12	88846991	88853008	6017	88850425
chr12:88939293-88940965	chr12	88939293	88940965	1672	88939545
chr12:89440653-89446709	chr12	89440653	89446709	6056	89444179
chr12:90536603-90542635	chr12	90536603	90542635	6032	90540043
chr12:90926476-90929319	chr12	90926476	90929319	2843	90927382
chr12:91232056-91235665	chr12	91232056	91235665	3609	91233072
chr12:91803832-91810633	chr12	91803832	91810633	6801	91808038
chr12:92313998-92320023	chr12	92313998	92320023	6025	92317431
chr12:92789554-92793820	chr12	92789554	92793820	4266	92792705
chr12:92916601-92921762	chr12	92916601	92921762	5161	92919170
chr12:93559696-93562370	chr12	93559696	93562370	2674	93559781
chr12:94389499-94395161	chr12	94389499	94395161	5662	94393050
chr12:94822819-94829012	chr12	94822819	94829012	6193	94826362
chr12:95775205-95781318	chr12	95775205	95781318	6113	95778735
chr12:96315942-96321971	chr12	96315942	96321971	6029	96319373
chr12:96610411-96616519	chr12	96610411	96616519	6108	96613937
chr12:96639123-96642091	chr12	96639123	96642091	2968	96639503
chr12:97675759-97679095	chr12	97675759	97679095	3336	97676509
chr12:97723839-97729872	chr12	97723839	97729872	6033	97727281
chr12:98201682-98207271	chr12	98201682	98207271	5589	98205553
chr12:98310768-98316912	chr12	98310768	98316912	6144	98314324
chr12:99237939-99244029	chr12	99237939	99244029	6090	99241472
chr12:99312772-99314962	chr12	99312772	99314962	2190	99313341
chr12:99463307-99469450	chr12	99463307	99469450	6143	99466863
chr12:99992547-99995755	chr12	99992547	99995755	3208	99993158
chr12:100010759-100016815	chr12	100010759	100016815	6056	100014252
chr12:101029922-101033475	chr12	101029922	101033475	3553	101031009
chr12:101148022-101152064	chr12	101148022	101152064	4042	101149472
chr12:101152060-101155141	chr12	101152060	101155141	3081	101152551
chr12:101388254-101392205	chr12	101388254	101392205	3951	101389610
chr12:102238500-102241404	chr12	102238500	102241404	2904	102238824
chr12:102856330-102861982	chr12	102856330	102861982	5652	102859398
chr12:103297375-103298605	chr12	103297375	103298605	1230	103297528
chr12:103425913-103431106	chr12	103425913	103431106	5193	103428543
chr12:103434388-103440411	chr12	103434388	103440411	6023	103437830
chr12:105245853-105251970	chr12	105245853	105251970	6117	105249377
chr12:105628261-105634450	chr12	105628261	105634450	6189	105631705
chr12:105776064-105782085	chr12	105776064	105782085	6021	105779506
chr12:106164692-106169618	chr12	106164692	106169618	4926	106167013
chr12:106397864-106403971	chr12	106397864	106403971	6107	106401386
chr12:107082035-107085835	chr12	107082035	107085835	3800	107083266
chr12:107186191-107191200	chr12	107186191	107191200	5009	107188630
chr12:107722740-107728264	chr12	107722740	107728264	5524	107725683
chr12:107861951-107864193	chr12	107861951	107864193	2242	107863389
chr12:107921469-107923333	chr12	107921469	107923333	1864	107921506
chr12:108996947-109002973	chr12	108996947	109002973	6026	109000385
chr12:111960521-111963812	chr12	111960521	111963812	3291	111961248
chr12:112621197-112627228	chr12	112621197	112627228	6031	112624630
chr12:115285122-115291136	chr12	115285122	115291136	6014	115288560
chr12:125477702-125483252	chr12	125477702	125483252	5550	125480683
chr12:125600750-125604625	chr12	125600750	125604625	3875	125602037
chr12:127865855-127871882	chr12	127865855	127871882	6027	127869291
chr12:129800701-129806706	chr12	129800701	129806706	6005	129804114
chr12:133244941-133251091	chr12	133244941	133251091	6150	133248497
chr12_GL383549v1_alt:37302-43322	chr12_GL383549v1_alt	37302	43322	6020	40743
chr12_GL383549v1_alt:108758-113843	chr12_GL383549v1_alt	108758	113843	5085	111229
chr12_GL383550v2_alt:19955-26042	chr12_GL383550v2_alt	19955	26042	6087	23815
chr12_GL383550v2_alt:42213-48233	chr12_GL383550v2_alt	42213	48233	6020	45653
chr12_GL383550v2_alt:78629-84770	chr12_GL383550v2_alt	78629	84770	6141	82196
chr12_GL383553v2_alt:138462-140490	chr12_GL383553v2_alt	138462	140490	2028	138497
chr12_GL877876v1_alt:339031-345329	chr12_GL877876v1_alt	339031	345329	6298	342895
chr12_KI270835v1_alt:53868-59888	chr12_KI270835v1_alt	53868	59888	6020	57301
chr12_KI270904v1_alt:303393-309691	chr12_KI270904v1_alt	303393	309691	6298	307257
chr12_KI270904v1_alt:485199-491324	chr12_KI270904v1_alt	485199	491324	6125	488758
chr12_KI270904v1_alt:492619-498648	chr12_KI270904v1_alt	492619	498648	6029	496056
chr12_KI270904v1_alt:509802-515337	chr12_KI270904v1_alt	509802	515337	5535	512743
chr13:18443055-18445692	chr13	18443055	18445692	2637	18443112
chr13:18503477-18509621	chr13	18503477	18509621	6144	18507038
chr13:18630874-18635174	chr13	18630874	18635174	4300	18634399
chr13:18983771-18989849	chr13	18983771	18989849	6078	18987279
chr13:19272995-19279012	chr13	19272995	19279012	6017	19276425
chr13:19496786-19502813	chr13	19496786	19502813	6027	19500224
chr13:20327962-20331424	chr13	20327962	20331424	3462	20328881
chr13:20662316-20662541	chr13	20662316	20662541	225	20662377
chr13:21553479-21555603	chr13	21553479	21555603	2124	21555094
chr13:22346086-22352208	chr13	22346086	22352208	6122	22349630
chr13:22526334-22530881	chr13	22526334	22530881	4547	22528304
chr13:22574736-22580850	chr13	22574736	22580850	6114	22578248
chr13:23593800-23598172	chr13	23593800	23598172	4372	23597671
chr13:23779469-23785637	chr13	23779469	23785637	6168	23783030
chr13:24342490-24347980	chr13	24342490	24347980	5490	24345399
chr13:25637151-25643226	chr13	25637151	25643226	6075	25640678
chr13:29624568-29628950	chr13	29624568	29628950	4382	29628333
chr13:30213114-30215935	chr13	30213114	30215935	2821	30213347
chr13:30244583-30246873	chr13	30244583	30246873	2290	30244974
chr13:30259358-30265382	chr13	30259358	30265382	6024	30262793
chr13:31253621-31254769	chr13	31253621	31254769	1148	31254101
chr13:31302314-31308370	chr13	31302314	31308370	6056	31305753
chr13:31340591-31346520	chr13	31340591	31346520	5929	31343987
chr13:31690495-31692632	chr13	31690495	31692632	2137	31692234
chr13:33984674-33990692	chr13	33984674	33990692	6018	33988105
chr13:34387390-34388287	chr13	34387390	34388287	897	34388162
chr13:34494370-34499106	chr13	34494370	34499106	4736	34496525
chr13:35083360-35086285	chr13	35083360	35086285	2925	35085157
chr13:37053805-37056778	chr13	37053805	37056778	2973	37054192
chr13:37250340-37256381	chr13	37250340	37256381	6041	37253791
chr13:37605780-37608516	chr13	37605780	37608516	2736	37605931
chr13:38065372-38071518	chr13	38065372	38071518	6146	38068952
chr13:38112136-38118185	chr13	38112136	38118185	6049	38115598
chr13:38272160-38276048	chr13	38272160	38276048	3888	38273471
chr13:38278937-38279666	chr13	38278937	38279666	729	38279440
chr13:38289428-38293071	chr13	38289428	38293071	3643	38290483
chr13:39592286-39595129	chr13	39592286	39595129	2843	39592546
chr13:39741195-39746245	chr13	39741195	39746245	5050	39743679
chr13:40356290-40362321	chr13	40356290	40362321	6031	40359729
chr13:40415709-40419387	chr13	40415709	40419387	3678	40416812
chr13:40734919-40740945	chr13	40734919	40740945	6026	40738362
chr13:40828819-40834834	chr13	40828819	40834834	6015	40832252
chr13:40887579-40893100	chr13	40887579	40893100	5521	40890515
chr13:41873072-41874580	chr13	41873072	41874580	1508	41873758
chr13:41920384-41923445	chr13	41920384	41923445	3061	41920859
chr13:42424880-42430912	chr13	42424880	42430912	6032	42428320
chr13:42515975-42522435	chr13	42515975	42522435	6460	42519851
chr13:42856666-42859291	chr13	42856666	42859291	2625	42856702
chr13:45645030-45651067	chr13	45645030	45651067	6037	45648474
chr13:47103065-47107812	chr13	47103065	47107812	4747	47106188
chr13:47378739-47384276	chr13	47378739	47384276	5537	47381691
chr13:47563613-47570021	chr13	47563613	47570021	6408	47567464
chr13:47668114-47670955	chr13	47668114	47670955	2841	47668374
chr13:47712138-47718308	chr13	47712138	47718308	6170	47715714
chr13:47752781-47755411	chr13	47752781	47755411	2630	47752849
chr13:47781888-47787912	chr13	47781888	47787912	6024	47785326
chr13:47910080-47914110	chr13	47910080	47914110	4030	47911524
chr13:48021639-48024949	chr13	48021639	48024949	3310	48022368
chr13:48200815-48206953	chr13	48200815	48206953	6138	48204431
chr13:48416129-48422515	chr13	48416129	48422515	6386	48419962
chr13:48465555-48471566	chr13	48465555	48471566	6011	48468985
chr13:48696535-48701520	chr13	48696535	48701520	4985	48700093
chr13:49118181-49124497	chr13	49118181	49124497	6316	49121923
chr13:49880988-49885879	chr13	49880988	49885879	4891	49883297
chr13:50855870-50862066	chr13	50855870	50862066	6196	50859489
chr13:50982054-50988070	chr13	50982054	50988070	6016	50985496
chr13:51526815-51532517	chr13	51526815	51532517	5702	51529935
chr13:51567035-51571648	chr13	51567035	51571648	4613	51570580
chr13:51709500-51712453	chr13	51709500	51712453	2953	51709859
chr13:51982627-51989067	chr13	51982627	51989067	6440	51986489
chr13:52054508-52059967	chr13	52054508	52059967	5459	52057372
chr13:52214986-52217522	chr13	52214986	52217522	2536	52216143
chr13:52254319-52258039	chr13	52254319	52258039	3720	52257872
chr13:54043844-54049966	chr13	54043844	54049966	6122	54047386
chr13:54218991-54225025	chr13	54218991	54225025	6034	54222455
chr13:54822998-54826518	chr13	54822998	54826518	3520	54823940
chr13:54856026-54858194	chr13	54856026	54858194	2168	54857176
chr13:54920187-54923901	chr13	54920187	54923901	3714	54921296
chr13:55733059-55736448	chr13	55733059	55736448	3389	55733868
chr13:56575533-56578212	chr13	56575533	56578212	2679	56575637
chr13:56628701-56634933	chr13	56628701	56634933	6232	56632343
chr13:56762844-56769351	chr13	56762844	56769351	6507	56766719
chr13:56994624-56997059	chr13	56994624	56997059	2435	56996437
chr13:57229644-57236064	chr13	57229644	57236064	6420	57233494
chr13:57356582-57359190	chr13	57356582	57359190	2608	57357548
chr13:57622126-57622933	chr13	57622126	57622933	807	57622241
chr13:59291392-59297848	chr13	59291392	59297848	6456	59295264
chr13:59590682-59596761	chr13	59590682	59596761	6079	59594212
chr13:59850679-59851187	chr13	59850679	59851187	508	59850950
chr13:59984539-59987488	chr13	59984539	59987488	2949	59984896
chr13:60709752-60715784	chr13	60709752	60715784	6032	60713190
chr13:60904260-60907051	chr13	60904260	60907051	2791	60904504
chr13:61267388-61272579	chr13	61267388	61272579	5191	61270000
chr13:61365295-61369440	chr13	61365295	61369440	4145	61366866
chr13:63936840-63938849	chr13	63936840	63938849	2009	63937555
chr13:64773207-64774331	chr13	64773207	64774331	1124	64774036
chr13:64827741-64834170	chr13	64827741	64834170	6429	64831587
chr13:65585175-65591324	chr13	65585175	65591324	6149	65588747
chr13:65686569-65687611	chr13	65686569	65687611	1042	65686624
chr13:66023464-66026385	chr13	66023464	66026385	2921	66023802
chr13:66737482-66743507	chr13	66737482	66743507	6025	66740915
chr13:67452274-67457994	chr13	67452274	67457994	5720	67455881
chr13:67563301-67565367	chr13	67563301	67565367	2066	67563568
chr13:67588343-67594470	chr13	67588343	67594470	6127	67591948
chr13:67845594-67848664	chr13	67845594	67848664	3070	67846054
chr13:67898019-67901597	chr13	67898019	67901597	3578	67899021
chr13:68525978-68529294	chr13	68525978	68529294	3316	68526714
chr13:68619524-68623258	chr13	68619524	68623258	3734	68620654
chr13:69160584-69162501	chr13	69160584	69162501	1917	69161484
chr13:69398281-69399890	chr13	69398281	69399890	1609	69399635
chr13:69666831-69672968	chr13	69666831	69672968	6137	69670299
chr13:69785191-69788666	chr13	69785191	69788666	3475	69786081
chr13:70208978-70214892	chr13	70208978	70214892	5914	70212302
chr13:70459545-70463568	chr13	70459545	70463568	4023	70460970
chr13:71129221-71132382	chr13	71129221	71132382	3161	71131909
chr13:72062125-72068393	chr13	72062125	72068393	6268	72065813
chr13:72610246-72616287	chr13	72610246	72616287	6041	72613694
chr13:73640527-73646551	chr13	73640527	73646551	6024	73643958
chr13:74346302-74352730	chr13	74346302	74352730	6428	74350135
chr13:74426326-74432354	chr13	74426326	74432354	6028	74429767
chr13:74492831-74494339	chr13	74492831	74494339	1508	74493191
chr13:74536448-74542369	chr13	74536448	74542369	5921	74539793
chr13:74933129-74936994	chr13	74933129	74936994	3865	74934437
chr13:75276994-75278432	chr13	75276994	75278432	1438	75277539
chr13:75954892-75958067	chr13	75954892	75958067	3175	75955479
chr13:77199027-77205061	chr13	77199027	77205061	6034	77202468
chr13:77710071-77714181	chr13	77710071	77714181	4110	77711649
chr13:77959144-77964789	chr13	77959144	77964789	5645	77962204
chr13:78284306-78285397	chr13	78284306	78285397	1091	78284500
chr13:79300066-79306064	chr13	79300066	79306064	5998	79303484
chr13:79887034-79893236	chr13	79887034	79893236	6202	79890632
chr13:79951054-79956464	chr13	79951054	79956464	5410	79953898
chr13:80153645-80156418	chr13	80153645	80156418	2773	80153832
chr13:80516861-80522982	chr13	80516861	80522982	6121	80520401
chr13:81365674-81368962	chr13	81365674	81368962	3288	81366405
chr13:81748214-81753199	chr13	81748214	81753199	4985	81750609
chr13:82045349-82051380	chr13	82045349	82051380	6031	82048790
chr13:82110639-82115243	chr13	82110639	82115243	4604	82112651
chr13:82229018-82235152	chr13	82229018	82235152	6134	82232569
chr13:82805010-82808737	chr13	82805010	82808737	3727	82808626
chr13:83171180-83175035	chr13	83171180	83175035	3855	83174723
chr13:83304563-83305467	chr13	83304563	83305467	904	83304944
chr13:83754136-83760265	chr13	83754136	83760265	6129	83757695
chr13:83963554-83966366	chr13	83963554	83966366	2812	83963774
chr13:84696139-84699444	chr13	84696139	84699444	3305	84697524
chr13:84725510-84728143	chr13	84725510	84728143	2633	84725527
chr13:85123204-85129221	chr13	85123204	85129221	6017	85126630
chr13:86896431-86900028	chr13	86896431	86900028	3597	86897446
chr13:87043478-87047451	chr13	87043478	87047451	3973	87044899
chr13:88199681-88200851	chr13	88199681	88200851	1170	88200608
chr13:89087885-89093918	chr13	89087885	89093918	6033	89091323
chr13:89194600-89197798	chr13	89194600	89197798	3198	89195195
chr13:90663982-90669995	chr13	90663982	90669995	6013	90667422
chr13:90736313-90737940	chr13	90736313	90737940	1627	90736399
chr13:91832628-91835896	chr13	91832628	91835896	3268	91833318
chr13:92280761-92286884	chr13	92280761	92286884	6123	92284314
chr13:92516732-92522773	chr13	92516732	92522773	6041	92520203
chr13:92752475-92758488	chr13	92752475	92758488	6013	92755904
chr13:94372199-94378191	chr13	94372199	94378191	5992	94375622
chr13:94526651-94532798	chr13	94526651	94532798	6147	94530212
chr13:94732558-94733189	chr13	94732558	94733189	631	94732824
chr13:94870779-94875115	chr13	94870779	94875115	4336	94874349
chr13:95909806-95914258	chr13	95909806	95914258	4452	95911659
chr13:95915578-95921361	chr13	95915578	95921361	5783	95918798
chr13:96772870-96779315	chr13	96772870	96779315	6445	96776765
chr13:97602891-97605663	chr13	97602891	97605663	2772	97603836
chr13:97607659-97613767	chr13	97607659	97613767	6108	97611181
chr13:97730412-97736443	chr13	97730412	97736443	6031	97733851
chr13:99399921-99403319	chr13	99399921	99403319	3398	99400742
chr13:100698082-100704117	chr13	100698082	100704117	6035	100701533
chr13:101355250-101359193	chr13	101355250	101359193	3943	101356607
chr13:102154111-102158681	chr13	102154111	102158681	4570	102156083
chr13:102522020-102528176	chr13	102522020	102528176	6156	102525589
chr13:105383251-105388345	chr13	105383251	105388345	5094	105385760
chr13:106213540-106219555	chr13	106213540	106219555	6015	106216973
chr13:110048774-110051348	chr13	110048774	110051348	2574	110049855
chr13:110669595-110675717	chr13	110669595	110675717	6122	110673140
chr13:110993989-110999707	chr13	110993989	110999707	5718	110997122
chr13:111136253-111137247	chr13	111136253	111137247	994	111137169
chr13:112406825-112410373	chr13	112406825	112410373	3548	112407792
chr13:114217138-114219179	chr13	114217138	114219179	2041	114217449
chr13_KI270838v1_alt:207795-211343	chr13_KI270838v1_alt	207795	211343	3548	208762
chr14:18349749-18353734	chr14	18349749	18353734	3985	18351151
chr14:18371541-18374178	chr14	18371541	18374178	2637	18371596
chr14:18567288-18572644	chr14	18567288	18572644	5356	18570816
chr14:18705448-18708282	chr14	18705448	18708282	2834	18705688
chr14:18895899-18898732	chr14	18895899	18898732	2833	18896139
chr14:19188567-19191420	chr14	19188567	19191420	2853	19188831
chr14:19912673-19914848	chr14	19912673	19914848	2175	19913567
chr14:20103657-20109808	chr14	20103657	20109808	6151	20107220
chr14:20264630-20267500	chr14	20264630	20267500	2870	20264920
chr14:20280047-20286194	chr14	20280047	20286194	6147	20283606
chr14:20860123-20866268	chr14	20860123	20866268	6145	20863684
chr14:20910598-20916745	chr14	20910598	20916745	6147	20914149
chr14:21760073-21766285	chr14	21760073	21766285	6212	21763631
chr14:21896593-21899484	chr14	21896593	21899484	2891	21896894
chr14:21968678-21973026	chr14	21968678	21973026	4348	21970856
chr14:22348921-22355065	chr14	22348921	22355065	6144	22352440
chr14:23945677-23949611	chr14	23945677	23949611	3934	23947028
chr14:23973540-23977116	chr14	23973540	23977116	3576	23974823
chr14:23978686-23981493	chr14	23978686	23981493	2807	23980377
chr14:24016022-24019886	chr14	24016022	24019886	3864	24017306
chr14:24021460-24024298	chr14	24021460	24024298	2838	24023155
chr14:24026246-24030727	chr14	24026246	24030727	4481	24028141
chr14:24525954-24532097	chr14	24525954	24532097	6143	24529501
chr14:24756217-24757154	chr14	24756217	24757154	937	24756972
chr14:24768162-24774014	chr14	24768162	24774014	5852	24771432
chr14:25097841-25100693	chr14	25097841	25100693	2852	25098093
chr14:25105468-25108366	chr14	25105468	25108366	2898	25105792
chr14:25167086-25173204	chr14	25167086	25173204	6118	25170625
chr14:25183427-25189539	chr14	25183427	25189539	6112	25186976
chr14:25328593-25329686	chr14	25328593	25329686	1093	25328828
chr14:25432240-25434426	chr14	25432240	25434426	2186	25432607
chr14:25978856-25985332	chr14	25978856	25985332	6476	25982762
chr14:26106423-26112430	chr14	26106423	26112430	6007	26109836
chr14:26296495-26300612	chr14	26296495	26300612	4117	26298029
chr14:26308617-26315062	chr14	26308617	26315062	6445	26312470
chr14:27045112-27048110	chr14	27045112	27048110	2998	27045529
chr14:27052223-27054069	chr14	27052223	27054069	1846	27052662
chr14:27168328-27171216	chr14	27168328	27171216	2888	27168617
chr14:27224281-27225434	chr14	27224281	27225434	1153	27225338
chr14:27249606-27251175	chr14	27249606	27251175	1569	27249944
chr14:27461516-27462499	chr14	27461516	27462499	983	27462472
chr14:27673059-27679095	chr14	27673059	27679095	6036	27676501
chr14:28167997-28174141	chr14	28167997	28174141	6144	28171546
chr14:28188442-28194470	chr14	28188442	28194470	6028	28191879
chr14:28414199-28415726	chr14	28414199	28415726	1527	28414470
chr14:28846051-28851375	chr14	28846051	28851375	5324	28848794
chr14:28955834-28960275	chr14	28955834	28960275	4441	28957690
chr14:29775164-29781301	chr14	29775164	29781301	6137	29778712
chr14:29972061-29978485	chr14	29972061	29978485	6424	29975908
chr14:30065022-30066717	chr14	30065022	30066717	1695	30065342
chr14:30363537-30369568	chr14	30363537	30369568	6031	30366976
chr14:30474044-30480062	chr14	30474044	30480062	6018	30477472
chr14:31494121-31500646	chr14	31494121	31500646	6525	31498100
chr14:32517313-32523327	chr14	32517313	32523327	6014	32520768
chr14:32794582-32797795	chr14	32794582	32797795	3213	32795208
chr14:33088061-33094126	chr14	33088061	33094126	6065	33091564
chr14:33495861-33498847	chr14	33495861	33498847	2986	33496272
chr14:34142796-34146121	chr14	34142796	34146121	3325	34143530
chr14:34150072-34156225	chr14	34150072	34156225	6153	34153636
chr14:34391212-34397659	chr14	34391212	34397659	6447	34395078
chr14:35619353-35622522	chr14	35619353	35622522	3169	35619946
chr14:36184554-36190694	chr14	36184554	36190694	6140	36188107
chr14:36245689-36249899	chr14	36245689	36249899	4210	36247344
chr14:36411728-36417842	chr14	36411728	36417842	6114	36415269
chr14:37187765-37193961	chr14	37187765	37193961	6196	37191375
chr14:37293328-37299451	chr14	37293328	37299451	6123	37296879
chr14:37501628-37507758	chr14	37501628	37507758	6130	37505176
chr14:38412402-38418115	chr14	38412402	38418115	5713	38416051
chr14:38634947-38640984	chr14	38634947	38640984	6037	38638386
chr14:38671724-38675217	chr14	38671724	38675217	3493	38674446
chr14:38713382-38716469	chr14	38713382	38716469	3087	38713877
chr14:38766179-38768098	chr14	38766179	38768098	1919	38767909
chr14:38921698-38927831	chr14	38921698	38927831	6133	38925230
chr14:39017171-39023327	chr14	39017171	39023327	6156	39020737
chr14:39482613-39483139	chr14	39482613	39483139	526	39482969
chr14:39598964-39600525	chr14	39598964	39600525	1561	39599851
chr14:39630237-39631006	chr14	39630237	39631006	769	39630603
chr14:39655916-39662030	chr14	39655916	39662030	6114	39659443
chr14:40326207-40332209	chr14	40326207	40332209	6002	40329641
chr14:40348058-40354070	chr14	40348058	40354070	6012	40351497
chr14:41194373-41197416	chr14	41194373	41197416	3043	41194823
chr14:41493444-41497279	chr14	41493444	41497279	3835	41494669
chr14:41736592-41738504	chr14	41736592	41738504	1912	41736924
chr14:42152733-42154314	chr14	42152733	42154314	1581	42153298
chr14:43062334-43068363	chr14	43062334	43068363	6029	43065776
chr14:43253850-43257895	chr14	43253850	43257895	4045	43255304
chr14:43262062-43268079	chr14	43262062	43268079	6017	43265495
chr14:43370269-43376295	chr14	43370269	43376295	6026	43373704
chr14:43423139-43426716	chr14	43423139	43426716	3577	43425436
chr14:43439552-43441624	chr14	43439552	43441624	2072	43440188
chr14:43453760-43459895	chr14	43453760	43459895	6135	43457645
chr14:43492185-43498201	chr14	43492185	43498201	6016	43495612
chr14:43597900-43602088	chr14	43597900	43602088	4188	43601327
chr14:43698653-43704668	chr14	43698653	43704668	6015	43702079
chr14:44024502-44027234	chr14	44024502	44027234	2732	44024650
chr14:44208348-44211314	chr14	44208348	44211314	2966	44208716
chr14:44310922-44315068	chr14	44310922	44315068	4146	44312474
chr14:44321590-44325180	chr14	44321590	44325180	3590	44322591
chr14:44854402-44859572	chr14	44854402	44859572	5170	44856986
chr14:45591133-45593843	chr14	45591133	45593843	2710	45591238
chr14:45605779-45608280	chr14	45605779	45608280	2501	45605835
chr14:45928100-45929124	chr14	45928100	45929124	1024	45928154
chr14:46508563-46514741	chr14	46508563	46514741	6178	46512147
chr14:46620971-46622442	chr14	46620971	46622442	1471	46622059
chr14:47171654-47177809	chr14	47171654	47177809	6155	47175223
chr14:47377247-47383356	chr14	47377247	47383356	6109	47380785
chr14:47591340-47593889	chr14	47591340	47593889	2549	47591370
chr14:47794965-47800647	chr14	47794965	47800647	5682	47798065
chr14:47901180-47907204	chr14	47901180	47907204	6024	47904612
chr14:47940278-47943341	chr14	47940278	47943341	3063	47940759
chr14:48099978-48101087	chr14	48099978	48101087	1109	48100341
chr14:48187082-48193113	chr14	48187082	48193113	6031	48190522
chr14:48413488-48415025	chr14	48413488	48415025	1537	48413582
chr14:48443866-48448188	chr14	48443866	48448188	4322	48445644
chr14:48453485-48454429	chr14	48453485	48454429	944	48453570
chr14:48481502-48486504	chr14	48481502	48486504	5002	48483907
chr14:48590699-48593892	chr14	48590699	48593892	3193	48591319
chr14:48606742-48612848	chr14	48606742	48612848	6106	48610267
chr14:48697191-48702549	chr14	48697191	48702549	5358	48700710
chr14:48792164-48797029	chr14	48792164	48797029	4865	48796040
chr14:49096714-49102732	chr14	49096714	49102732	6018	49100143
chr14:49180536-49183803	chr14	49180536	49183803	3267	49181249
chr14:49245999-49248154	chr14	49245999	49248154	2155	49246626
chr14:49356594-49362741	chr14	49356594	49362741	6147	49360152
chr14:49385422-49389034	chr14	49385422	49389034	3612	49387061
chr14:49393046-49395725	chr14	49393046	49395725	2679	49394476
chr14:50074940-50080005	chr14	50074940	50080005	5065	50077411
chr14:52157773-52163865	chr14	52157773	52163865	6092	52161363
chr14:52208174-52214292	chr14	52208174	52214292	6118	52211703
chr14:52255422-52258132	chr14	52255422	52258132	2710	52255549
chr14:52384494-52390306	chr14	52384494	52390306	5812	52387721
chr14:52502588-52506527	chr14	52502588	52506527	3939	52506148
chr14:52571673-52574723	chr14	52571673	52574723	3050	52572171
chr14:53084651-53090883	chr14	53084651	53090883	6232	53088243
chr14:53318040-53324215	chr14	53318040	53324215	6175	53321623
chr14:53423803-53429913	chr14	53423803	53429913	6110	53427334
chr14:53797906-53804327	chr14	53797906	53804327	6421	53801751
chr14:54233877-54240023	chr14	54233877	54240023	6146	54237438
chr14:54948075-54954122	chr14	54948075	54954122	6047	54951574
chr14:55810978-55813508	chr14	55810978	55813508	2530	55813366
chr14:56228633-56234747	chr14	56228633	56234747	6114	56232183
chr14:56252678-56254118	chr14	56252678	56254118	1440	56252781
chr14:56454500-56460544	chr14	56454500	56460544	6044	56457977
chr14:56639511-56645657	chr14	56639511	56645657	6146	56643087
chr14:56667527-56673561	chr14	56667527	56673561	6034	56670967
chr14:57106635-57110949	chr14	57106635	57110949	4314	57108361
chr14:57112210-57118214	chr14	57112210	57118214	6004	57115642
chr14:57622861-57625790	chr14	57622861	57625790	2929	57624374
chr14:57740801-57746244	chr14	57740801	57746244	5443	57743649
chr14:57951001-57957444	chr14	57951001	57957444	6443	57954851
chr14:58032539-58038561	chr14	58032539	58038561	6022	58035974
chr14:58041309-58045624	chr14	58041309	58045624	4315	58043028
chr14:58525265-58531028	chr14	58525265	58531028	5763	58529279
chr14:58590710-58593601	chr14	58590710	58593601	2891	58591028
chr14:59409450-59415609	chr14	59409450	59415609	6159	59413014
chr14:59513180-59519328	chr14	59513180	59519328	6148	59516743
chr14:59551490-59557628	chr14	59551490	59557628	6138	59555040
chr14:59665136-59669618	chr14	59665136	59669618	4482	59667033
chr14:59890954-59893583	chr14	59890954	59893583	2629	59890992
chr14:60339972-60343158	chr14	60339972	60343158	3186	60340581
chr14:60381629-60387770	chr14	60381629	60387770	6141	60385217
chr14:60443052-60449196	chr14	60443052	60449196	6144	60446623
chr14:60887600-60890255	chr14	60887600	60890255	2655	60888022
chr14:61004443-61007327	chr14	61004443	61007327	2884	61004761
chr14:61942868-61945573	chr14	61942868	61945573	2705	61943306
chr14:62286319-62288718	chr14	62286319	62288718	2399	62287947
chr14:62522444-62526515	chr14	62522444	62526515	4071	62523932
chr14:62535851-62541882	chr14	62535851	62541882	6031	62539266
chr14:62636558-62642711	chr14	62636558	62642711	6153	62640120
chr14:62948315-62949337	chr14	62948315	62949337	1022	62948583
chr14:65892079-65895662	chr14	65892079	65895662	3583	65895603
chr14:66146289-66150268	chr14	66146289	66150268	3979	66147685
chr14:66201092-66206612	chr14	66201092	66206612	5520	66204031
chr14:66297571-66300616	chr14	66297571	66300616	3045	66298036
chr14:66333314-66337531	chr14	66333314	66337531	4217	66336348
chr14:66587761-66593313	chr14	66587761	66593313	5552	66590728
chr14:66701365-66707789	chr14	66701365	66707789	6424	66705239
chr14:66777029-66778319	chr14	66777029	66778319	1290	66777397
chr14:67051244-67055698	chr14	67051244	67055698	4454	67053537
chr14:67868071-67874097	chr14	67868071	67874097	6026	67871511
chr14:70499345-70501311	chr14	70499345	70501311	1966	70499607
chr14:70501314-70507441	chr14	70501314	70507441	6127	70504857
chr14:70547290-70553322	chr14	70547290	70553322	6032	70550730
chr14:71807303-71811691	chr14	71807303	71811691	4388	71809103
chr14:76744287-76749583	chr14	76744287	76749583	5296	76747848
chr14:79767758-79773791	chr14	79767758	79773791	6033	79771199
chr14:79953962-79959689	chr14	79953962	79959689	5727	79957127
chr14:80028416-80033709	chr14	80028416	80033709	5293	80031120
chr14:80038802-80044988	chr14	80038802	80044988	6186	80042378
chr14:80088527-80094682	chr14	80088527	80094682	6155	80092091
chr14:80590778-80593264	chr14	80590778	80593264	2486	80592573
chr14:80682140-80686222	chr14	80682140	80686222	4082	80684519
chr14:80884361-80890811	chr14	80884361	80890811	6450	80888203
chr14:81114165-81120190	chr14	81114165	81120190	6025	81117599
chr14:81542738-81546785	chr14	81542738	81546785	4047	81544188
chr14:81546782-81547621	chr14	81546782	81547621	839	81546868
chr14:81860155-81864917	chr14	81860155	81864917	4762	81862326
chr14:82347549-82353568	chr14	82347549	82353568	6019	82350977
chr14:83639298-83645330	chr14	83639298	83645330	6032	83642744
chr14:85885595-85891616	chr14	85885595	85891616	6021	85889028
chr14:86312232-86318377	chr14	86312232	86318377	6145	86315788
chr14:86472193-86475284	chr14	86472193	86475284	3091	86472698
chr14:86591295-86595904	chr14	86591295	86595904	4609	86593320
chr14:87423312-87429303	chr14	87423312	87429303	5991	87426711
chr14:87929105-87932440	chr14	87929105	87932440	3335	87929903
chr14:88369546-88376039	chr14	88369546	88376039	6493	88373447
chr14:88670349-88673949	chr14	88670349	88673949	3600	88672961
chr14:92852827-92858975	chr14	92852827	92858975	6148	92856387
chr14:96001558-96006972	chr14	96001558	96006972	5414	96005513
chr14:97674324-97680861	chr14	97674324	97680861	6537	97678163
chr14:101143774-101145334	chr14	101143774	101145334	1560	101144048
chr14:101266199-101272227	chr14	101266199	101272227	6028	101269636
chr14:101941898-101942356	chr14	101941898	101942356	458	101942218
chr14:106427215-106430280	chr14	106427215	106430280	3065	106427697
chr14_GL000225v1_random:144679-147967	chr14_GL000225v1_random	144679	147967	3288	145376
chr14_KI270722v1_random:8495-14621	chr14_KI270722v1_random	8495	14621	6126	12037
chr14_KI270846v1_alt:918894-921959	chr14_KI270846v1_alt	918894	921959	3065	919376
chr15:17013608-17019737	chr15	17013608	17019737	6129	17017154
chr15:19890348-19894324	chr15	19890348	19894324	3976	19891750
chr15:19948218-19954369	chr15	19948218	19954369	6151	19951770
chr15:20311030-20317051	chr15	20311030	20317051	6021	20314459
chr15:20628850-20635238	chr15	20628850	20635238	6388	20632649
chr15:23714069-23720093	chr15	23714069	23720093	6024	23717511
chr15:24020364-24021301	chr15	24020364	24021301	937	24021081
chr15:24043193-24049348	chr15	24043193	24049348	6155	24046754
chr15:25255613-25261749	chr15	25255613	25261749	6136	25259181
chr15:26531055-26537615	chr15	26531055	26537615	6560	26534965
chr15:26616987-26619679	chr15	26616987	26619679	2692	26617155
chr15:29413764-29417653	chr15	29413764	29417653	3889	29415076
chr15:29505148-29510542	chr15	29505148	29510542	5394	29508323
chr15:30775177-30781390	chr15	30775177	30781390	6213	30778818
chr15:31598207-31604615	chr15	31598207	31604615	6408	31602028
chr15:32078525-32081300	chr15	32078525	32081300	2775	32078725
chr15:32183429-32189574	chr15	32183429	32189574	6145	32186987
chr15:32292269-32298310	chr15	32292269	32298310	6041	32295716
chr15:32726153-32728280	chr15	32726153	32728280	2127	32727082
chr15:33350180-33352109	chr15	33350180	33352109	1929	33351334
chr15:33684527-33688291	chr15	33684527	33688291	3764	33686500
chr15:33757839-33763610	chr15	33757839	33763610	5771	33761678
chr15:34484761-34487680	chr15	34484761	34487680	2919	34485079
chr15:36195372-36201389	chr15	36195372	36201389	6017	36198809
chr15:36257191-36260715	chr15	36257191	36260715	3524	36258131
chr15:37213094-37215733	chr15	37213094	37215733	2639	37213161
chr15:37407846-37413026	chr15	37407846	37413026	5180	37411716
chr15:37427156-37433181	chr15	37427156	37433181	6025	37430590
chr15:37472553-37477184	chr15	37472553	37477184	4631	37474597
chr15:37531661-37536175	chr15	37531661	37536175	4514	37533585
chr15:37955428-37959276	chr15	37955428	37959276	3848	37956664
chr15:38119420-38125490	chr15	38119420	38125490	6070	38123296
chr15:38782749-38788763	chr15	38782749	38788763	6014	38786176
chr15:39220971-39224412	chr15	39220971	39224412	3441	39221830
chr15:39420570-39426588	chr15	39420570	39426588	6018	39423997
chr15:42764132-42770256	chr15	42764132	42770256	6124	42767686
chr15:43649975-43656002	chr15	43649975	43656002	6027	43653412
chr15:43960938-43964069	chr15	43960938	43964069	3131	43961478
chr15:44038557-44044919	chr15	44038557	44044919	6362	44042352
chr15:44252034-44258049	chr15	44252034	44258049	6015	44255459
chr15:44359620-44364207	chr15	44359620	44364207	4587	44361620
chr15:44685628-44687992	chr15	44685628	44687992	2364	44686978
chr15:44740551-44744469	chr15	44740551	44744469	3918	44741891
chr15:44991143-44995956	chr15	44991143	44995956	4813	44993949
chr15:45055239-45056583	chr15	45055239	45056583	1344	45055564
chr15:46046459-46049558	chr15	46046459	46049558	3099	46046974
chr15:46104553-46110666	chr15	46104553	46110666	6113	46108083
chr15:46368521-46369496	chr15	46368521	46369496	975	46369485
chr15:46424929-46431060	chr15	46424929	46431060	6131	46428479
chr15:46744997-46749615	chr15	46744997	46749615	4618	46747027
chr15:46832237-46834934	chr15	46832237	46834934	2697	46832352
chr15:47165532-47171560	chr15	47165532	47171560	6028	47168972
chr15:49068556-49073687	chr15	49068556	49073687	5131	49072125
chr15:49354233-49360252	chr15	49354233	49360252	6019	49357662
chr15:49395983-49402014	chr15	49395983	49402014	6031	49399423
chr15:51173565-51179009	chr15	51173565	51179009	5444	51176419
chr15:51509214-51512196	chr15	51509214	51512196	2982	51509630
chr15:51568814-51573077	chr15	51568814	51573077	4263	51572359
chr15:51590946-51597084	chr15	51590946	51597084	6138	51594488
chr15:51786858-51793025	chr15	51786858	51793025	6167	51790430
chr15:52164654-52167387	chr15	52164654	52167387	2733	52167251
chr15:52824190-52830141	chr15	52824190	52830141	5951	52827558
chr15:52902265-52907451	chr15	52902265	52907451	5186	52905610
chr15:53051010-53055770	chr15	53051010	53055770	4760	53053180
chr15:53183248-53189202	chr15	53183248	53189202	5954	53186637
chr15:53276407-53279499	chr15	53276407	53279499	3092	53277592
chr15:53540633-53546677	chr15	53540633	53546677	6044	53544085
chr15:53684199-53690229	chr15	53684199	53690229	6030	53687636
chr15:53935525-53939787	chr15	53935525	53939787	4262	53939411
chr15:54056066-54061130	chr15	54056066	54061130	5064	54058535
chr15:54432411-54435744	chr15	54432411	54435744	3333	54433160
chr15:54543252-54546477	chr15	54543252	54546477	3225	54543869
chr15:54698819-54704973	chr15	54698819	54704973	6154	54702381
chr15:54783600-54785306	chr15	54783600	54785306	1706	54784916
chr15:54850725-54855879	chr15	54850725	54855879	5154	54854628
chr15:54871705-54877844	chr15	54871705	54877844	6139	54875260
chr15:54944760-54950216	chr15	54944760	54950216	5456	54947639
chr15:54993289-54994461	chr15	54993289	54994461	1172	54994356
chr15:55063993-55069991	chr15	55063993	55069991	5998	55067406
chr15:55143186-55149315	chr15	55143186	55149315	6129	55146738
chr15:55502660-55505918	chr15	55502660	55505918	3258	55503349
chr15:55555680-55559663	chr15	55555680	55559663	3983	55557065
chr15:55605395-55605963	chr15	55605395	55605963	568	55605495
chr15:55805901-55808778	chr15	55805901	55808778	2877	55806199
chr15:55944021-55949962	chr15	55944021	55949962	5941	55947589
chr15:56107826-56109018	chr15	56107826	56109018	1192	56108130
chr15:56149422-56155773	chr15	56149422	56155773	6351	56153134
chr15:56398989-56405142	chr15	56398989	56405142	6153	56402561
chr15:56436062-56438895	chr15	56436062	56438895	2833	56437027
chr15:56516835-56518687	chr15	56516835	56518687	1852	56517227
chr15:56561415-56567575	chr15	56561415	56567575	6160	56564978
chr15:58125731-58131761	chr15	58125731	58131761	6030	58129170
chr15:58193368-58199898	chr15	58193368	58199898	6530	58196969
chr15:58362605-58369063	chr15	58362605	58369063	6458	58366478
chr15:60237176-60243313	chr15	60237176	60243313	6137	60240734
chr15:60331600-60335816	chr15	60331600	60335816	4216	60333312
chr15:60692814-60694074	chr15	60692814	60694074	1260	60692874
chr15:60949945-60954454	chr15	60949945	60954454	4509	60951864
chr15:61896237-61902274	chr15	61896237	61902274	6037	61899686
chr15:64326660-64332685	chr15	64326660	64332685	6025	64330099
chr15:68916566-68919556	chr15	68916566	68919556	2990	68916975
chr15:70370967-70373907	chr15	70370967	70373907	2940	70371344
chr15:70729653-70735160	chr15	70729653	70735160	5507	70732568
chr15:71174139-71180152	chr15	71174139	71180152	6013	71177563
chr15:71265152-71270472	chr15	71265152	71270472	5320	71269037
chr15:73532643-73536205	chr15	73532643	73536205	3562	73534604
chr15:76592521-76598950	chr15	76592521	76598950	6429	76596388
chr15:76779914-76786040	chr15	76779914	76786040	6126	76783457
chr15:76887180-76893336	chr15	76887180	76893336	6156	76890742
chr15:77260757-77266297	chr15	77260757	77266297	5540	77263679
chr15:77321886-77324054	chr15	77321886	77324054	2168	77322703
chr15:78186200-78189835	chr15	78186200	78189835	3635	78187248
chr15:78607584-78613730	chr15	78607584	78613730	6146	78611145
chr15:78719834-78725853	chr15	78719834	78725853	6019	78723268
chr15:79272632-79276191	chr15	79272632	79276191	3559	79273603
chr15:79779745-79784248	chr15	79779745	79784248	4503	79783908
chr15:80961732-80965964	chr15	80961732	80965964	4232	80963403
chr15:81581674-81586995	chr15	81581674	81586995	5321	81584420
chr15:81697165-81703174	chr15	81697165	81703174	6009	81700597
chr15:81730280-81736308	chr15	81730280	81736308	6028	81733719
chr15:81797930-81803963	chr15	81797930	81803963	6033	81801371
chr15:81821801-81824701	chr15	81821801	81824701	2900	81822124
chr15:81870667-81876699	chr15	81870667	81876699	6032	81874107
chr15:81995166-82001196	chr15	81995166	82001196	6030	81998605
chr15:83167578-83169318	chr15	83167578	83169318	1740	83168704
chr15:83221533-83225415	chr15	83221533	83225415	3882	83225061
chr15:83383651-83389616	chr15	83383651	83389616	5965	83387024
chr15:83860680-83866771	chr15	83860680	83866771	6091	83864187
chr15:83962725-83969163	chr15	83962725	83969163	6438	83966602
chr15:85433963-85439965	chr15	85433963	85439965	6002	85437394
chr15:86147143-86150914	chr15	86147143	86150914	3771	86150694
chr15:86474091-86480345	chr15	86474091	86480345	6254	86477656
chr15:86528094-86534125	chr15	86528094	86534125	6031	86531534
chr15:86720737-86723666	chr15	86720737	86723666	2929	86721073
chr15:87377228-87383395	chr15	87377228	87383395	6167	87380783
chr15:87463738-87469749	chr15	87463738	87469749	6011	87467158
chr15:87509891-87515920	chr15	87509891	87515920	6029	87513328
chr15:88357066-88363201	chr15	88357066	88363201	6135	88360631
chr15:89634318-89640301	chr15	89634318	89640301	5983	89637744
chr15:91090308-91094714	chr15	91090308	91094714	4406	91092138
chr15:91500665-91506649	chr15	91500665	91506649	5984	91504058
chr15:92251681-92253789	chr15	92251681	92253789	2108	92252113
chr15:92755239-92760779	chr15	92755239	92760779	5540	92758186
chr15:93675399-93681428	chr15	93675399	93681428	6029	93678839
chr15:93792219-93798382	chr15	93792219	93798382	6163	93795793
chr15:96664310-96667921	chr15	96664310	96667921	3611	96665320
chr15:97364173-97365517	chr15	97364173	97365517	1344	97364425
chr15:97432693-97438849	chr15	97432693	97438849	6156	97436266
chr15:98091539-98097564	chr15	98091539	98097564	6025	98094965
chr15:98987694-98993562	chr15	98987694	98993562	5868	98991532
chr15:100067771-100073922	chr15	100067771	100073922	6151	100071316
chr15:100083863-100089998	chr15	100083863	100089998	6135	100087412
chr15:100361638-100364469	chr15	100361638	100364469	2831	100361889
chr15:100365266-100371301	chr15	100365266	100371301	6035	100368708
chr15:100417071-100423096	chr15	100417071	100423096	6025	100420506
chr15:100575307-100579216	chr15	100575307	100579216	3909	100576598
chr15:101626450-101632475	chr15	101626450	101632475	6025	101629886
chr15_KI270849v1_alt:8965-11329	chr15_KI270849v1_alt	8965	11329	2364	10315
chr15_KI270849v1_alt:63929-67847	chr15_KI270849v1_alt	63929	67847	3918	65269
chr15_KI270849v1_alt:187348-190311	chr15_KI270849v1_alt	187348	190311	2963	187738
chr15_KI270905v1_alt:1689261-1693152	chr15_KI270905v1_alt	1689261	1693152	3891	1690575
chr15_KI270905v1_alt:1780645-1786039	chr15_KI270905v1_alt	1780645	1786039	5394	1783820
chr15_KI270905v1_alt:3060906-3067137	chr15_KI270905v1_alt	3060906	3067137	6231	3064547
chr15_KI270905v1_alt:3883357-3889765	chr15_KI270905v1_alt	3883357	3889765	6408	3887178
chr15_KI270905v1_alt:4363649-4366423	chr15_KI270905v1_alt	4363649	4366423	2774	4363849
chr15_KI270905v1_alt:4468780-4474925	chr15_KI270905v1_alt	4468780	4474925	6145	4472338
chr15_KI270905v1_alt:4577968-4584006	chr15_KI270905v1_alt	4577968	4584006	6038	4581412
chr15_KI270905v1_alt:4940745-4942866	chr15_KI270905v1_alt	4940745	4942866	2121	4941671
chr16:8057919-8060801	chr16	8057919	8060801	2882	8058209
chr16:9294235-9294886	chr16	9294235	9294886	651	9294659
chr16:12591772-12597508	chr16	12591772	12597508	5736	12595235
chr16:12603812-12609764	chr16	12603812	12609764	5952	12607259
chr16:17733165-17739300	chr16	17733165	17739300	6135	17736716
chr16:17906425-17912554	chr16	17906425	17912554	6129	17909968
chr16:18608050-18614193	chr16	18608050	18614193	6143	18611605
chr16:18670171-18673266	chr16	18670171	18673266	3095	18670686
chr16:20652551-20655408	chr16	20652551	20655408	2857	20652827
chr16:26092617-26098745	chr16	26092617	26098745	6128	26096168
chr16:26421362-26425393	chr16	26421362	26425393	4031	26422812
chr16:31337869-31344038	chr16	31337869	31344038	6169	31341448
chr16:31611826-31615053	chr16	31611826	31615053	3227	31612477
chr16:31687221-31693324	chr16	31687221	31693324	6103	31690750
chr16:31825440-31830591	chr16	31825440	31830591	5151	31828003
chr16:31937557-31943695	chr16	31937557	31943695	6138	31941113
chr16:31966224-31969152	chr16	31966224	31969152	2928	31966571
chr16:32075999-32079296	chr16	32075999	32079296	3297	32076715
chr16:32370380-32372347	chr16	32370380	32372347	1967	32370889
chr16:32907734-32910654	chr16	32907734	32910654	2920	32908081
chr16:33019244-33022543	chr16	33019244	33022543	3299	33019960
chr16:33649362-33654840	chr16	33649362	33654840	5478	33652273
chr16:34018673-34024592	chr16	34018673	34024592	5919	34022231
chr16:34177933-34178988	chr16	34177933	34178988	1055	34178563
chr16:34838809-34839883	chr16	34838809	34839883	1074	34839113
chr16:35074915-35080923	chr16	35074915	35080923	6008	35078342
chr16:35116170-35118187	chr16	35116170	35118187	2017	35116852
chr16:35162136-35166172	chr16	35162136	35166172	4036	35163584
chr16:35166184-35169335	chr16	35166184	35169335	3151	35166983
chr16:35287186-35293336	chr16	35287186	35293336	6150	35290749
chr16:35468696-35474693	chr16	35468696	35474693	5997	35472108
chr16:36071922-36077950	chr16	36071922	36077950	6028	36075361
chr16:46489860-46496028	chr16	46489860	46496028	6168	46493415
chr16:46535347-46541495	chr16	46535347	46541495	6148	46538920
chr16:46587611-46591326	chr16	46587611	46591326	3715	46588746
chr16:46643214-46646992	chr16	46643214	46646992	3778	46644407
chr16:47099159-47103451	chr16	47099159	47103451	4292	47100877
chr16:47182757-47188783	chr16	47182757	47188783	6026	47186184
chr16:47324144-47328488	chr16	47324144	47328488	4344	47325898
chr16:47347059-47353218	chr16	47347059	47353218	6159	47350638
chr16:47437710-47443907	chr16	47437710	47443907	6197	47441253
chr16:47900421-47903269	chr16	47900421	47903269	2848	47900691
chr16:47909897-47916004	chr16	47909897	47916004	6107	47913422
chr16:48758690-48764871	chr16	48758690	48764871	6181	48762289
chr16:50343339-50349410	chr16	50343339	50349410	6071	50346834
chr16:51329809-51335954	chr16	51329809	51335954	6145	51333365
chr16:51371583-51374414	chr16	51371583	51374414	2831	51371821
chr16:52017777-52020677	chr16	52017777	52020677	2900	52018111
chr16:52333409-52339534	chr16	52333409	52339534	6125	52336965
chr16:53396916-53402916	chr16	53396916	53402916	6000	53400327
chr16:54042096-54048145	chr16	54042096	54048145	6049	54045533
chr16:55598797-55604812	chr16	55598797	55604812	6015	55602220
chr16:55615451-55620229	chr16	55615451	55620229	4778	55619005
chr16:56154514-56160662	chr16	56154514	56160662	6148	56158075
chr16:56394766-56397679	chr16	56394766	56397679	2913	56395103
chr16:59072258-59078403	chr16	59072258	59078403	6145	59075813
chr16:59096419-59102546	chr16	59096419	59102546	6127	59099960
chr16:59408539-59410566	chr16	59408539	59410566	2027	59408669
chr16:59761051-59765308	chr16	59761051	59765308	4257	59762759
chr16:59976601-59982619	chr16	59976601	59982619	6018	59980032
chr16:60522745-60528760	chr16	60522745	60528760	6015	60526183
chr16:60877333-60880008	chr16	60877333	60880008	2675	60877392
chr16:60935971-60941164	chr16	60935971	60941164	5193	60939490
chr16:61782078-61788101	chr16	61782078	61788101	6023	61785512
chr16:61801455-61807489	chr16	61801455	61807489	6034	61804893
chr16:62553567-62555527	chr16	62553567	62555527	1960	62554153
chr16:63119951-63125975	chr16	63119951	63125975	6024	63123388
chr16:63147735-63153286	chr16	63147735	63153286	5551	63150702
chr16:63388077-63394106	chr16	63388077	63394106	6029	63391514
chr16:65356743-65362738	chr16	65356743	65362738	5995	65360146
chr16:65551127-65557278	chr16	65551127	65557278	6151	65554683
chr16:65690011-65696020	chr16	65690011	65696020	6009	65693429
chr16:65928441-65931567	chr16	65928441	65931567	3126	65928970
chr16:66495982-66502114	chr16	66495982	66502114	6132	66499525
chr16:70044731-70047563	chr16	70044731	70047563	2832	70045003
chr16:71604286-71605693	chr16	71604286	71605693	1407	71604550
chr16:72144787-72148532	chr16	72144787	72148532	3745	72145953
chr16:72324392-72329827	chr16	72324392	72329827	5435	72327959
chr16:72342000-72346146	chr16	72342000	72346146	4146	72343559
chr16:72543204-72549689	chr16	72543204	72549689	6485	72547109
chr16:72580798-72586932	chr16	72580798	72586932	6134	72584353
chr16:72627274-72633298	chr16	72627274	72633298	6024	72630712
chr16:74515713-74518819	chr16	74515713	74518819	3106	74517127
chr16:75719124-75725286	chr16	75719124	75725286	6162	75722676
chr16:76609852-76611639	chr16	76609852	76611639	1787	76610766
chr16:77524975-77530897	chr16	77524975	77530897	5922	77528538
chr16:79240529-79246215	chr16	79240529	79246215	5686	79243640
chr16:80219706-80225843	chr16	80219706	80225843	6137	80223258
chr16:80727089-80730717	chr16	80727089	80730717	3628	80730526
chr16:82139255-82145258	chr16	82139255	82145258	6003	82142674
chr16:83637252-83643296	chr16	83637252	83643296	6044	83640704
chr16:86233295-86239310	chr16	86233295	86239310	6015	86236725
chr16:86262173-86268197	chr16	86262173	86268197	6024	86265607
chr16_KI270728v1_random:99354-105498	chr16_KI270728v1_random	99354	105498	6144	102915
chr16_KI270728v1_random:147391-149632	chr16_KI270728v1_random	147391	149632	2241	149322
chr16_KI270728v1_random:411696-417840	chr16_KI270728v1_random	411696	417840	6144	415257
chr16_KI270728v1_random:1171720-1174640	chr16_KI270728v1_random	1171720	1174640	2920	1172067
chr16_KI270728v1_random:1280902-1284201	chr16_KI270728v1_random	1280902	1284201	3299	1281618
chr16_KI270728v1_random:1497846-1503321	chr16_KI270728v1_random	1497846	1503321	5475	1500754
chr16_KI270728v1_random:1683799-1686044	chr16_KI270728v1_random	1683799	1686044	2245	1685732
chr16_KI270853v1_alt:673680-676536	chr16_KI270853v1_alt	673680	676536	2856	673952
chr17:3097451-3101933	chr17	3097451	3101933	4482	3101096
chr17:3176530-3182557	chr17	3176530	3182557	6027	3179965
chr17:3348385-3352043	chr17	3348385	3352043	3658	3350607
chr17:3456122-3458560	chr17	3456122	3458560	2438	3456622
chr17:5574962-5579269	chr17	5574962	5579269	4307	5576684
chr17:5850799-5852215	chr17	5850799	5852215	1416	5850848
chr17:9615985-9622015	chr17	9615985	9622015	6030	9619425
chr17:13855495-13861599	chr17	13855495	13861599	6104	13859017
chr17:14597488-14603954	chr17	14597488	14603954	6466	14601355
chr17:15355300-15360799	chr17	15355300	15360799	5499	15358222
chr17:22720417-22721771	chr17	22720417	22721771	1354	22721077
chr17:26675746-26679560	chr17	26675746	26679560	3814	26676979
chr17:26735774-26741856	chr17	26735774	26741856	6082	26739266
chr17:27010710-27014310	chr17	27010710	27014310	3600	27011717
chr17:27028611-27033096	chr17	27028611	27033096	4485	27032159
chr17:27145788-27148649	chr17	27145788	27148649	2861	27146067
chr17:27249212-27255352	chr17	27249212	27255352	6140	27252772
chr17:29897115-29901291	chr17	29897115	29901291	4176	29898704
chr17:30022793-30026172	chr17	30022793	30026172	3379	30023605
chr17:31780986-31786541	chr17	31780986	31786541	5555	31783960
chr17:32887137-32893184	chr17	32887137	32893184	6047	32890573
chr17:32965864-32969770	chr17	32965864	32969770	3906	32967175
chr17:33877135-33883249	chr17	33877135	33883249	6114	33880681
chr17:34030370-34036565	chr17	34030370	34036565	6195	34033935
chr17:35274370-35278179	chr17	35274370	35278179	3809	35277762
chr17:35307396-35310331	chr17	35307396	35310331	2935	35307769
chr17:35393949-35399945	chr17	35393949	35399945	5996	35397365
chr17:41239930-41246018	chr17	41239930	41246018	6088	41243434
chr17:51304948-51311073	chr17	51304948	51311073	6125	51308580
chr17:51327012-51330920	chr17	51327012	51330920	3908	51330028
chr17:51449359-51453161	chr17	51449359	51453161	3802	51450560
chr17:51574410-51580797	chr17	51574410	51580797	6387	51578252
chr17:51623818-51627041	chr17	51623818	51627041	3223	51624462
chr17:52458100-52460747	chr17	52458100	52460747	2647	52458173
chr17:52656222-52658548	chr17	52656222	52658548	2326	52657017
chr17:53811054-53812618	chr17	53811054	53812618	1564	53811878
chr17:53914707-53918904	chr17	53914707	53918904	4197	53916311
chr17:54161123-54166037	chr17	54161123	54166037	4914	54163464
chr17:54697769-54698682	chr17	54697769	54698682	913	54698026
chr17:54820656-54826798	chr17	54820656	54826798	6142	54824238
chr17:55501716-55507741	chr17	55501716	55507741	6025	55505150
chr17:55789685-55792342	chr17	55789685	55792342	2657	55789727
chr17:55938699-55945099	chr17	55938699	55945099	6400	55942529
chr17:56002401-56008616	chr17	56002401	56008616	6215	56006029
chr17:56050764-56052234	chr17	56050764	56052234	1470	56050992
chr17:56380301-56386508	chr17	56380301	56386508	6207	56383902
chr17:61110229-61116238	chr17	61110229	61116238	6009	61113662
chr17:61673057-61676705	chr17	61673057	61676705	3648	61676574
chr17:62324431-62327363	chr17	62324431	62327363	2932	62324782
chr17:62356953-62363149	chr17	62356953	62363149	6196	62360533
chr17:62783259-62786540	chr17	62783259	62786540	3281	62783948
chr17:64363941-64366987	chr17	64363941	64366987	3046	64364398
chr17:68843900-68847065	chr17	68843900	68847065	3165	68844474
chr17:68949177-68950445	chr17	68949177	68950445	1268	68949369
chr17:69036418-69040727	chr17	69036418	69040727	4309	69038141
chr17:69924873-69925829	chr17	69924873	69925829	956	69924928
chr17:70458956-70464987	chr17	70458956	70464987	6031	70462395
chr17:71643610-71648940	chr17	71643610	71648940	5330	71646357
chr17:71810919-71814626	chr17	71810919	71814626	3707	71812088
chr17:73807437-73811369	chr17	73807437	73811369	3932	73808780
chr17:82952367-82956177	chr17	82952367	82956177	3810	82953588
chr17_GL000205v2_random:44576-50603	chr17_GL000205v2_random	44576	50603	6027	48010
chr17_GL000205v2_random:115420-118466	chr17_GL000205v2_random	115420	118466	3046	116004
chr17_GL383565v1_alt:54993-61004	chr17_GL383565v1_alt	54993	61004	6011	58412
chr17_GL383565v1_alt:158732-164763	chr17_GL383565v1_alt	158732	164763	6031	162171
chr17_KI270729v1_random:191353-197373	chr17_KI270729v1_random	191353	197373	6020	194790
chr17_KI270858v1_alt:59408-64316	chr17_KI270858v1_alt	59408	64316	4908	61733
chr17_KI270858v1_alt:227435-231142	chr17_KI270858v1_alt	227435	231142	3707	228604
chr18:35807-41823	chr18	35807	41823	6016	39231
chr18:535701-541755	chr18	535701	541755	6054	539136
chr18:1335217-1341361	chr18	1335217	1341361	6144	1338773
chr18:1699974-1705809	chr18	1699974	1705809	5835	1703217
chr18:2247167-2253196	chr18	2247167	2253196	6029	2250612
chr18:2343122-2346606	chr18	2343122	2346606	3484	2344023
chr18:3736731-3739789	chr18	3736731	3739789	3058	3737195
chr18:4683913-4686670	chr18	4683913	4686670	2757	4684086
chr18:4892795-4898717	chr18	4892795	4898717	5922	4896142
chr18:4982388-4984533	chr18	4982388	4984533	2145	4983757
chr18:5004136-5010155	chr18	5004136	5010155	6019	5007564
chr18:5122003-5128135	chr18	5122003	5128135	6132	5125562
chr18:6163697-6169833	chr18	6163697	6169833	6136	6167251
chr18:6699818-6705944	chr18	6699818	6705944	6126	6703365
chr18:7398117-7403452	chr18	7398117	7403452	5335	7400864
chr18:7966442-7972474	chr18	7966442	7972474	6032	7969882
chr18:9264857-9270775	chr18	9264857	9270775	5918	9268192
chr18:10650018-10656113	chr18	10650018	10656113	6095	10653526
chr18:11058121-11063443	chr18	11058121	11063443	5322	11060831
chr18:12181637-12187780	chr18	12181637	12187780	6143	12185199
chr18:13689803-13695871	chr18	13689803	13695871	6068	13693318
chr18:14064986-14071100	chr18	14064986	14071100	6114	14068548
chr18:14162672-14168081	chr18	14162672	14168081	5409	14166218
chr18:15188475-15191660	chr18	15188475	15191660	3185	15189067
chr18:15218950-15220697	chr18	15218950	15220697	1747	15220075
chr18:21738836-21739625	chr18	21738836	21739625	789	21739361
chr18:21953082-21955925	chr18	21953082	21955925	2843	21953366
chr18:22529636-22535664	chr18	22529636	22535664	6028	22533078
chr18:22617023-22622359	chr18	22617023	22622359	5336	22619789
chr18:22719811-22722656	chr18	22719811	22722656	2845	22720063
chr18:22760673-22763788	chr18	22760673	22763788	3115	22761958
chr18:22885395-22891520	chr18	22885395	22891520	6125	22888933
chr18:23326174-23330209	chr18	23326174	23330209	4035	23327624
chr18:24901157-24907226	chr18	24901157	24907226	6069	24904678
chr18:25380497-25384972	chr18	25380497	25384972	4475	25383051
chr18:25718293-25722611	chr18	25718293	25722611	4318	25720026
chr18:25745151-25748689	chr18	25745151	25748689	3538	25746106
chr18:25774316-25777924	chr18	25774316	25777924	3608	25775332
chr18:27279551-27285578	chr18	27279551	27285578	6027	27282986
chr18:27510008-27516039	chr18	27510008	27516039	6031	27513450
chr18:28240443-28246440	chr18	28240443	28246440	5997	28243873
chr18:28296239-28296913	chr18	28296239	28296913	674	28296667
chr18:28749300-28750873	chr18	28749300	28750873	1573	28749346
chr18:28879163-28879688	chr18	28879163	28879688	525	28879590
chr18:30297877-30298546	chr18	30297877	30298546	669	30298428
chr18:30730662-30737084	chr18	30730662	30737084	6422	30734519
chr18:32395715-32401334	chr18	32395715	32401334	5619	32398741
chr18:32657897-32661353	chr18	32657897	32661353	3456	32658767
chr18:32795864-32797503	chr18	32795864	32797503	1639	32795931
chr18:33382390-33386396	chr18	33382390	33386396	4006	33386280
chr18:33535160-33535556	chr18	33535160	33535556	396	33535460
chr18:33786878-33793028	chr18	33786878	33793028	6150	33790447
chr18:33888893-33890546	chr18	33888893	33890546	1653	33889461
chr18:34331115-34337159	chr18	34331115	34337159	6044	34334543
chr18:34894774-34900928	chr18	34894774	34900928	6154	34898337
chr18:35205779-35211809	chr18	35205779	35211809	6030	35209218
chr18:35627588-35633705	chr18	35627588	35633705	6117	35631127
chr18:35760308-35766412	chr18	35760308	35766412	6104	35763822
chr18:35792708-35796748	chr18	35792708	35796748	4040	35794163
chr18:35812170-35815549	chr18	35812170	35815549	3379	35812979
chr18:35866970-35868968	chr18	35866970	35868968	1998	35867218
chr18:35897480-35903637	chr18	35897480	35903637	6157	35901048
chr18:37074885-37079519	chr18	37074885	37079519	4634	37076908
chr18:37111556-37117653	chr18	37111556	37117653	6097	37115088
chr18:37819737-37825798	chr18	37819737	37825798	6061	37823177
chr18:37943245-37944381	chr18	37943245	37944381	1136	37943766
chr18:39122634-39126345	chr18	39122634	39126345	3711	39123757
chr18:39565592-39571600	chr18	39565592	39571600	6008	39569028
chr18:39755929-39757653	chr18	39755929	39757653	1724	39757236
chr18:39924369-39930434	chr18	39924369	39930434	6065	39927823
chr18:40513388-40514660	chr18	40513388	40514660	1272	40513512
chr18:40844862-40848268	chr18	40844862	40848268	3406	40845676
chr18:41086465-41089857	chr18	41086465	41089857	3392	41088702
chr18:41631742-41637769	chr18	41631742	41637769	6027	41635181
chr18:41775014-41781045	chr18	41775014	41781045	6031	41778454
chr18:42660319-42666556	chr18	42660319	42666556	6237	42663964
chr18:42714003-42717016	chr18	42714003	42717016	3013	42714426
chr18:43082270-43084899	chr18	43082270	43084899	2629	43082302
chr18:43285925-43292078	chr18	43285925	43292078	6153	43289489
chr18:43323961-43326711	chr18	43323961	43326711	2750	43324089
chr18:43835497-43841622	chr18	43835497	43841622	6125	43839049
chr18:44275391-44278421	chr18	44275391	44278421	3030	44275824
chr18:44299898-44305988	chr18	44299898	44305988	6090	44303422
chr18:44378311-44381203	chr18	44378311	44381203	2892	44378680
chr18:44415919-44422383	chr18	44415919	44422383	6464	44419788
chr18:44444782-44448159	chr18	44444782	44448159	3377	44445576
chr18:45696570-45700593	chr18	45696570	45700593	4023	45698024
chr18:45811301-45813924	chr18	45811301	45813924	2623	45811336
chr18:46742619-46748236	chr18	46742619	46748236	5617	46745641
chr18:47637319-47643479	chr18	47637319	47643479	6160	47640890
chr18:47660373-47666427	chr18	47660373	47666427	6054	47663810
chr18:48648985-48655135	chr18	48648985	48655135	6150	48652558
chr18:49215768-49223192	chr18	49215768	49223192	7424	49219330
chr18:49420540-49426551	chr18	49420540	49426551	6011	49423971
chr18:49717972-49721108	chr18	49717972	49721108	3136	49718499
chr18:50147918-50150845	chr18	50147918	50150845	2927	50148258
chr18:51740631-51746665	chr18	51740631	51746665	6034	51744073
chr18:51828766-51831704	chr18	51828766	51831704	2938	51829119
chr18:53173506-53177343	chr18	53173506	53177343	3837	53174750
chr18:53511450-53517443	chr18	53511450	53517443	5993	53514873
chr18:53640454-53643790	chr18	53640454	53643790	3336	53641190
chr18:53804182-53810332	chr18	53804182	53810332	6150	53807747
chr18:53822122-53825049	chr18	53822122	53825049	2927	53822480
chr18:54426981-54430581	chr18	54426981	54430581	3600	54427989
chr18:55155364-55157975	chr18	55155364	55157975	2611	55155382
chr18:56130894-56133999	chr18	56130894	56133999	3105	56131410
chr18:56153856-56157095	chr18	56153856	56157095	3239	56154514
chr18:56525569-56531695	chr18	56525569	56531695	6126	56529108
chr18:57226193-57229996	chr18	57226193	57229996	3803	57227430
chr18:57259696-57265728	chr18	57259696	57265728	6032	57263136
chr18:57719248-57725264	chr18	57719248	57725264	6016	57722672
chr18:59114773-59118660	chr18	59114773	59118660	3887	59116077
chr18:59256648-59262781	chr18	59256648	59262781	6133	59260200
chr18:59771359-59777443	chr18	59771359	59777443	6084	59774877
chr18:60303365-60306056	chr18	60303365	60306056	2691	60303485
chr18:61175114-61177692	chr18	61175114	61177692	2578	61177462
chr18:61520342-61524065	chr18	61520342	61524065	3723	61521497
chr18:61715619-61718454	chr18	61715619	61718454	2835	61715859
chr18:62906292-62912314	chr18	62906292	62912314	6022	62909723
chr18:63687738-63694231	chr18	63687738	63694231	6493	63691631
chr18:63862795-63866418	chr18	63862795	63866418	3623	63863828
chr18:64424277-64430404	chr18	64424277	64430404	6127	64427832
chr18:64572565-64578676	chr18	64572565	64578676	6111	64576095
chr18:65166414-65172446	chr18	65166414	65172446	6032	65169944
chr18:66293279-66296442	chr18	66293279	66296442	3163	66295377
chr18:66715074-66721105	chr18	66715074	66721105	6031	66718519
chr18:67741669-67745951	chr18	67741669	67745951	4282	67745568
chr18:68303207-68306496	chr18	68303207	68306496	3289	68303928
chr18:69449559-69455072	chr18	69449559	69455072	5513	69452485
chr18:69963588-69966613	chr18	69963588	69966613	3025	69964014
chr18:70714323-70720447	chr18	70714323	70720447	6124	70717863
chr18:70735869-70741976	chr18	70735869	70741976	6107	70739408
chr18:70795008-70798177	chr18	70795008	70798177	3169	70797798
chr18:71790930-71793614	chr18	71790930	71793614	2684	71791032
chr18:72135559-72136268	chr18	72135559	72136268	709	72135669
chr18:72276319-72278002	chr18	72276319	72278002	1683	72276572
chr18:73016480-73022098	chr18	73016480	73022098	5618	73019962
chr18:73444827-73446422	chr18	73444827	73446422	1595	73445997
chr18:73629283-73631070	chr18	73629283	73631070	1787	73629622
chr18:75846851-75852883	chr18	75846851	75852883	6032	75850291
chr18:77577755-77583881	chr18	77577755	77583881	6126	77581320
chr18:80234752-80238502	chr18	80234752	80238502	3750	80235925
chr18_GL383568v1_alt:52229-58260	chr18_GL383568v1_alt	52229	58260	6031	55670
chr18_GL383568v1_alt:65121-71148	chr18_GL383568v1_alt	65121	71148	6027	68558
chr18_GL383570v1_alt:114910-120659	chr18_GL383570v1_alt	114910	120659	5749	118445
chr18_GL383570v1_alt:131795-138074	chr18_GL383570v1_alt	131795	138074	6279	135231
chr19:116491-118291	chr19	116491	118291	1800	116744
chr19:146476-152899	chr19	146476	152899	6423	150354
chr19:9397704-9403756	chr19	9397704	9403756	6052	9401208
chr19:11906254-11911830	chr19	11906254	11911830	5576	11909246
chr19:20228479-20229341	chr19	20228479	20229341	862	20228903
chr19:20490325-20496607	chr19	20490325	20496607	6282	20494026
chr19:20807724-20813827	chr19	20807724	20813827	6103	20811249
chr19:20826772-20830668	chr19	20826772	20830668	3896	20828083
chr19:20987901-20992539	chr19	20987901	20992539	4638	20991772
chr19:21737565-21737968	chr19	21737565	21737968	403	21737802
chr19:22148369-22154509	chr19	22148369	22154509	6140	22151940
chr19:22227078-22230510	chr19	22227078	22230510	3432	22227932
chr19:22675331-22677606	chr19	22675331	22677606	2275	22675801
chr19:22949516-22955672	chr19	22949516	22955672	6156	22953087
chr19:22978484-22984012	chr19	22978484	22984012	5528	22981453
chr19:23613435-23619660	chr19	23613435	23619660	6225	23617073
chr19:24112740-24115687	chr19	24112740	24115687	2947	24113105
chr19:24231729-24237385	chr19	24231729	24237385	5656	24234793
chr19:24394039-24399943	chr19	24394039	24399943	5904	24397370
chr19:27296139-27297480	chr19	27296139	27297480	1341	27296751
chr19:27324366-27330338	chr19	27324366	27330338	5972	27327493
chr19:27466423-27469736	chr19	27466423	27469736	3313	27467143
chr19:27501948-27504573	chr19	27501948	27504573	2625	27502973
chr19:27598223-27600024	chr19	27598223	27600024	1801	27599182
chr19:27852700-27858830	chr19	27852700	27858830	6130	27856236
chr19:28087649-28092997	chr19	28087649	28092997	5348	28091198
chr19:28177582-28183612	chr19	28177582	28183612	6030	28181027
chr19:28269706-28275728	chr19	28269706	28275728	6022	28273143
chr19:28676991-28679757	chr19	28676991	28679757	2766	28677168
chr19:28756881-28762969	chr19	28756881	28762969	6088	28760423
chr19:28806186-28808787	chr19	28806186	28808787	2601	28806203
chr19:29132609-29138743	chr19	29132609	29138743	6134	29136151
chr19:29225779-29231807	chr19	29225779	29231807	6028	29229214
chr19:29348349-29354473	chr19	29348349	29354473	6124	29351886
chr19:29459290-29465188	chr19	29459290	29465188	5898	29462729
chr19:29552349-29557417	chr19	29552349	29557417	5068	29555982
chr19:30142648-30143934	chr19	30142648	30143934	1286	30142850
chr19:30192976-30193783	chr19	30192976	30193783	807	30193392
chr19:32846037-32852182	chr19	32846037	32852182	6145	32849605
chr19:34625134-34631273	chr19	34625134	34631273	6139	34628691
chr19:34657166-34658790	chr19	34657166	34658790	1624	34658675
chr19:34860177-34866213	chr19	34860177	34866213	6036	34863624
chr19:37116469-37122625	chr19	37116469	37122625	6156	37120046
chr19:37837502-37843533	chr19	37837502	37843533	6031	37840941
chr19:39649212-39655243	chr19	39649212	39655243	6031	39652759
chr19:39667440-39670417	chr19	39667440	39670417	2977	39667811
chr19:39722462-39725834	chr19	39722462	39725834	3372	39723260
chr19:40912707-40917997	chr19	40912707	40917997	5290	40916237
chr19:41098534-41102820	chr19	41098534	41102820	4286	41102114
chr19:41486362-41492519	chr19	41486362	41492519	6157	41489934
chr19:42714368-42720306	chr19	42714368	42720306	5938	42717728
chr19:44250028-44253909	chr19	44250028	44253909	3881	44251324
chr19:52052691-52056400	chr19	52052691	52056400	3709	52054530
chr19:55822401-55828429	chr19	55822401	55828429	6028	55825837
chr19:57729119-57733434	chr19	57729119	57733434	4315	57730843
chr19_GL383573v1_alt:144680-150800	chr19_GL383573v1_alt	144680	150800	6120	148224
chr19_GL383573v1_alt:163495-167393	chr19_GL383573v1_alt	163495	167393	3898	164805
chr19_GL383573v1_alt:167843-173863	chr19_GL383573v1_alt	167843	173863	6020	171276
chr19_GL383573v1_alt:331177-335815	chr19_GL383573v1_alt	331177	335815	4638	335048
chr19_GL383575v2_alt:98755-99158	chr19_GL383575v2_alt	98755	99158	403	98992
chr19_GL383576v1_alt:147220-153373	chr19_GL383576v1_alt	147220	153373	6153	150762
chr19_KI270867v1_alt:44923-47983	chr19_KI270867v1_alt	44923	47983	3060	46728
chr1_KI270707v1_random:26079-31835	chr1_KI270707v1_random	26079	31835	5756	29253
chr1_KI270709v1_random:43820-49938	chr1_KI270709v1_random	43820	49938	6118	47348
chr1_KI270759v1_alt:321628-322495	chr1_KI270759v1_alt	321628	322495	867	322359
chr1_KI270760v1_alt:91418-97052	chr1_KI270760v1_alt	91418	97052	5634	94461
chr1_KI270763v1_alt:665117-665625	chr1_KI270763v1_alt	665117	665625	508	665528
chr1_KI270763v1_alt:819155-825298	chr1_KI270763v1_alt	819155	825298	6143	822708
chr1_KI270763v1_alt:832326-837513	chr1_KI270763v1_alt	832326	837513	5187	834962
chr1_KI270766v1_alt:130959-134274	chr1_KI270766v1_alt	130959	134274	3315	131691
chr2:95055-99392	chr2	95055	99392	4337	96814
chr2:799542-805567	chr2	799542	805567	6025	802979
chr2:2201945-2205282	chr2	2201945	2205282	3337	2202696
chr2:3083757-3088524	chr2	3083757	3088524	4767	3085939
chr2:3369246-3375395	chr2	3369246	3375395	6149	3372804
chr2:4157808-4163833	chr2	4157808	4163833	6025	4161251
chr2:4642968-4648965	chr2	4642968	4648965	5997	4646405
chr2:4733729-4739760	chr2	4733729	4739760	6031	4737168
chr2:5196905-5199911	chr2	5196905	5199911	3006	5197319
chr2:5258558-5262778	chr2	5258558	5262778	4220	5260211
chr2:8127341-8131954	chr2	8127341	8131954	4613	8129368
chr2:8180334-8184713	chr2	8180334	8184713	4379	8182123
chr2:8968014-8973531	chr2	8968014	8973531	5517	8970940
chr2:9038331-9044482	chr2	9038331	9044482	6151	9041891
chr2:9860962-9867093	chr2	9860962	9867093	6131	9864513
chr2:13719671-13720996	chr2	13719671	13720996	1325	13720297
chr2:14099133-14105291	chr2	14099133	14105291	6158	14102707
chr2:14378950-14381666	chr2	14378950	14381666	2716	14379090
chr2:14848064-14854078	chr2	14848064	14854078	6014	14851504
chr2:15439500-15445667	chr2	15439500	15445667	6167	15443077
chr2:15960364-15963656	chr2	15960364	15963656	3292	15961046
chr2:16878386-16879599	chr2	16878386	16879599	1213	16879407
chr2:18733710-18735715	chr2	18733710	18735715	2005	18733744
chr2:18964469-18965590	chr2	18964469	18965590	1121	18964842
chr2:19089266-19095388	chr2	19089266	19095388	6122	19092837
chr2:19164393-19167658	chr2	19164393	19167658	3265	19165078
chr2:19305839-19311862	chr2	19305839	19311862	6023	19309278
chr2:19581431-19586096	chr2	19581431	19586096	4665	19584182
chr2:19919409-19922725	chr2	19919409	19922725	3316	19920154
chr2:20458302-20464784	chr2	20458302	20464784	6482	20462200
chr2:20711413-20715894	chr2	20711413	20715894	4481	20714956
chr2:21335938-21342064	chr2	21335938	21342064	6126	21339487
chr2:22156442-22162464	chr2	22156442	22162464	6022	22159879
chr2:22305047-22308109	chr2	22305047	22308109	3062	22305520
chr2:22590027-22595389	chr2	22590027	22595389	5362	22592852
chr2:22731494-22734275	chr2	22731494	22734275	2781	22731656
chr2:22984153-22990168	chr2	22984153	22990168	6015	22987598
chr2:23171551-23177697	chr2	23171551	23177697	6146	23175090
chr2:23736568-23742711	chr2	23736568	23742711	6143	23740125
chr2:24095157-24101258	chr2	24095157	24101258	6101	24098706
chr2:28329474-28332318	chr2	28329474	28332318	2844	28329756
chr2:29092095-29094970	chr2	29092095	29094970	2875	29092385
chr2:30814942-30819831	chr2	30814942	30819831	4889	30817243
chr2:30851012-30854220	chr2	30851012	30854220	3208	30851654
chr2:30904198-30910223	chr2	30904198	30910223	6025	30907634
chr2:31492862-31495795	chr2	31492862	31495795	2933	31493240
chr2:31496361-31502450	chr2	31496361	31502450	6089	31499863
chr2:31600995-31604064	chr2	31600995	31604064	3069	31601490
chr2:31750220-31753473	chr2	31750220	31753473	3253	31750883
chr2:31795337-31801439	chr2	31795337	31801439	6102	31798874
chr2:33170013-33176199	chr2	33170013	33176199	6186	33173579
chr2:34508425-34511393	chr2	34508425	34511393	2968	34508814
chr2:34635311-34641476	chr2	34635311	34641476	6165	34638883
chr2:34653392-34656102	chr2	34653392	34656102	2710	34653537
chr2:35012447-35018591	chr2	35012447	35018591	6144	35016008
chr2:35477663-35482933	chr2	35477663	35482933	5270	35481171
chr2:35733858-35740341	chr2	35733858	35740341	6483	35737831
chr2:35766443-35772292	chr2	35766443	35772292	5849	35769705
chr2:36062483-36066662	chr2	36062483	36066662	4179	36064093
chr2:36088311-36092058	chr2	36088311	36092058	3747	36091960
chr2:36097608-36103137	chr2	36097608	36103137	5529	36100575
chr2:37723156-37729270	chr2	37723156	37729270	6114	37726710
chr2:39985141-39988644	chr2	39985141	39988644	3503	39988101
chr2:40024395-40027951	chr2	40024395	40027951	3556	40025391
chr2:40220886-40223525	chr2	40220886	40223525	2639	40220950
chr2:40681884-40684941	chr2	40681884	40684941	3057	40683121
chr2:41056448-41059150	chr2	41056448	41059150	2702	41058666
chr2:41358471-41362266	chr2	41358471	41362266	3795	41362023
chr2:41551964-41553706	chr2	41551964	41553706	1742	41553068
chr2:42989475-42995502	chr2	42989475	42995502	6027	42992913
chr2:45075744-45081776	chr2	45075744	45081776	6032	45079184
chr2:45428601-45431789	chr2	45428601	45431789	3188	45429220
chr2:46219620-46223305	chr2	46219620	46223305	3685	46221193
chr2:47973523-47979858	chr2	47973523	47979858	6335	47977277
chr2:48739839-48745890	chr2	48739839	48745890	6051	48743267
chr2:49082084-49085507	chr2	49082084	49085507	3423	49084919
chr2:49209899-49215937	chr2	49209899	49215937	6038	49213339
chr2:49243412-49248326	chr2	49243412	49248326	4914	49245739
chr2:49300595-49304554	chr2	49300595	49304554	3959	49302045
chr2:49312181-49317565	chr2	49312181	49317565	5384	49314998
chr2:49428696-49432080	chr2	49428696	49432080	3384	49429498
chr2:49480971-49486482	chr2	49480971	49486482	5511	49483898
chr2:49881889-49888348	chr2	49881889	49888348	6459	49885763
chr2:50357784-50364248	chr2	50357784	50364248	6464	50361673
chr2:51391397-51397636	chr2	51391397	51397636	6239	51395063
chr2:51836056-51837426	chr2	51836056	51837426	1370	51836590
chr2:51891839-51896066	chr2	51891839	51896066	4227	51894885
chr2:51913304-51917406	chr2	51913304	51917406	4102	51914859
chr2:53162764-53166901	chr2	53162764	53166901	4137	53164299
chr2:53587033-53593044	chr2	53587033	53593044	6011	53590463
chr2:53663023-53667679	chr2	53663023	53667679	4656	53665100
chr2:55442106-55447873	chr2	55442106	55447873	5767	55445664
chr2:55462161-55468310	chr2	55462161	55468310	6149	55465719
chr2:55814032-55820140	chr2	55814032	55820140	6108	55817564
chr2:56079324-56082083	chr2	56079324	56082083	2759	56079530
chr2:56319846-56323306	chr2	56319846	56323306	3460	56320714
chr2:56421065-56427207	chr2	56421065	56427207	6142	56424607
chr2:56601355-56602977	chr2	56601355	56602977	1622	56601442
chr2:56725906-56726694	chr2	56725906	56726694	788	56726115
chr2:56817517-56822722	chr2	56817517	56822722	5205	56820015
chr2:57018456-57019479	chr2	57018456	57019479	1023	57018837
chr2:57282460-57286075	chr2	57282460	57286075	3615	57283902
chr2:57306563-57309347	chr2	57306563	57309347	2784	57306767
chr2:57418710-57424719	chr2	57418710	57424719	6009	57422137
chr2:57587069-57592429	chr2	57587069	57592429	5360	57589847
chr2:57608847-57614848	chr2	57608847	57614848	6001	57612259
chr2:57827620-57831808	chr2	57827620	57831808	4188	57831589
chr2:58173758-58177788	chr2	58173758	58177788	4030	58175208
chr2:58177808-58180717	chr2	58177808	58180717	2909	58178164
chr2:58325341-58331263	chr2	58325341	58331263	5922	58328899
chr2:58688932-58694629	chr2	58688932	58694629	5697	58692075
chr2:59261403-59265611	chr2	59261403	59265611	4208	59263020
chr2:59326307-59332440	chr2	59326307	59332440	6133	59329869
chr2:59431320-59432884	chr2	59431320	59432884	1564	59431576
chr2:59556385-59559164	chr2	59556385	59559164	2779	59556573
chr2:60034873-60040756	chr2	60034873	60040756	5883	60038421
chr2:60083662-60089694	chr2	60083662	60089694	6032	60087102
chr2:60141191-60147223	chr2	60141191	60147223	6032	60144631
chr2:60189023-60195053	chr2	60189023	60195053	6030	60192460
chr2:62605237-62611375	chr2	62605237	62611375	6138	62608793
chr2:62835478-62841498	chr2	62835478	62841498	6020	62838915
chr2:63210476-63216721	chr2	63210476	63216721	6245	63214046
chr2:63305907-63308890	chr2	63305907	63308890	2983	63306314
chr2:63388138-63393542	chr2	63388138	63393542	5404	63390964
chr2:63451020-63453355	chr2	63451020	63453355	2335	63451518
chr2:63507549-63510691	chr2	63507549	63510691	3142	63510005
chr2:63530723-63536624	chr2	63530723	63536624	5901	63534284
chr2:63623031-63626801	chr2	63623031	63626801	3770	63624754
chr2:63926516-63932665	chr2	63926516	63932665	6149	63930087
chr2:64891026-64897091	chr2	64891026	64897091	6065	64894581
chr2:65892476-65896399	chr2	65892476	65896399	3923	65893843
chr2:66177170-66183202	chr2	66177170	66183202	6032	66180613
chr2:66206329-66212369	chr2	66206329	66212369	6040	66209758
chr2:66391130-66397150	chr2	66391130	66397150	6020	66394559
chr2:67356064-67362249	chr2	67356064	67362249	6185	67359673
chr2:67507103-67508437	chr2	67507103	67508437	1334	67507767
chr2:67588934-67595046	chr2	67588934	67595046	6112	67592470
chr2:68003770-68006943	chr2	68003770	68006943	3173	68004405
chr2:68014913-68017967	chr2	68014913	68017967	3054	68015378
chr2:68063790-68069928	chr2	68063790	68069928	6138	68067307
chr2:68346762-68350084	chr2	68346762	68350084	3322	68347554
chr2:68404908-68411339	chr2	68404908	68411339	6431	68408754
chr2:68597238-68601083	chr2	68597238	68601083	3845	68598534
chr2:70842198-70848320	chr2	70842198	70848320	6122	70845744
chr2:72063975-72069997	chr2	72063975	72069997	6022	72067402
chr2:72368166-72371003	chr2	72368166	72371003	2837	72368438
chr2:72403730-72409869	chr2	72403730	72409869	6139	72407289
chr2:72643839-72648592	chr2	72643839	72648592	4753	72646367
chr2:72703965-72705447	chr2	72703965	72705447	1482	72704902
chr2:73460454-73466651	chr2	73460454	73466651	6197	73464019
chr2:73538400-73544525	chr2	73538400	73544525	6125	73541942
chr2:73721395-73727535	chr2	73721395	73727535	6140	73724959
chr2:74986883-74989596	chr2	74986883	74989596	2713	74987029
chr2:75329135-75332326	chr2	75329135	75332326	3191	75329735
chr2:76796817-76801677	chr2	76796817	76801677	4860	76799025
chr2:76904973-76910509	chr2	76904973	76910509	5536	76907917
chr2:77136112-77141625	chr2	77136112	77141625	5513	77139047
chr2:77161907-77167963	chr2	77161907	77167963	6056	77165386
chr2:77219769-77225373	chr2	77219769	77225373	5604	77222781
chr2:77592831-77598845	chr2	77592831	77598845	6014	77596256
chr2:77753772-77759778	chr2	77753772	77759778	6006	77757190
chr2:77842648-77846388	chr2	77842648	77846388	3740	77843860
chr2:78162329-78166169	chr2	78162329	78166169	3840	78163645
chr2:78654532-78660912	chr2	78654532	78660912	6380	78658387
chr2:79465914-79470114	chr2	79465914	79470114	4200	79469453
chr2:80807057-80812611	chr2	80807057	80812611	5554	80810096
chr2:80814794-80821022	chr2	80814794	80821022	6228	80818709
chr2:81208654-81211319	chr2	81208654	81211319	2665	81209866
chr2:82241497-82245139	chr2	82241497	82245139	3642	82242539
chr2:82516664-82517570	chr2	82516664	82517570	906	82516866
chr2:82875301-82881898	chr2	82875301	82881898	6597	82879318
chr2:83088804-83094831	chr2	83088804	83094831	6027	83092241
chr2:83347474-83353489	chr2	83347474	83353489	6015	83350910
chr2:83768302-83774332	chr2	83768302	83774332	6030	83771742
chr2:83976400-83982544	chr2	83976400	83982544	6144	83979956
chr2:84104657-84110192	chr2	84104657	84110192	5535	84107603
chr2:84224738-84230910	chr2	84224738	84230910	6172	84228312
chr2:84262379-84268496	chr2	84262379	84268496	6117	84265918
chr2:84353645-84359968	chr2	84353645	84359968	6323	84357387
chr2:84398282-84400830	chr2	84398282	84400830	2548	84400147
chr2:84662149-84668251	chr2	84662149	84668251	6102	84665674
chr2:85963806-85969950	chr2	85963806	85969950	6144	85967358
chr2:87841589-87844222	chr2	87841589	87844222	2633	87841634
chr2:88729712-88732741	chr2	88729712	88732741	3029	88730149
chr2:89259304-89260504	chr2	89259304	89260504	1200	89259445
chr2:91446947-91453083	chr2	91446947	91453083	6136	91450500
chr2:91903455-91907484	chr2	91903455	91907484	4029	91904902
chr2:91921173-91927204	chr2	91921173	91927204	6031	91924613
chr2:91950717-91952959	chr2	91950717	91952959	2242	91952654
chr2:91968761-91971877	chr2	91968761	91971877	3116	91969283
chr2:94496017-94499162	chr2	94496017	94499162	3145	94496625
chr2:94646822-94648013	chr2	94646822	94648013	1191	94647925
chr2:95092743-95098852	chr2	95092743	95098852	6109	95096259
chr2:95778476-95784619	chr2	95778476	95784619	6143	95782023
chr2:95823540-95824353	chr2	95823540	95824353	813	95824254
chr2:95869529-95875690	chr2	95869529	95875690	6161	95873091
chr2:96378981-96385131	chr2	96378981	96385131	6150	96382539
chr2:96441168-96445854	chr2	96441168	96445854	4686	96444019
chr2:96454434-96460785	chr2	96454434	96460785	6351	96458281
chr2:97525420-97531566	chr2	97525420	97531566	6146	97528978
chr2:97872470-97878856	chr2	97872470	97878856	6386	97876280
chr2:97937801-97940526	chr2	97937801	97940526	2725	97939599
chr2:98074901-98077796	chr2	98074901	98077796	2895	98075203
chr2:98267381-98268402	chr2	98267381	98268402	1021	98268114
chr2:98977835-98984019	chr2	98977835	98984019	6184	98981428
chr2:98990735-98993198	chr2	98990735	98993198	2463	98992627
chr2:99003156-99007304	chr2	99003156	99007304	4148	99004372
chr2:99045235-99049744	chr2	99045235	99049744	4509	99047147
chr2:101935390-101940619	chr2	101935390	101940619	5229	101939227
chr2:102324371-102330501	chr2	102324371	102330501	6130	102327929
chr2:103200565-103206694	chr2	103200565	103206694	6129	103204110
chr2:106130892-106136925	chr2	106130892	106136925	6033	106134333
chr2:106909803-106913395	chr2	106909803	106913395	3592	106912746
chr2:107236628-107239582	chr2	107236628	107239582	2954	107236985
chr2:108647020-108649977	chr2	108647020	108649977	2957	108647389
chr2:109309331-109311588	chr2	109309331	109311588	2257	109310916
chr2:109952956-109959093	chr2	109952956	109959093	6137	109956523
chr2:110191029-110196929	chr2	110191029	110196929	5900	110194581
chr2:110250921-110257059	chr2	110250921	110257059	6138	110254489
chr2:110297435-110299093	chr2	110297435	110299093	1658	110298524
chr2:110440325-110441265	chr2	110440325	110441265	940	110440725
chr2:110916307-110919566	chr2	110916307	110919566	3259	110916981
chr2:111080503-111083194	chr2	111080503	111083194	2691	111080595
chr2:111588847-111591614	chr2	111588847	111591614	2767	111589049
chr2:113658897-113663203	chr2	113658897	113663203	4306	113660617
chr2:114286779-114289753	chr2	114286779	114289753	2974	114287164
chr2:114335582-114336791	chr2	114335582	114336791	1209	114336667
chr2:115013548-115016724	chr2	115013548	115016724	3176	115014925
chr2:116036256-116039676	chr2	116036256	116039676	3420	116037091
chr2:116234072-116236869	chr2	116234072	116236869	2797	116234304
chr2:116358672-116363984	chr2	116358672	116363984	5312	116361428
chr2:116399711-116401674	chr2	116399711	116401674	1963	116401520
chr2:116552825-116556729	chr2	116552825	116556729	3904	116556343
chr2:117001151-117007277	chr2	117001151	117007277	6126	117004691
chr2:117156034-117162051	chr2	117156034	117162051	6017	117159461
chr2:117208814-117210610	chr2	117208814	117210610	1796	117209344
chr2:117472198-117478772	chr2	117472198	117478772	6574	117476119
chr2:117525395-117530328	chr2	117525395	117530328	4933	117528795
chr2:117579236-117584661	chr2	117579236	117584661	5425	117583256
chr2:117623253-117629278	chr2	117623253	117629278	6025	117626689
chr2:117649184-117655215	chr2	117649184	117655215	6031	117652622
chr2:117778178-117784316	chr2	117778178	117784316	6138	117781731
chr2:117803780-117809809	chr2	117803780	117809809	6029	117807222
chr2:117897887-117902118	chr2	117897887	117902118	4231	117899542
chr2:117923683-117929272	chr2	117923683	117929272	5589	117926693
chr2:118999565-119001635	chr2	118999565	119001635	2070	118999978
chr2:119095768-119101847	chr2	119095768	119101847	6079	119099273
chr2:120069158-120072942	chr2	120069158	120072942	3784	120070405
chr2:120185694-120188893	chr2	120185694	120188893	3199	120186302
chr2:122550745-122556816	chr2	122550745	122556816	6071	122554240
chr2:123423552-123426715	chr2	123423552	123426715	3163	123424145
chr2:123628724-123634742	chr2	123628724	123634742	6018	123632152
chr2:123855318-123861591	chr2	123855318	123861591	6273	123858989
chr2:124122949-124129073	chr2	124122949	124129073	6124	124126483
chr2:124139775-124145807	chr2	124139775	124145807	6032	124143215
chr2:124407870-124413893	chr2	124407870	124413893	6023	124411302
chr2:124626282-124632724	chr2	124626282	124632724	6442	124630148
chr2:125357970-125363458	chr2	125357970	125363458	5488	125360923
chr2:125622954-125627543	chr2	125622954	125627543	4589	125624942
chr2:125825533-125831674	chr2	125825533	125831674	6141	125829095
chr2:126086455-126090228	chr2	126086455	126090228	3773	126087642
chr2:126160486-126165775	chr2	126160486	126165775	5289	126164345
chr2:126195613-126199204	chr2	126195613	126199204	3591	126199165
chr2:128826419-128830833	chr2	128826419	128830833	4414	128828273
chr2:128848973-128854229	chr2	128848973	128854229	5256	128852513
chr2:128964615-128967505	chr2	128964615	128967505	2890	128964916
chr2:129531920-129537968	chr2	129531920	129537968	6048	129535373
chr2:129569283-129574947	chr2	129569283	129574947	5664	129572403
chr2:131184415-131187237	chr2	131184415	131187237	2822	131184655
chr2:131373901-131379444	chr2	131373901	131379444	5543	131376851
chr2:132231325-132237282	chr2	132231325	132237282	5957	132234760
chr2:132528881-132535004	chr2	132528881	132535004	6123	132532419
chr2:133188191-133191925	chr2	133188191	133191925	3734	133189358
chr2:133299870-133302778	chr2	133299870	133302778	2908	133300202
chr2:133546865-133552758	chr2	133546865	133552758	5893	133550171
chr2:133614287-133619317	chr2	133614287	133619317	5030	133616726
chr2:133910480-133916504	chr2	133910480	133916504	6024	133913920
chr2:134042779-134048904	chr2	134042779	134048904	6125	134046312
chr2:134064987-134067823	chr2	134064987	134067823	2836	134065480
chr2:134825451-134831458	chr2	134825451	134831458	6007	134828878
chr2:135231810-135237948	chr2	135231810	135237948	6138	135235361
chr2:135380867-135387000	chr2	135380867	135387000	6133	135384418
chr2:135402975-135408984	chr2	135402975	135408984	6009	135406396
chr2:135413765-135418121	chr2	135413765	135418121	4356	135415531
chr2:135938595-135942665	chr2	135938595	135942665	4070	135940082
chr2:136596065-136602178	chr2	136596065	136602178	6113	136599604
chr2:136679871-136682542	chr2	136679871	136682542	2671	136679947
chr2:137101514-137107548	chr2	137101514	137107548	6034	137104982
chr2:137554560-137560715	chr2	137554560	137560715	6155	137558137
chr2:137622457-137625482	chr2	137622457	137625482	3025	137622902
chr2:138256587-138259554	chr2	138256587	138259554	2967	138257004
chr2:138290277-138291338	chr2	138290277	138291338	1061	138290508
chr2:138795654-138802086	chr2	138795654	138802086	6432	138799503
chr2:138888957-138890627	chr2	138888957	138890627	1670	138889523
chr2:138932356-138934750	chr2	138932356	138934750	2394	138932902
chr2:139307940-139311227	chr2	139307940	139311227	3287	139308640
chr2:139397682-139400056	chr2	139397682	139400056	2374	139398447
chr2:139649031-139652123	chr2	139649031	139652123	3092	139651732
chr2:139879468-139880492	chr2	139879468	139880492	1024	139879842
chr2:139929830-139931857	chr2	139929830	139931857	2027	139931283
chr2:141070198-141072019	chr2	141070198	141072019	1821	141070929
chr2:141218786-141224987	chr2	141218786	141224987	6201	141222453
chr2:141570162-141576585	chr2	141570162	141576585	6423	141574019
chr2:141660027-141665185	chr2	141660027	141665185	5158	141663762
chr2:142727867-142734001	chr2	142727867	142734001	6134	142731419
chr2:143006042-143012076	chr2	143006042	143012076	6034	143009484
chr2:143661562-143667611	chr2	143661562	143667611	6049	143664991
chr2:143860956-143866987	chr2	143860956	143866987	6031	143864395
chr2:144104121-144108357	chr2	144104121	144108357	4236	144107678
chr2:144721671-144723358	chr2	144721671	144723358	1687	144722952
chr2:144784975-144790758	chr2	144784975	144790758	5783	144788821
chr2:145439830-145442752	chr2	145439830	145442752	2922	145440178
chr2:145782395-145788484	chr2	145782395	145788484	6089	145785940
chr2:146075368-146077262	chr2	146075368	146077262	1894	146076844
chr2:146152851-146153757	chr2	146152851	146153757	906	146152897
chr2:146405741-146411341	chr2	146405741	146411341	5600	146409179
chr2:146643934-146648001	chr2	146643934	146648001	4067	146645407
chr2:146788403-146794539	chr2	146788403	146794539	6136	146791961
chr2:147150812-147156955	chr2	147150812	147156955	6143	147154379
chr2:147182222-147188529	chr2	147182222	147188529	6307	147185957
chr2:147281137-147283870	chr2	147281137	147283870	2733	147281163
chr2:147727004-147733028	chr2	147727004	147733028	6024	147730443
chr2:147766522-147772633	chr2	147766522	147772633	6111	147770057
chr2:148001383-148004745	chr2	148001383	148004745	3362	148003186
chr2:148188745-148194773	chr2	148188745	148194773	6028	148192182
chr2:148363532-148368483	chr2	148363532	148368483	4951	148365900
chr2:148380603-148386123	chr2	148380603	148386123	5520	148383530
chr2:148424207-148427801	chr2	148424207	148427801	3594	148425460
chr2:149648025-149648449	chr2	149648025	149648449	424	149648303
chr2:149850457-149856466	chr2	149850457	149856466	6009	149853882
chr2:149910910-149913829	chr2	149910910	149913829	2919	149911236
chr2:149945265-149951292	chr2	149945265	149951292	6027	149948703
chr2:149965733-149971865	chr2	149965733	149971865	6132	149969282
chr2:150192338-150196424	chr2	150192338	150196424	4086	150195741
chr2:151556839-151559953	chr2	151556839	151559953	3114	151557442
chr2:151743367-151749492	chr2	151743367	151749492	6125	151746903
chr2:152194123-152198430	chr2	152194123	152198430	4307	152195843
chr2:152996138-153001862	chr2	152996138	153001862	5724	152999283
chr2:153244351-153248532	chr2	153244351	153248532	4181	153248136
chr2:153359993-153366417	chr2	153359993	153366417	6424	153363812
chr2:153699162-153702483	chr2	153699162	153702483	3321	153699915
chr2:153719447-153725466	chr2	153719447	153725466	6019	153722878
chr2:155476781-155479947	chr2	155476781	155479947	3166	155477365
chr2:155747822-155752855	chr2	155747822	155752855	5033	155751795
chr2:155879907-155885578	chr2	155879907	155885578	5671	155883778
chr2:155965887-155971915	chr2	155965887	155971915	6028	155969320
chr2:156049606-156051294	chr2	156049606	156051294	1688	156050661
chr2:156254518-156260532	chr2	156254518	156260532	6014	156257954
chr2:157069627-157073758	chr2	157069627	157073758	4131	157071170
chr2:157368535-157374566	chr2	157368535	157374566	6031	157371975
chr2:157515143-157521173	chr2	157515143	157521173	6030	157518580
chr2:157566353-157572377	chr2	157566353	157572377	6024	157569787
chr2:157704176-157710617	chr2	157704176	157710617	6441	157708051
chr2:158222832-158229001	chr2	158222832	158229001	6169	158226379
chr2:158278138-158284288	chr2	158278138	158284288	6150	158281701
chr2:158295106-158295944	chr2	158295106	158295944	838	158295298
chr2:158351231-158357242	chr2	158351231	158357242	6011	158354652
chr2:158397230-158401705	chr2	158397230	158401705	4475	158399199
chr2:158420131-158424727	chr2	158420131	158424727	4596	158422162
chr2:158522617-158528649	chr2	158522617	158528649	6032	158526058
chr2:159578499-159582073	chr2	159578499	159582073	3574	159579499
chr2:159821740-159828118	chr2	159821740	159828118	6378	159825532
chr2:160114516-160119928	chr2	160114516	160119928	5412	160118088
chr2:160133093-160137062	chr2	160133093	160137062	3969	160134479
chr2:160148479-160154581	chr2	160148479	160154581	6102	160152021
chr2:160180695-160187127	chr2	160180695	160187127	6432	160184553
chr2:160766499-160772615	chr2	160766499	160772615	6116	160770031
chr2:160797332-160803466	chr2	160797332	160803466	6134	160800896
chr2:161010001-161016450	chr2	161010001	161016450	6449	161013867
chr2:161536248-161541694	chr2	161536248	161541694	5446	161539103
chr2:161567011-161568449	chr2	161567011	161568449	1438	161567195
chr2:162985708-162988432	chr2	162985708	162988432	2724	162985843
chr2:163282214-163284302	chr2	163282214	163284302	2088	163283085
chr2:163497385-163503793	chr2	163497385	163503793	6408	163501244
chr2:164261247-164267132	chr2	164261247	164267132	5885	164264561
chr2:164290539-164294184	chr2	164290539	164294184	3645	164291596
chr2:165485934-165491963	chr2	165485934	165491963	6029	165489371
chr2:165531620-165533012	chr2	165531620	165533012	1392	165532133
chr2:166581223-166587377	chr2	166581223	166587377	6154	166584798
chr2:166853711-166859875	chr2	166853711	166859875	6164	166857264
chr2:166988454-166994509	chr2	166988454	166994509	6055	166991898
chr2:167154653-167156317	chr2	167154653	167156317	1664	167155170
chr2:167558320-167562649	chr2	167558320	167562649	4329	167561880
chr2:167633327-167636078	chr2	167633327	167636078	2751	167634776
chr2:167835042-167841189	chr2	167835042	167841189	6147	167838601
chr2:168867268-168871365	chr2	168867268	168871365	4097	168868780
chr2:169248623-169254656	chr2	169248623	169254656	6033	169252064
chr2:169261613-169264258	chr2	169261613	169264258	2645	169261668
chr2:169267266-169270017	chr2	169267266	169270017	2751	169268181
chr2:169367295-169370030	chr2	169367295	169370030	2735	169367441
chr2:169399205-169405299	chr2	169399205	169405299	6094	169402738
chr2:169452781-169458934	chr2	169452781	169458934	6153	169456337
chr2:169971731-169973523	chr2	169971731	169973523	1792	169972338
chr2:170125609-170132074	chr2	170125609	170132074	6465	170129497
chr2:170631752-170635617	chr2	170631752	170635617	3865	170633045
chr2:171378658-171381780	chr2	171378658	171381780	3122	171379822
chr2:172315270-172321297	chr2	172315270	172321297	6027	172318706
chr2:174269465-174274467	chr2	174269465	174274467	5002	174271872
chr2:174287996-174292112	chr2	174287996	174292112	4116	174289523
chr2:175189721-175192885	chr2	175189721	175192885	3164	175190302
chr2:175505659-175509589	chr2	175505659	175509589	3930	175507037
chr2:175671483-175674797	chr2	175671483	175674797	3314	175672214
chr2:175708820-175715273	chr2	175708820	175715273	6453	175712690
chr2:175717204-175722730	chr2	175717204	175722730	5526	175720141
chr2:175759595-175765629	chr2	175759595	175765629	6034	175763036
chr2:175957588-175963710	chr2	175957588	175963710	6122	175961130
chr2:176796422-176802427	chr2	176796422	176802427	6005	176799840
chr2:177456750-177460326	chr2	177456750	177460326	3576	177457757
chr2:177785395-177791549	chr2	177785395	177791549	6154	177788963
chr2:177973073-177979090	chr2	177973073	177979090	6017	177976513
chr2:178032531-178038048	chr2	178032531	178038048	5517	178035450
chr2:178049371-178055510	chr2	178049371	178055510	6139	178052938
chr2:178352113-178358247	chr2	178352113	178358247	6134	178355661
chr2:178965323-178970927	chr2	178965323	178970927	5604	178969176
chr2:178982451-178988482	chr2	178982451	178988482	6031	178985891
chr2:179079603-179080345	chr2	179079603	179080345	742	179080066
chr2:179195944-179201918	chr2	179195944	179201918	5974	179199379
chr2:179314496-179318894	chr2	179314496	179318894	4398	179318056
chr2:179387868-179391890	chr2	179387868	179391890	4022	179389320
chr2:179629553-179633799	chr2	179629553	179633799	4246	179633127
chr2:180052480-180055127	chr2	180052480	180055127	2647	180052541
chr2:180767224-180769322	chr2	180767224	180769322	2098	180768654
chr2:181088926-181095379	chr2	181088926	181095379	6453	181092797
chr2:181731649-181737831	chr2	181731649	181737831	6182	181735240
chr2:182212404-182218434	chr2	182212404	182218434	6030	182215840
chr2:182686554-182692673	chr2	182686554	182692673	6119	182690104
chr2:183418859-183422593	chr2	183418859	183422593	3734	183420013
chr2:183547211-183551127	chr2	183547211	183551127	3916	183548558
chr2:183586195-183592337	chr2	183586195	183592337	6142	183589749
chr2:183793322-183797551	chr2	183793322	183797551	4229	183794986
chr2:183849523-183855550	chr2	183849523	183855550	6027	183852959
chr2:183975444-183980331	chr2	183975444	183980331	4887	183978991
chr2:184243126-184246740	chr2	184243126	184246740	3614	184244174
chr2:185193025-185194777	chr2	185193025	185194777	1752	185194042
chr2:185291936-185296515	chr2	185291936	185296515	4579	185294504
chr2:185377484-185380663	chr2	185377484	185380663	3179	185378105
chr2:185849191-185850330	chr2	185849191	185850330	1139	185849623
chr2:185864597-185870656	chr2	185864597	185870656	6059	185868035
chr2:186009588-186014912	chr2	186009588	186014912	5324	186012351
chr2:186230323-186236462	chr2	186230323	186236462	6139	186233874
chr2:186313075-186318950	chr2	186313075	186318950	5875	186316341
chr2:186792721-186799099	chr2	186792721	186799099	6378	186796550
chr2:186811774-186817171	chr2	186811774	186817171	5397	186815395
chr2:188123561-188129537	chr2	188123561	188129537	5976	188126945
chr2:188825978-188828044	chr2	188825978	188828044	2066	188827794
chr2:188861992-188868402	chr2	188861992	188868402	6410	188865839
chr2:189026777-189030101	chr2	189026777	189030101	3324	189027481
chr2:189319190-189325324	chr2	189319190	189325324	6134	189322751
chr2:189432303-189436165	chr2	189432303	189436165	3862	189433756
chr2:189714967-189718098	chr2	189714967	189718098	3131	189715513
chr2:190117931-190119130	chr2	190117931	190119130	1199	190118291
chr2:190224335-190226313	chr2	190224335	190226313	1978	190225694
chr2:190471104-190477209	chr2	190471104	190477209	6105	190474640
chr2:190555815-190558472	chr2	190555815	190558472	2657	190555901
chr2:191094712-191098769	chr2	191094712	191098769	4057	191096193
chr2:191761849-191767876	chr2	191761849	191767876	6027	191765287
chr2:192386391-192386683	chr2	192386391	192386683	292	192386587
chr2:192524170-192530640	chr2	192524170	192530640	6470	192528070
chr2:193406818-193409552	chr2	193406818	193409552	2734	193407015
chr2:193648468-193650058	chr2	193648468	193650058	1590	193648643
chr2:194390840-194394862	chr2	194390840	194394862	4022	194392272
chr2:194446428-194449633	chr2	194446428	194449633	3205	194447045
chr2:194639129-194644911	chr2	194639129	194644911	5782	194642351
chr2:194808404-194812039	chr2	194808404	194812039	3635	194809451
chr2:194939427-194942631	chr2	194939427	194942631	3204	194940046
chr2:195224010-195228435	chr2	195224010	195228435	4425	195226211
chr2:195228435-195233711	chr2	195228435	195233711	5276	195231875
chr2:195523002-195529095	chr2	195523002	195529095	6093	195526553
chr2:195743883-195749992	chr2	195743883	195749992	6109	195747412
chr2:196905587-196911636	chr2	196905587	196911636	6049	196909027
chr2:197064423-197068374	chr2	197064423	197068374	3951	197065863
chr2:197728962-197734964	chr2	197728962	197734964	6002	197732384
chr2:197747953-197754294	chr2	197747953	197754294	6341	197751719
chr2:197830078-197832947	chr2	197830078	197832947	2869	197832576
chr2:198196260-198202415	chr2	198196260	198202415	6155	198199805
chr2:198528912-198531548	chr2	198528912	198531548	2636	198528965
chr2:198581976-198586261	chr2	198581976	198586261	4285	198583675
chr2:198894019-198897256	chr2	198894019	198897256	3237	198895497
chr2:199028485-199034598	chr2	199028485	199034598	6113	199032013
chr2:199074069-199077697	chr2	199074069	199077697	3628	199075168
chr2:199887773-199892735	chr2	199887773	199892735	4962	199890162
chr2:200204035-200207058	chr2	200204035	200207058	3023	200204472
chr2:200499453-200502297	chr2	200499453	200502297	2844	200499703
chr2:201025936-201029937	chr2	201025936	201029937	4001	201027388
chr2:201036027-201038907	chr2	201036027	201038907	2880	201036317
chr2:201290544-201296670	chr2	201290544	201296670	6126	201294096
chr2:201299945-201306098	chr2	201299945	201306098	6153	201303504
chr2:201369726-201375774	chr2	201369726	201375774	6048	201373201
chr2:201612600-201618705	chr2	201612600	201618705	6105	201616131
chr2:203699254-203700141	chr2	203699254	203700141	887	203699466
chr2:205206760-205209385	chr2	205206760	205209385	2625	205207792
chr2:206494817-206499652	chr2	206494817	206499652	4835	206497076
chr2:206908035-206914052	chr2	206908035	206914052	6017	206911465
chr2:206927007-206931028	chr2	206927007	206931028	4021	206929948
chr2:207000910-207006934	chr2	207000910	207006934	6024	207004336
chr2:207344166-207350576	chr2	207344166	207350576	6410	207348025
chr2:208760978-208766284	chr2	208760978	208766284	5306	208763699
chr2:208773457-208776294	chr2	208773457	208776294	2837	208773720
chr2:208784256-208790424	chr2	208784256	208790424	6168	208787839
chr2:208800640-208806791	chr2	208800640	208806791	6151	208804210
chr2:208811621-208817648	chr2	208811621	208817648	6027	208815056
chr2:208831567-208837733	chr2	208831567	208837733	6166	208835143
chr2:208894674-208900079	chr2	208894674	208900079	5405	208897488
chr2:209021184-209026294	chr2	209021184	209026294	5110	209023732
chr2:209163636-209169053	chr2	209163636	209169053	5417	209166452
chr2:209241960-209247498	chr2	209241960	209247498	5538	209245041
chr2:209261434-209267527	chr2	209261434	209267527	6093	209264945
chr2:209284727-209287849	chr2	209284727	209287849	3122	209285271
chr2:209371719-209375160	chr2	209371719	209375160	3441	209372580
chr2:210350623-210356764	chr2	210350623	210356764	6141	210354180
chr2:210445919-210451484	chr2	210445919	210451484	5565	210448929
chr2:210505420-210511544	chr2	210505420	210511544	6124	210508954
chr2:210760550-210762399	chr2	210760550	210762399	1849	210761421
chr2:211219320-211225344	chr2	211219320	211225344	6024	211222759
chr2:211888536-211894571	chr2	211888536	211894571	6035	211891981
chr2:212054824-212060959	chr2	212054824	212060959	6135	212058364
chr2:212585773-212586732	chr2	212585773	212586732	959	212585848
chr2:212753208-212756641	chr2	212753208	212756641	3433	212756346
chr2:212756649-212762802	chr2	212756649	212762802	6153	212760196
chr2:212858893-212861704	chr2	212858893	212861704	2811	212859126
chr2:212875721-212881888	chr2	212875721	212881888	6167	212879265
chr2:212884161-212888599	chr2	212884161	212888599	4438	212886029
chr2:214173517-214174533	chr2	214173517	214174533	1016	214173649
chr2:214683796-214689805	chr2	214683796	214689805	6009	214687213
chr2:215220243-215226331	chr2	215220243	215226331	6088	215223743
chr2:215252971-215259113	chr2	215252971	215259113	6142	215256531
chr2:215819019-215825477	chr2	215819019	215825477	6458	215822897
chr2:215976650-215978919	chr2	215976650	215978919	2269	215978457
chr2:215988086-215994568	chr2	215988086	215994568	6482	215991970
chr2:216323379-216326974	chr2	216323379	216326974	3595	216324389
chr2:216454715-216460842	chr2	216454715	216460842	6127	216458258
chr2:219931818-219937838	chr2	219931818	219937838	6020	219935251
chr2:221984562-221990586	chr2	221984562	221990586	6024	221988002
chr2:222584377-222590526	chr2	222584377	222590526	6149	222587932
chr2:223012587-223018014	chr2	223012587	223018014	5427	223015433
chr2:223330510-223336653	chr2	223330510	223336653	6143	223334076
chr2:223790798-223793675	chr2	223790798	223793675	2877	223791101
chr2:224484836-224489748	chr2	224484836	224489748	4912	224488686
chr2:225127766-225129765	chr2	225127766	225129765	1999	225128589
chr2:225712805-225716279	chr2	225712805	225716279	3474	225713695
chr2:226107276-226113417	chr2	226107276	226113417	6141	226110824
chr2:226252834-226256216	chr2	226252834	226256216	3382	226253645
chr2:226453620-226458769	chr2	226453620	226458769	5149	226457290
chr2:227064885-227070875	chr2	227064885	227070875	5990	227068292
chr2:228030894-228037043	chr2	228030894	228037043	6149	228034454
chr2:228568257-228574281	chr2	228568257	228574281	6024	228571700
chr2:228755693-228761717	chr2	228755693	228761717	6024	228759133
chr2:230525443-230531552	chr2	230525443	230531552	6109	230529001
chr2:230603339-230607843	chr2	230603339	230607843	4504	230607209
chr2:230622438-230625750	chr2	230622438	230625750	3312	230623170
chr2:230802109-230805410	chr2	230802109	230805410	3301	230802832
chr2:232355238-232361245	chr2	232355238	232361245	6007	232358668
chr2:234775486-234781643	chr2	234775486	234781643	6157	234779042
chr2:234888389-234894419	chr2	234888389	234894419	6030	234891824
chr2:236421116-236424207	chr2	236421116	236424207	3091	236421634
chr2:240544494-240550522	chr2	240544494	240550522	6028	240547937
chr20:129964-135977	chr20	129964	135977	6013	133403
chr20:1216781-1221343	chr20	1216781	1221343	4562	1220296
chr20:1742269-1745033	chr20	1742269	1745033	2764	1742441
chr20:2266570-2270606	chr20	2266570	2270606	4036	2268027
chr20:2500825-2506958	chr20	2500825	2506958	6133	2504374
chr20:3497913-3501511	chr20	3497913	3501511	3598	3498256
chr20:3522344-3528081	chr20	3522344	3528081	5737	3525474
chr20:4388486-4391347	chr20	4388486	4391347	2861	4389113
chr20:5277909-5279185	chr20	5277909	5279185	1276	5278786
chr20:6189258-6193082	chr20	6189258	6193082	3824	6190491
chr20:6969859-6971483	chr20	6969859	6971483	1624	6971137
chr20:8445925-8446690	chr20	8445925	8446690	765	8445981
chr20:9461287-9467437	chr20	9461287	9467437	6150	9464856
chr20:9746778-9748554	chr20	9746778	9748554	1776	9747259
chr20:9858428-9861663	chr20	9858428	9861663	3235	9859071
chr20:10159067-10163313	chr20	10159067	10163313	4246	10162637
chr20:10819436-10822465	chr20	10819436	10822465	3029	10819888
chr20:11632779-11638837	chr20	11632779	11638837	6058	11636214
chr20:11728206-11734197	chr20	11728206	11734197	5991	11731612
chr20:12147202-12148297	chr20	12147202	12148297	1095	12147477
chr20:12477508-12481122	chr20	12477508	12481122	3614	12478529
chr20:12491624-12497742	chr20	12491624	12497742	6118	12495166
chr20:12582507-12588531	chr20	12582507	12588531	6024	12585941
chr20:12662762-12668255	chr20	12662762	12668255	5493	12665711
chr20:13596387-13599688	chr20	13596387	13599688	3301	13597106
chr20:14270711-14276637	chr20	14270711	14276637	5926	14274069
chr20:14806154-14812579	chr20	14806154	14812579	6425	14810012
chr20:15134318-15137722	chr20	15134318	15137722	3404	15135138
chr20:17411115-17417183	chr20	17411115	17417183	6068	17414609
chr20:18125192-18127819	chr20	18125192	18127819	2627	18125221
chr20:18332912-18339088	chr20	18332912	18339088	6176	18336497
chr20:18601523-18606939	chr20	18601523	18606939	5416	18604349
chr20:19034031-19036926	chr20	19034031	19036926	2895	19034332
chr20:21413527-21418677	chr20	21413527	21418677	5150	21417406
chr20:21856828-21859907	chr20	21856828	21859907	3079	21857322
chr20:21887655-21893685	chr20	21887655	21893685	6030	21891093
chr20:21928988-21933105	chr20	21928988	21933105	4117	21930517
chr20:22009432-22014844	chr20	22009432	22014844	5412	22013005
chr20:22114636-22119281	chr20	22114636	22119281	4645	22118184
chr20:22131755-22135333	chr20	22131755	22135333	3578	22132748
chr20:22194131-22200273	chr20	22194131	22200273	6142	22197688
chr20:22476762-22478987	chr20	22476762	22478987	2225	22477618
chr20:22734670-22740785	chr20	22734670	22740785	6115	22738209
chr20:22851812-22857781	chr20	22851812	22857781	5969	22854961
chr20:23426108-23432140	chr20	23426108	23432140	6032	23429548
chr20:23589308-23595311	chr20	23589308	23595311	6003	23592735
chr20:24900605-24906618	chr20	24900605	24906618	6013	24904032
chr20:24921723-24927909	chr20	24921723	24927909	6186	24925316
chr20:24944088-24948908	chr20	24944088	24948908	4820	24946349
chr20:25105252-25111037	chr20	25105252	25111037	5785	25108819
chr20:25165636-25170195	chr20	25165636	25170195	4559	25169509
chr20:25260505-25265239	chr20	25260505	25265239	4734	25263855
chr20:25329949-25335970	chr20	25329949	25335970	6021	25333381
chr20:26116905-26118345	chr20	26116905	26118345	1440	26117921
chr20:26233677-26239735	chr20	26233677	26239735	6058	26237117
chr20:26303217-26304782	chr20	26303217	26304782	1565	26304346
chr20:28626003-28626726	chr20	28626003	28626726	723	28626646
chr20:28736655-28742476	chr20	28736655	28742476	5821	28739903
chr20:28827984-28829608	chr20	28827984	28829608	1624	28829289
chr20:28914441-28915491	chr20	28914441	28915491	1050	28915071
chr20:29021939-29026810	chr20	29021939	29026810	4871	29024242
chr20:29108505-29111699	chr20	29108505	29111699	3194	29109117
chr20:29233893-29238491	chr20	29233893	29238491	4598	29235899
chr20:29330490-29336615	chr20	29330490	29336615	6125	29334025
chr20:29525906-29531926	chr20	29525906	29531926	6020	29529335
chr20:29723090-29727329	chr20	29723090	29727329	4239	29724747
chr20:29767705-29773860	chr20	29767705	29773860	6155	29771270
chr20:29816735-29821369	chr20	29816735	29821369	4634	29820282
chr20:30407587-30410772	chr20	30407587	30410772	3185	30408198
chr20:30731925-30735561	chr20	30731925	30735561	3636	30734675
chr20:30985455-30991464	chr20	30985455	30991464	6009	30988887
chr20:31332715-31338862	chr20	31332715	31338862	6147	31336273
chr20:39368228-39373484	chr20	39368228	39373484	5256	39370902
chr20:39802657-39806397	chr20	39802657	39806397	3740	39803803
chr20:39919701-39922810	chr20	39919701	39922810	3109	39920175
chr20:40553339-40556599	chr20	40553339	40556599	3260	40556293
chr20:40619322-40625356	chr20	40619322	40625356	6034	40622770
chr20:42206269-42212317	chr20	42206269	42212317	6048	42209721
chr20:43368451-43371740	chr20	43368451	43371740	3289	43369150
chr20:43814461-43820491	chr20	43814461	43820491	6030	43817900
chr20:45651481-45657593	chr20	45651481	45657593	6112	45655006
chr20:48587113-48591591	chr20	48587113	48591591	4478	48589009
chr20:53472644-53478653	chr20	53472644	53478653	6009	53476083
chr20:53503851-53509874	chr20	53503851	53509874	6023	53507288
chr20:54240042-54244144	chr20	54240042	54244144	4102	54241587
chr20:54782510-54788349	chr20	54782510	54788349	5839	54785943
chr20:55244667-55248435	chr20	55244667	55248435	3768	55246527
chr20:55305585-55311343	chr20	55305585	55311343	5758	55308777
chr20:55848497-55851151	chr20	55848497	55851151	2654	55848616
chr20:55859566-55865521	chr20	55859566	55865521	5955	55863004
chr20:56049567-56056026	chr20	56049567	56056026	6459	56053456
chr20:56338903-56341973	chr20	56338903	56341973	3070	56340333
chr20_GL383577v2_alt:109153-115202	chr20_GL383577v2_alt	109153	115202	6049	112591
chr21:5348617-5354771	chr21	5348617	5354771	6154	5352183
chr21:5625888-5627596	chr21	5625888	5627596	1708	5626313
chr21:5688961-5691954	chr21	5688961	5691954	2993	5689386
chr21:6245753-6248786	chr21	6245753	6248786	3033	6246333
chr21:6645388-6648433	chr21	6645388	6648433	3045	6645972
chr21:6860850-6865131	chr21	6860850	6865131	4281	6864360
chr21:7121114-7124107	chr21	7121114	7124107	2993	7121539
chr21:7280237-7286391	chr21	7280237	7286391	6154	7283803
chr21:7555069-7557929	chr21	7555069	7557929	2860	7555338
chr21:7686184-7689217	chr21	7686184	7689217	3033	7686764
chr21:8607716-8611272	chr21	8607716	8611272	3556	8608702
chr21:9265937-9272066	chr21	9265937	9272066	6129	9269478
chr21:9311603-9316759	chr21	9311603	9316759	5156	9314225
chr21:10631089-10637220	chr21	10631089	10637220	6131	10634640
chr21:10739647-10745670	chr21	10739647	10745670	6023	10743082
chr21:10769752-10775788	chr21	10769752	10775788	6036	10773191
chr21:13072076-13074714	chr21	13072076	13074714	2638	13072133
chr21:13131778-13137920	chr21	13131778	13137920	6142	13135337
chr21:13414808-13417909	chr21	13414808	13417909	3101	13415318
chr21:13577049-13579202	chr21	13577049	13579202	2153	13577677
chr21:13725901-13730182	chr21	13725901	13730182	4281	13729411
chr21:14166719-14172876	chr21	14166719	14172876	6157	14170288
chr21:14326861-14332307	chr21	14326861	14332307	5446	14330741
chr21:14778901-14785063	chr21	14778901	14785063	6162	14782486
chr21:14800651-14806257	chr21	14800651	14806257	5606	14803651
chr21:14927082-14933113	chr21	14927082	14933113	6031	14930522
chr21:15554205-15556888	chr21	15554205	15556888	2683	15554301
chr21:16224329-16230705	chr21	16224329	16230705	6376	16228183
chr21:16756873-16760251	chr21	16756873	16760251	3378	16757663
chr21:16879388-16884946	chr21	16879388	16884946	5558	16882390
chr21:17034152-17040255	chr21	17034152	17040255	6103	17037670
chr21:17090513-17096530	chr21	17090513	17096530	6017	17093945
chr21:17163639-17169032	chr21	17163639	17169032	5393	17166453
chr21:17271306-17277560	chr21	17271306	17277560	6254	17274978
chr21:17311822-17315042	chr21	17311822	17315042	3220	17312479
chr21:17327482-17333500	chr21	17327482	17333500	6018	17330924
chr21:17373448-17376030	chr21	17373448	17376030	2582	17375617
chr21:17376038-17381930	chr21	17376038	17381930	5892	17379476
chr21:17971630-17973387	chr21	17971630	17973387	1757	17971727
chr21:18464197-18467400	chr21	18464197	18467400	3203	18464834
chr21:19149495-19153216	chr21	19149495	19153216	3721	19150647
chr21:19294358-19295855	chr21	19294358	19295855	1497	19295740
chr21:19812587-19816709	chr21	19812587	19816709	4122	19814133
chr21:19961157-19961725	chr21	19961157	19961725	568	19961628
chr21:20435517-20439374	chr21	20435517	20439374	3857	20436811
chr21:20921779-20926204	chr21	20921779	20926204	4425	20925643
chr21:22493175-22499632	chr21	22493175	22499632	6457	22497054
chr21:22919614-22923853	chr21	22919614	22923853	4239	22921273
chr21:24554593-24560956	chr21	24554593	24560956	6363	24558390
chr21:25433895-25439626	chr21	25433895	25439626	5731	25437047
chr21:25918367-25924392	chr21	25918367	25924392	6025	25921799
chr21:27661157-27663617	chr21	27661157	27663617	2460	27661849
chr21:28558004-28561134	chr21	28558004	28561134	3130	28558541
chr21:30198455-30199708	chr21	30198455	30199708	1253	30198523
chr21:30727431-30730806	chr21	30727431	30730806	3375	30728240
chr21:32040727-32042354	chr21	32040727	32042354	1627	32041880
chr21:35787108-35788662	chr21	35787108	35788662	1554	35787892
chr21:36616544-36622673	chr21	36616544	36622673	6129	36620088
chr21:37109076-37115174	chr21	37109076	37115174	6098	37112615
chr21:40033161-40039180	chr21	40033161	40039180	6019	40036590
chr21:40109437-40115573	chr21	40109437	40115573	6136	40112990
chr21:40761819-40765115	chr21	40761819	40765115	3296	40762536
chr21:44560026-44563667	chr21	44560026	44563667	3641	44561406
chr21_KI270874v1_alt:16747-22140	chr21_KI270874v1_alt	16747	22140	5393	19561
chr21_KI270874v1_alt:127616-133861	chr21_KI270874v1_alt	127616	133861	6245	131288
chr22:10584715-10588271	chr22	10584715	10588271	3556	10585701
chr22:11134389-11136627	chr22	11134389	11136627	2238	11136315
chr22:11152821-11155845	chr22	11152821	11155845	3024	11153341
chr22:11288307-11294417	chr22	11288307	11294417	6110	11291827
chr22:11341432-11346064	chr22	11341432	11346064	4632	11344977
chr22:11800955-11806116	chr22	11800955	11806116	5161	11803578
chr22:11959381-11965528	chr22	11959381	11965528	6147	11962944
chr22:12042157-12044901	chr22	12042157	12044901	2744	12042312
chr22:12388849-12394988	chr22	12388849	12394988	6139	12392409
chr22:12497108-12499861	chr22	12497108	12499861	2753	12498073
chr22:12543079-12546030	chr22	12543079	12546030	2951	12543440
chr22:12546318-12550508	chr22	12546318	12550508	4190	12547904
chr22:12632374-12635557	chr22	12632374	12635557	3183	12632983
chr22:12699016-12703731	chr22	12699016	12703731	4715	12701156
chr22:12801330-12807455	chr22	12801330	12807455	6125	12804890
chr22:12873434-12879563	chr22	12873434	12879563	6129	12876975
chr22:15280559-15284543	chr22	15280559	15284543	3984	15281960
chr22:15302345-15304982	chr22	15302345	15304982	2637	15302400
chr22:15494338-15499694	chr22	15494338	15499694	5356	15497866
chr22:15618566-15621394	chr22	15618566	15621394	2828	15618806
chr22:16021017-16027044	chr22	16021017	16027044	6027	16024453
chr22:16166512-16169150	chr22	16166512	16169150	2638	16166569
chr22:16183718-16189738	chr22	16183718	16189738	6020	16187148
chr22:16235053-16241190	chr22	16235053	16241190	6137	16238611
chr22:16449338-16453360	chr22	16449338	16453360	4022	16450786
chr22:16496572-16498810	chr22	16496572	16498810	2238	16498498
chr22:16514632-16517656	chr22	16514632	16517656	3024	16515152
chr22:16660386-16665762	chr22	16660386	16665762	5376	16663924
chr22:16708485-16712750	chr22	16708485	16712750	4265	16710155
chr22:16767309-16772131	chr22	16767309	16772131	4822	16769533
chr22:16941609-16944248	chr22	16941609	16944248	2639	16941861
chr22:17024132-17030285	chr22	17024132	17030285	6153	17027699
chr22:17932084-17936587	chr22	17932084	17936587	4503	17934047
chr22:22187854-22193971	chr22	22187854	22193971	6117	22191387
chr22:22331689-22336920	chr22	22331689	22336920	5231	22334330
chr22:23662983-23669138	chr22	23662983	23669138	6155	23666544
chr22:24372099-24374785	chr22	24372099	24374785	2686	24372206
chr22:28035791-28039677	chr22	28035791	28039677	3886	28037091
chr22:28083531-28089677	chr22	28083531	28089677	6146	28087085
chr22:28163683-28169817	chr22	28163683	28169817	6134	28167247
chr22:28191323-28197439	chr22	28191323	28197439	6116	28194860
chr22:28209186-28215291	chr22	28209186	28215291	6105	28212703
chr22:28311878-28314615	chr22	28311878	28314615	2737	28313286
chr22:28528947-28535075	chr22	28528947	28535075	6128	28532481
chr22:28663283-28669315	chr22	28663283	28669315	6032	28666723
chr22:33172692-33177313	chr22	33172692	33177313	4621	33174906
chr22:34788709-34794838	chr22	34788709	34794838	6129	34792261
chr22:34816799-34822923	chr22	34816799	34822923	6124	34820352
chr22:35165680-35170019	chr22	35165680	35170019	4339	35169229
chr22:49742064-49744706	chr22	49742064	49744706	2642	49742099
chr22_KI270732v1_random:1733-7874	chr22_KI270732v1_random	1733	7874	6141	5291
chr22_KI270733v1_random:3419-6412	chr22_KI270733v1_random	3419	6412	2993	3844
chr22_KI270739v1_random:38402-42470	chr22_KI270739v1_random	38402	42470	4068	39916
chr2_GL383521v1_alt:20194-26249	chr2_GL383521v1_alt	20194	26249	6055	23636
chr2_GL383522v1_alt:36912-41022	chr2_GL383522v1_alt	36912	41022	4110	38422
chr2_GL383522v1_alt:51849-57994	chr2_GL383522v1_alt	51849	57994	6145	55409
chr2_KI270770v1_alt:75482-81507	chr2_KI270770v1_alt	75482	81507	6025	78919
chr2_KI270772v1_alt:46019-52106	chr2_KI270772v1_alt	46019	52106	6087	49558
chr2_KI270775v1_alt:133558-136978	chr2_KI270775v1_alt	133558	136978	3420	134393
chr3:761741-762812	chr3	761741	762812	1071	762013
chr3:809376-815406	chr3	809376	815406	6030	812813
chr3:1387560-1393571	chr3	1387560	1393571	6011	1390978
chr3:1477491-1483625	chr3	1477491	1483625	6134	1481038
chr3:1681677-1687794	chr3	1681677	1687794	6117	1685215
chr3:2255273-2256651	chr3	2255273	2256651	1378	2256365
chr3:3409456-3413493	chr3	3409456	3413493	4037	3410909
chr3:3480112-3482747	chr3	3480112	3482747	2635	3480157
chr3:3672795-3674542	chr3	3672795	3674542	1747	3673400
chr3:3719386-3725382	chr3	3719386	3725382	5996	3722812
chr3:3897140-3899108	chr3	3897140	3899108	1968	3898739
chr3:3909469-3914942	chr3	3909469	3914942	5473	3912357
chr3:3963076-3969110	chr3	3963076	3969110	6034	3966515
chr3:3996513-3997903	chr3	3996513	3997903	1390	3997543
chr3:4134003-4137634	chr3	4134003	4137634	3631	4135046
chr3:4174565-4180684	chr3	4174565	4180684	6119	4178115
chr3:4211801-4217510	chr3	4211801	4217510	5709	4214971
chr3:4253248-4259276	chr3	4253248	4259276	6028	4256690
chr3:4916534-4922591	chr3	4916534	4922591	6057	4919975
chr3:4965757-4971913	chr3	4965757	4971913	6156	4969326
chr3:5414662-5418907	chr3	5414662	5418907	4245	5416322
chr3:5512066-5513076	chr3	5512066	5513076	1010	5512401
chr3:5935700-5939837	chr3	5935700	5939837	4137	5937249
chr3:6340819-6346935	chr3	6340819	6346935	6116	6344371
chr3:7934187-7937896	chr3	7934187	7937896	3709	7937783
chr3:8062037-8064744	chr3	8062037	8064744	2707	8062153
chr3:8371834-8378046	chr3	8371834	8378046	6212	8375450
chr3:8611524-8617535	chr3	8611524	8617535	6011	8614935
chr3:8716076-8722097	chr3	8716076	8722097	6021	8719507
chr3:8921961-8928067	chr3	8921961	8928067	6106	8925485
chr3:9259855-9266384	chr3	9259855	9266384	6529	9263794
chr3:10538256-10540880	chr3	10538256	10540880	2624	10538300
chr3:10657509-10663246	chr3	10657509	10663246	5737	10660672
chr3:14070097-14076246	chr3	14070097	14076246	6149	14073652
chr3:15188651-15192702	chr3	15188651	15192702	4051	15190105
chr3:15192837-15195732	chr3	15192837	15195732	2895	15193172
chr3:16676612-16682750	chr3	16676612	16682750	6138	16680162
chr3:16778681-16781993	chr3	16778681	16781993	3312	16779410
chr3:17695218-17699552	chr3	17695218	17699552	4334	17696678
chr3:18516080-18520244	chr3	18516080	18520244	4164	18519521
chr3:18975949-18982086	chr3	18975949	18982086	6137	18979498
chr3:19350329-19355886	chr3	19350329	19355886	5557	19353307
chr3:19498993-19503936	chr3	19498993	19503936	4943	19501350
chr3:19581801-19585299	chr3	19581801	19585299	3498	19582718
chr3:19626059-19627263	chr3	19626059	19627263	1204	19627110
chr3:19778129-19780901	chr3	19778129	19780901	2772	19778311
chr3:19787986-19788976	chr3	19787986	19788976	990	19788754
chr3:19855048-19861075	chr3	19855048	19861075	6027	19858488
chr3:21124547-21129868	chr3	21124547	21129868	5321	21128449
chr3:21812230-21818339	chr3	21812230	21818339	6109	21815754
chr3:22053195-22056308	chr3	22053195	22056308	3113	22053695
chr3:22082078-22086635	chr3	22082078	22086635	4557	22085650
chr3:22137195-22139778	chr3	22137195	22139778	2583	22137245
chr3:22179701-22180833	chr3	22179701	22180833	1132	22180359
chr3:22446497-22447752	chr3	22446497	22447752	1255	22446986
chr3:22687546-22690181	chr3	22687546	22690181	2635	22687593
chr3:22707793-22713077	chr3	22707793	22713077	5284	22710469
chr3:22801378-22807403	chr3	22801378	22807403	6025	22804817
chr3:22827076-22832406	chr3	22827076	22832406	5330	22829904
chr3:23266649-23269368	chr3	23266649	23269368	2719	23267629
chr3:23349243-23355385	chr3	23349243	23355385	6142	23352808
chr3:24203521-24209830	chr3	24203521	24209830	6309	24207069
chr3:24280189-24285593	chr3	24280189	24285593	5404	24283007
chr3:24566789-24572947	chr3	24566789	24572947	6158	24570314
chr3:25328558-25334693	chr3	25328558	25334693	6135	25332099
chr3:26494216-26497830	chr3	26494216	26497830	3614	26495242
chr3:26783096-26789130	chr3	26783096	26789130	6034	26786537
chr3:26875517-26881396	chr3	26875517	26881396	5879	26879431
chr3:26881365-26886762	chr3	26881365	26886762	5397	26884924
chr3:26944101-26949001	chr3	26944101	26949001	4900	26946427
chr3:26991547-26995650	chr3	26991547	26995650	4103	26993050
chr3:28059242-28064514	chr3	28059242	28064514	5272	28062675
chr3:28182518-28183932	chr3	28182518	28183932	1414	28183269
chr3:28354166-28357018	chr3	28354166	28357018	2852	28354427
chr3:28417068-28420085	chr3	28417068	28420085	3017	28417439
chr3:28620773-28623247	chr3	28620773	28623247	2474	28622157
chr3:28960044-28962877	chr3	28960044	28962877	2833	28960291
chr3:29670285-29676431	chr3	29670285	29676431	6146	29673827
chr3:29993917-29999918	chr3	29993917	29999918	6001	29997342
chr3:30050741-30056276	chr3	30050741	30056276	5535	30053684
chr3:30412411-30414283	chr3	30412411	30414283	1872	30412678
chr3:30428649-30433628	chr3	30428649	30433628	4979	30431038
chr3:32010453-32016606	chr3	32010453	32016606	6153	32014019
chr3:32263087-32268603	chr3	32263087	32268603	5516	32266028
chr3:33671454-33677714	chr3	33671454	33677714	6260	33675011
chr3:34094086-34100217	chr3	34094086	34100217	6131	34097636
chr3:34654022-34656689	chr3	34654022	34656689	2667	34655272
chr3:34733664-34737951	chr3	34733664	34737951	4287	34735434
chr3:34763710-34769236	chr3	34763710	34769236	5526	34766645
chr3:34904159-34910234	chr3	34904159	34910234	6075	34907681
chr3:35103912-35109933	chr3	35103912	35109933	6021	35107351
chr3:35225817-35231938	chr3	35225817	35231938	6121	35229372
chr3:35456550-35458296	chr3	35456550	35458296	1746	35458002
chr3:35610446-35614582	chr3	35610446	35614582	4136	35611991
chr3:36082744-36088885	chr3	36082744	36088885	6141	36086296
chr3:36320973-36327093	chr3	36320973	36327093	6120	36324523
chr3:37840629-37844355	chr3	37840629	37844355	3726	37841805
chr3:38405400-38411538	chr3	38405400	38411538	6138	38408960
chr3:38932236-38938393	chr3	38932236	38938393	6157	38935794
chr3:39304219-39309843	chr3	39304219	39309843	5624	39308127
chr3:39361499-39365600	chr3	39361499	39365600	4101	39365398
chr3:39953562-39959686	chr3	39953562	39959686	6124	39957103
chr3:39973046-39977052	chr3	39973046	39977052	4006	39974475
chr3:39994053-40000178	chr3	39994053	40000178	6125	39997608
chr3:40032551-40035230	chr3	40032551	40035230	2679	40032645
chr3:40133895-40137692	chr3	40133895	40137692	3797	40137458
chr3:40271390-40277506	chr3	40271390	40277506	6116	40274919
chr3:41279782-41283806	chr3	41279782	41283806	4024	41281226
chr3:41370356-41376413	chr3	41370356	41376413	6057	41374211
chr3:41423577-41429916	chr3	41423577	41429916	6339	41427337
chr3:41492403-41495901	chr3	41492403	41495901	3498	41494003
chr3:41616351-41622775	chr3	41616351	41622775	6424	41620187
chr3:41772040-41775225	chr3	41772040	41775225	3185	41772644
chr3:41824182-41830304	chr3	41824182	41830304	6122	41827723
chr3:42239085-42244648	chr3	42239085	42244648	5563	42242060
chr3:43064774-43070790	chr3	43064774	43070790	6016	43068206
chr3:43565822-43571847	chr3	43565822	43571847	6025	43569260
chr3:43591620-43597774	chr3	43591620	43597774	6154	43595187
chr3:43660973-43665534	chr3	43660973	43665534	4561	43662966
chr3:43678954-43685094	chr3	43678954	43685094	6140	43682504
chr3:46148347-46152980	chr3	46148347	46152980	4633	46150199
chr3:46273084-46276066	chr3	46273084	46276066	2982	46273486
chr3:46790519-46796072	chr3	46790519	46796072	5553	46793496
chr3:51199048-51205178	chr3	51199048	51205178	6130	51202592
chr3:51264859-51267373	chr3	51264859	51267373	2514	51265275
chr3:51455920-51462098	chr3	51455920	51462098	6178	51459481
chr3:51647858-51653935	chr3	51647858	51653935	6077	51651360
chr3:54284955-54291072	chr3	54284955	54291072	6117	54288496
chr3:54468128-54474552	chr3	54468128	54474552	6424	54471971
chr3:54723840-54727918	chr3	54723840	54727918	4078	54725337
chr3:54802615-54808221	chr3	54802615	54808221	5606	54805626
chr3:55136329-55142351	chr3	55136329	55142351	6022	55139761
chr3:55209131-55215269	chr3	55209131	55215269	6138	55212682
chr3:55388739-55394829	chr3	55388739	55394829	6090	55392254
chr3:55831626-55837762	chr3	55831626	55837762	6136	55835176
chr3:56213069-56219149	chr3	56213069	56219149	6080	56216567
chr3:56945132-56951290	chr3	56945132	56951290	6158	56948703
chr3:57324583-57330726	chr3	57324583	57330726	6143	57328135
chr3:57476938-57483084	chr3	57476938	57483084	6146	57480495
chr3:57606881-57612402	chr3	57606881	57612402	5521	57609808
chr3:58806577-58812715	chr3	58806577	58812715	6138	58810127
chr3:58816278-58821556	chr3	58816278	58821556	5278	58819716
chr3:58842154-58848179	chr3	58842154	58848179	6025	58845587
chr3:58852277-58856002	chr3	58852277	58856002	3725	58853408
chr3:58930787-58936933	chr3	58930787	58936933	6146	58934346
chr3:58980264-58982870	chr3	58980264	58982870	2606	58980279
chr3:59031895-59038291	chr3	59031895	59038291	6396	59035770
chr3:59395156-59400281	chr3	59395156	59400281	5125	59398709
chr3:59493059-59494195	chr3	59493059	59494195	1136	59493214
chr3:59613855-59619953	chr3	59613855	59619953	6098	59617380
chr3:60481111-60485781	chr3	60481111	60485781	4670	60483253
chr3:60710285-60715325	chr3	60710285	60715325	5040	60713857
chr3:60928577-60931373	chr3	60928577	60931373	2796	60928789
chr3:61021624-61024015	chr3	61021624	61024015	2391	61022418
chr3:61042988-61049130	chr3	61042988	61049130	6142	61046565
chr3:61187325-61191091	chr3	61187325	61191091	3766	61188506
chr3:61211021-61217154	chr3	61211021	61217154	6133	61214581
chr3:61365015-61367591	chr3	61365015	61367591	2576	61365861
chr3:61395099-61399415	chr3	61395099	61399415	4316	61396831
chr3:63136268-63142301	chr3	63136268	63142301	6033	63139709
chr3:63153078-63155842	chr3	63153078	63155842	2764	63153250
chr3:63255612-63260977	chr3	63255612	63260977	5365	63259146
chr3:63645170-63651336	chr3	63645170	63651336	6166	63648744
chr3:63695497-63700382	chr3	63695497	63700382	4885	63697813
chr3:63733312-63739364	chr3	63733312	63739364	6052	63736749
chr3:64475793-64481959	chr3	64475793	64481959	6166	64479371
chr3:64978922-64982753	chr3	64978922	64982753	3831	64980158
chr3:65054359-65059879	chr3	65054359	65059879	5520	65057291
chr3:65119888-65126215	chr3	65119888	65126215	6327	65123625
chr3:65509292-65515316	chr3	65509292	65515316	6024	65512730
chr3:65696871-65699890	chr3	65696871	65699890	3019	65697298
chr3:66842801-66848943	chr3	66842801	66848943	6142	66846358
chr3:66892730-66897722	chr3	66892730	66897722	4992	66896559
chr3:66916843-66919927	chr3	66916843	66919927	3084	66917322
chr3:67147643-67153797	chr3	67147643	67153797	6154	67151211
chr3:67153986-67160430	chr3	67153986	67160430	6444	67157845
chr3:67279471-67282409	chr3	67279471	67282409	2938	67279829
chr3:67393029-67399181	chr3	67393029	67399181	6152	67396596
chr3:67427514-67431440	chr3	67427514	67431440	3926	67431026
chr3:67438040-67441379	chr3	67438040	67441379	3339	67438811
chr3:67947816-67953946	chr3	67947816	67953946	6130	67951365
chr3:68810218-68816325	chr3	68810218	68816325	6107	68813740
chr3:69344860-69350993	chr3	69344860	69350993	6133	69348408
chr3:70660176-70662827	chr3	70660176	70662827	2651	70660253
chr3:70688940-70689285	chr3	70688940	70689285	345	70689093
chr3:71665586-71666655	chr3	71665586	71666655	1069	71666518
chr3:74688037-74690946	chr3	74688037	74690946	2909	74688357
chr3:76214334-76220340	chr3	76214334	76220340	6006	76217736
chr3:76394662-76398488	chr3	76394662	76398488	3826	76395896
chr3:76749824-76752447	chr3	76749824	76752447	2623	76749871
chr3:77756444-77762685	chr3	77756444	77762685	6241	77760111
chr3:78487036-78493167	chr3	78487036	78493167	6131	78490575
chr3:78675184-78681346	chr3	78675184	78681346	6162	78678749
chr3:79623165-79626165	chr3	79623165	79626165	3000	79625782
chr3:79685745-79688378	chr3	79685745	79688378	2633	79685795
chr3:80596049-80599727	chr3	80596049	80599727	3678	80597150
chr3:80709137-80713680	chr3	80709137	80713680	4543	80713003
chr3:81878123-81884278	chr3	81878123	81884278	6155	81881687
chr3:82399772-82403496	chr3	82399772	82403496	3724	82400879
chr3:82843246-82846815	chr3	82843246	82846815	3569	82844227
chr3:83639711-83641735	chr3	83639711	83641735	2024	83640434
chr3:83702489-83703130	chr3	83702489	83703130	641	83702795
chr3:84009636-84013755	chr3	84009636	84013755	4119	84011174
chr3:84086862-84091281	chr3	84086862	84091281	4419	84090168
chr3:84760708-84767154	chr3	84760708	84767154	6446	84764592
chr3:84884977-84891143	chr3	84884977	84891143	6166	84888557
chr3:85153071-85158885	chr3	85153071	85158885	5814	85156549
chr3:85289930-85295940	chr3	85289930	85295940	6010	85293362
chr3:85943813-85947235	chr3	85943813	85947235	3422	85945352
chr3:86019895-86020992	chr3	86019895	86020992	1097	86020411
chr3:86039081-86045220	chr3	86039081	86045220	6139	86042653
chr3:86092963-86099092	chr3	86092963	86099092	6129	86096517
chr3:86297030-86303174	chr3	86297030	86303174	6144	86300592
chr3:86583531-86585426	chr3	86583531	86585426	1895	86584552
chr3:87017114-87023232	chr3	87017114	87023232	6118	87020642
chr3:87402877-87407308	chr3	87402877	87407308	4431	87404734
chr3:87882878-87888478	chr3	87882878	87888478	5600	87885914
chr3:87932615-87933806	chr3	87932615	87933806	1191	87932777
chr3:88097376-88100968	chr3	88097376	88100968	3592	88098405
chr3:88181952-88188095	chr3	88181952	88188095	6143	88185517
chr3:88557632-88560226	chr3	88557632	88560226	2594	88559735
chr3:88746909-88753147	chr3	88746909	88753147	6238	88750473
chr3:88869833-88875863	chr3	88869833	88875863	6030	88873271
chr3:88891404-88894215	chr3	88891404	88894215	2811	88891652
chr3:89070582-89071335	chr3	89070582	89071335	753	89070763
chr3:89073986-89078067	chr3	89073986	89078067	4081	89075511
chr3:89747613-89753632	chr3	89747613	89753632	6019	89751050
chr3:89755774-89756059	chr3	89755774	89756059	285	89755992
chr3:89831715-89837875	chr3	89831715	89837875	6160	89835283
chr3:89885556-89888508	chr3	89885556	89888508	2952	89885923
chr3:89957833-89963855	chr3	89957833	89963855	6022	89961262
chr3:89995974-90002110	chr3	89995974	90002110	6136	89999532
chr3:90334081-90340103	chr3	90334081	90340103	6022	90337511
chr3:90372520-90376973	chr3	90372520	90376973	4453	90374385
chr3:90419722-90421535	chr3	90419722	90421535	1813	90420472
chr3:90624582-90626883	chr3	90624582	90626883	2301	90625751
chr3:91291218-91297271	chr3	91291218	91297271	6053	91294692
chr3:93749362-93750946	chr3	93749362	93750946	1584	93749877
chr3:93766941-93772994	chr3	93766941	93772994	6053	93770377
chr3:93832881-93838408	chr3	93832881	93838408	5527	93835817
chr3:94551665-94553847	chr3	94551665	94553847	2182	94552014
chr3:94630628-94636779	chr3	94630628	94636779	6151	94634207
chr3:94745469-94751496	chr3	94745469	94751496	6027	94748905
chr3:94838259-94842079	chr3	94838259	94842079	3820	94839491
chr3:94846027-94852063	chr3	94846027	94852063	6036	94849446
chr3:95645053-95651229	chr3	95645053	95651229	6176	95648638
chr3:95776853-95780760	chr3	95776853	95780760	3907	95778202
chr3:95804176-95805987	chr3	95804176	95805987	1811	95805055
chr3:95860387-95866536	chr3	95860387	95866536	6149	95863948
chr3:95874384-95877255	chr3	95874384	95877255	2871	95875153
chr3:95988831-95991840	chr3	95988831	95991840	3009	95989249
chr3:96378127-96379139	chr3	96378127	96379139	1012	96378653
chr3:96529063-96533173	chr3	96529063	96533173	4110	96530577
chr3:97330578-97332552	chr3	97330578	97332552	1974	97331831
chr3:97641427-97645082	chr3	97641427	97645082	3655	97644862
chr3:98174083-98180245	chr3	98174083	98180245	6162	98177657
chr3:98406586-98412727	chr3	98406586	98412727	6141	98410149
chr3:98681987-98688011	chr3	98681987	98688011	6024	98685430
chr3:98858830-98864866	chr3	98858830	98864866	6036	98862293
chr3:99034788-99040932	chr3	99034788	99040932	6144	99038348
chr3:99301785-99306654	chr3	99301785	99306654	4869	99304083
chr3:99450736-99456202	chr3	99450736	99456202	5466	99453599
chr3:99589036-99594989	chr3	99589036	99594989	5953	99592437
chr3:100509607-100515641	chr3	100509607	100515641	6034	100513049
chr3:100619155-100620604	chr3	100619155	100620604	1449	100619982
chr3:101108330-101114476	chr3	101108330	101114476	6146	101111891
chr3:101448642-101453885	chr3	101448642	101453885	5243	101451290
chr3:101735395-101739625	chr3	101735395	101739625	4230	101739244
chr3:102008204-102014355	chr3	102008204	102014355	6151	102011756
chr3:102039923-102046053	chr3	102039923	102046053	6130	102043485
chr3:102823113-102826187	chr3	102823113	102826187	3074	102823612
chr3:103220448-103226476	chr3	103220448	103226476	6028	103223883
chr3:103234262-103237339	chr3	103234262	103237339	3077	103234747
chr3:104121308-104122084	chr3	104121308	104122084	776	104121346
chr3:105296223-105302219	chr3	105296223	105302219	5996	105299659
chr3:105309055-105310189	chr3	105309055	105310189	1134	105309849
chr3:105589635-105592187	chr3	105589635	105592187	2552	105591863
chr3:105994496-105996220	chr3	105994496	105996220	1724	105994529
chr3:106665293-106671324	chr3	106665293	106671324	6031	106668735
chr3:106855037-106859237	chr3	106855037	106859237	4200	106856646
chr3:106950127-106952741	chr3	106950127	106952741	2614	106950157
chr3:106975444-106981476	chr3	106975444	106981476	6032	106978885
chr3:107039637-107041847	chr3	107039637	107041847	2210	107040012
chr3:107144092-107150246	chr3	107144092	107150246	6154	107147657
chr3:107158126-107162441	chr3	107158126	107162441	4315	107159841
chr3:107333744-107339866	chr3	107333744	107339866	6122	107337277
chr3:107470052-107476506	chr3	107470052	107476506	6454	107473942
chr3:108257680-108263696	chr3	108257680	108263696	6016	108261114
chr3:108349067-108349649	chr3	108349067	108349649	582	108349568
chr3:108371447-108375491	chr3	108371447	108375491	4044	108372902
chr3:108655511-108661648	chr3	108655511	108661648	6137	108659066
chr3:108749400-108755425	chr3	108749400	108755425	6025	108752833
chr3:109199872-109205903	chr3	109199872	109205903	6031	109203311
chr3:109236261-109238257	chr3	109236261	109238257	1996	109237923
chr3:109524153-109527502	chr3	109524153	109527502	3349	109524911
chr3:109647588-109653403	chr3	109647588	109653403	5815	109651477
chr3:109664743-109670946	chr3	109664743	109670946	6203	109668321
chr3:109759895-109765286	chr3	109759895	109765286	5391	109762718
chr3:109795205-109800906	chr3	109795205	109800906	5701	109798334
chr3:110009316-110013823	chr3	110009316	110013823	4507	110011237
chr3:110203969-110205025	chr3	110203969	110205025	1056	110204757
chr3:110440086-110446113	chr3	110440086	110446113	6027	110443524
chr3:110671439-110677515	chr3	110671439	110677515	6076	110675150
chr3:110998305-111004748	chr3	110998305	111004748	6443	111002171
chr3:111018716-111024745	chr3	111018716	111024745	6029	111022156
chr3:111380691-111385381	chr3	111380691	111385381	4690	111382796
chr3:112211221-112217359	chr3	112211221	112217359	6138	112214783
chr3:112724116-112730267	chr3	112724116	112730267	6151	112727684
chr3:112911600-112915811	chr3	112911600	112915811	4211	112913223
chr3:113366591-113372740	chr3	113366591	113372740	6149	113370154
chr3:113471798-113477946	chr3	113471798	113477946	6148	113475358
chr3:114276891-114282906	chr3	114276891	114282906	6015	114280321
chr3:115747662-115750528	chr3	115747662	115750528	2866	115747956
chr3:115753795-115757014	chr3	115753795	115757014	3219	115754467
chr3:116359999-116366026	chr3	116359999	116366026	6027	116363435
chr3:116455196-116461295	chr3	116455196	116461295	6099	116458751
chr3:116744833-116748998	chr3	116744833	116748998	4165	116746415
chr3:117207145-117211104	chr3	117207145	117211104	3959	117208516
chr3:117777980-117784141	chr3	117777980	117784141	6161	117781551
chr3:118458194-118462868	chr3	118458194	118462868	4674	118460277
chr3:118516737-118522906	chr3	118516737	118522906	6169	118520327
chr3:118914243-118920271	chr3	118914243	118920271	6028	118917681
chr3:119045132-119051153	chr3	119045132	119051153	6021	119048571
chr3:119055352-119059134	chr3	119055352	119059134	3782	119056546
chr3:119164449-119170639	chr3	119164449	119170639	6190	119168052
chr3:119843597-119847303	chr3	119843597	119847303	3706	119844735
chr3:120003776-120009853	chr3	120003776	120009853	6077	120007334
chr3:120573021-120579186	chr3	120573021	120579186	6165	120576584
chr3:120580772-120584654	chr3	120580772	120584654	3882	120582063
chr3:120722643-120725954	chr3	120722643	120725954	3311	120723372
chr3:120957644-120960919	chr3	120957644	120960919	3275	120958332
chr3:121050371-121054749	chr3	121050371	121054749	4378	121052155
chr3:121264471-121268564	chr3	121264471	121268564	4093	121266052
chr3:121452690-121458395	chr3	121452690	121458395	5705	121455808
chr3:121810984-121817438	chr3	121810984	121817438	6454	121814834
chr3:122209249-122209357	chr3	122209249	122209357	108	122209302
chr3:122445379-122447869	chr3	122445379	122447869	2490	122447094
chr3:122655040-122657786	chr3	122655040	122657786	2746	122655247
chr3:122732871-122739022	chr3	122732871	122739022	6151	122736444
chr3:125849810-125855962	chr3	125849810	125855962	6152	125853383
chr3:125936638-125942696	chr3	125936638	125942696	6058	125940078
chr3:126331604-126337586	chr3	126331604	126337586	5982	126334997
chr3:126382388-126385065	chr3	126382388	126385065	2677	126382474
chr3:127514564-127517713	chr3	127514564	127517713	3149	127515126
chr3:130628808-130634065	chr3	130628808	130634065	5257	130631473
chr3:130806738-130810813	chr3	130806738	130810813	4075	130808225
chr3:131331467-131337625	chr3	131331467	131337625	6158	131335043
chr3:131407997-131410988	chr3	131407997	131410988	2991	131408398
chr3:132099871-132104821	chr3	132099871	132104821	4950	132102238
chr3:132122335-132123690	chr3	132122335	132123690	1355	132122636
chr3:132136909-132141753	chr3	132136909	132141753	4844	132140305
chr3:132608246-132610215	chr3	132608246	132610215	1969	132609705
chr3:132610207-132613387	chr3	132610207	132613387	3180	132610797
chr3:132797777-132799563	chr3	132797777	132799563	1786	132799043
chr3:133173706-133179818	chr3	133173706	133179818	6112	133177239
chr3:133551337-133557486	chr3	133551337	133557486	6149	133554894
chr3:133681221-133687356	chr3	133681221	133687356	6135	133684778
chr3:133735367-133740379	chr3	133735367	133740379	5012	133737887
chr3:135435779-135438403	chr3	135435779	135438403	2624	135436045
chr3:135584725-135590755	chr3	135584725	135590755	6030	135588160
chr3:135604242-135610155	chr3	135604242	135610155	5913	135607567
chr3:135658603-135664636	chr3	135658603	135664636	6033	135662026
chr3:135822591-135828133	chr3	135822591	135828133	5542	135825542
chr3:136113968-136120299	chr3	136113968	136120299	6331	136117800
chr3:136126020-136132173	chr3	136126020	136132173	6153	136129591
chr3:136224307-136230440	chr3	136224307	136230440	6133	136227874
chr3:136465951-136471133	chr3	136465951	136471133	5182	136468581
chr3:137140165-137143517	chr3	137140165	137143517	3352	137140928
chr3:137211031-137217172	chr3	137211031	137217172	6141	137214608
chr3:137412472-137418746	chr3	137412472	137418746	6274	137416155
chr3:137653910-137660442	chr3	137653910	137660442	6532	137657764
chr3:137660583-137666719	chr3	137660583	137666719	6136	137664139
chr3:137750702-137756538	chr3	137750702	137756538	5836	137754271
chr3:137885630-137887314	chr3	137885630	137887314	1684	137886364
chr3:137898713-137902264	chr3	137898713	137902264	3551	137900167
chr3:137979859-137985949	chr3	137979859	137985949	6090	137983402
chr3:138522300-138524423	chr3	138522300	138524423	2123	138522798
chr3:138562044-138566828	chr3	138562044	138566828	4784	138564271
chr3:139068339-139068642	chr3	139068339	139068642	303	139068380
chr3:139332939-139336780	chr3	139332939	139336780	3841	139334190
chr3:139404562-139410725	chr3	139404562	139410725	6163	139408157
chr3:139590956-139596035	chr3	139590956	139596035	5079	139594386
chr3:139799781-139802230	chr3	139799781	139802230	2449	139800223
chr3:139818729-139822575	chr3	139818729	139822575	3846	139819991
chr3:140622731-140626499	chr3	140622731	140626499	3768	140625693
chr3:140933090-140938657	chr3	140933090	140938657	5567	140936916
chr3:140987583-140993670	chr3	140987583	140993670	6087	140991089
chr3:141672291-141676330	chr3	141672291	141676330	4039	141673749
chr3:142290203-142296232	chr3	142290203	142296232	6029	142293640
chr3:143390474-143396603	chr3	143390474	143396603	6129	143394025
chr3:143620630-143626780	chr3	143620630	143626780	6150	143624189
chr3:143662333-143668488	chr3	143662333	143668488	6155	143665905
chr3:143932065-143934149	chr3	143932065	143934149	2084	143932750
chr3:144024120-144027461	chr3	144024120	144027461	3341	144024909
chr3:145823395-145824243	chr3	145823395	145824243	848	145823834
chr3:145917900-145924052	chr3	145917900	145924052	6152	145921462
chr3:145927778-145933791	chr3	145927778	145933791	6013	145931206
chr3:146726438-146731610	chr3	146726438	146731610	5172	146729050
chr3:147063500-147066981	chr3	147063500	147066981	3481	147064369
chr3:148303471-148307231	chr3	148303471	148307231	3760	148304648
chr3:148347272-148353408	chr3	148347272	148353408	6136	148350827
chr3:150711838-150716604	chr3	150711838	150716604	4766	150715736
chr3:151241772-151247772	chr3	151241772	151247772	6000	151245193
chr3:151483506-151489977	chr3	151483506	151489977	6471	151487405
chr3:151509490-151515631	chr3	151509490	151515631	6141	151513038
chr3:152421562-152425343	chr3	152421562	152425343	3781	152423507
chr3:152980701-152986404	chr3	152980701	152986404	5703	152983794
chr3:153506403-153512405	chr3	153506403	153512405	6002	153509839
chr3:153583994-153587712	chr3	153583994	153587712	3718	153587539
chr3:153654942-153657119	chr3	153654942	153657119	2177	153655438
chr3:153796804-153802956	chr3	153796804	153802956	6152	153800362
chr3:154262605-154268724	chr3	154262605	154268724	6119	154266142
chr3:154619379-154623868	chr3	154619379	154623868	4489	154622935
chr3:154647537-154650367	chr3	154647537	154650367	2830	154647753
chr3:154854491-154856758	chr3	154854491	154856758	2267	154855491
chr3:154875030-154881148	chr3	154875030	154881148	6118	154878527
chr3:154911095-154913991	chr3	154911095	154913991	2896	154912448
chr3:154945160-154951300	chr3	154945160	154951300	6140	154948718
chr3:154983594-154986878	chr3	154983594	154986878	3284	154984288
chr3:155469062-155475088	chr3	155469062	155475088	6026	155472502
chr3:155541893-155548049	chr3	155541893	155548049	6156	155545462
chr3:155620664-155626212	chr3	155620664	155626212	5548	155623824
chr3:156880310-156883164	chr3	156880310	156883164	2854	156880574
chr3:156966142-156972506	chr3	156966142	156972506	6364	156969696
chr3:157340046-157346169	chr3	157340046	157346169	6123	157343601
chr3:157685205-157691319	chr3	157685205	157691319	6114	157688762
chr3:157724697-157730723	chr3	157724697	157730723	6026	157728135
chr3:157879333-157885499	chr3	157879333	157885499	6166	157882914
chr3:157896819-157902843	chr3	157896819	157902843	6024	157900251
chr3:157992725-157995594	chr3	157992725	157995594	2869	157993026
chr3:158019676-158025704	chr3	158019676	158025704	6028	158023116
chr3:158034153-158039629	chr3	158034153	158039629	5476	158037703
chr3:158065621-158067899	chr3	158065621	158067899	2278	158067675
chr3:158634523-158640540	chr3	158634523	158640540	6017	158637951
chr3:159162582-159163527	chr3	159162582	159163527	945	159162997
chr3:159423066-159429208	chr3	159423066	159429208	6142	159426608
chr3:159491122-159497261	chr3	159491122	159497261	6139	159494678
chr3:159714265-159720397	chr3	159714265	159720397	6132	159717804
chr3:160323501-160325341	chr3	160323501	160325341	1840	160324203
chr3:160359463-160365012	chr3	160359463	160365012	5549	160362443
chr3:161046134-161049090	chr3	161046134	161049090	2956	161046513
chr3:161706794-161713195	chr3	161706794	161713195	6401	161710622
chr3:162476319-162479082	chr3	162476319	162479082	2763	162476525
chr3:162502327-162504843	chr3	162502327	162504843	2516	162503080
chr3:162867801-162872544	chr3	162867801	162872544	4743	162871384
chr3:162966314-162970025	chr3	162966314	162970025	3711	162967445
chr3:163236941-163242962	chr3	163236941	163242962	6021	163240375
chr3:163319691-163320719	chr3	163319691	163320719	1028	163320709
chr3:163429707-163435235	chr3	163429707	163435235	5528	163432648
chr3:163640981-163643667	chr3	163640981	163643667	2686	163641090
chr3:164036538-164039728	chr3	164036538	164039728	3190	164037139
chr3:164134347-164137058	chr3	164134347	164137058	2711	164134473
chr3:164257043-164260546	chr3	164257043	164260546	3503	164257989
chr3:164702605-164708638	chr3	164702605	164708638	6033	164706047
chr3:165572331-165578354	chr3	165572331	165578354	6023	165575764
chr3:165587135-165591182	chr3	165587135	165591182	4047	165588586
chr3:165933680-165936584	chr3	165933680	165936584	2904	165934000
chr3:165961012-165962816	chr3	165961012	165962816	1804	165962428
chr3:166228040-166232462	chr3	166228040	166232462	4422	166229875
chr3:166617451-166623581	chr3	166617451	166623581	6130	166620994
chr3:166717031-166719198	chr3	166717031	166719198	2167	166717493
chr3:167129352-167135528	chr3	167129352	167135528	6176	167132904
chr3:167275267-167281266	chr3	167275267	167281266	5999	167278674
chr3:167289314-167295687	chr3	167289314	167295687	6373	167293124
chr3:168011032-168017055	chr3	168011032	168017055	6023	168014464
chr3:168128296-168134440	chr3	168128296	168134440	6144	168131863
chr3:168757940-168759672	chr3	168757940	168759672	1732	168758605
chr3:169375162-169378334	chr3	169375162	169378334	3172	169375753
chr3:169418137-169420197	chr3	169418137	169420197	2060	169418323
chr3:169568735-169572987	chr3	169568735	169572987	4252	169570413
chr3:169679487-169685517	chr3	169679487	169685517	6030	169682926
chr3:169733600-169736494	chr3	169733600	169736494	2894	169733900
chr3:171625080-171632749	chr3	171625080	171632749	7669	171628435
chr3:173381849-173388281	chr3	173381849	173388281	6432	173385708
chr3:174401151-174403261	chr3	174401151	174403261	2110	174402367
chr3:174605174-174611325	chr3	174605174	174611325	6151	174608737
chr3:174744357-174747417	chr3	174744357	174747417	3060	174745512
chr3:175320700-175323501	chr3	175320700	175323501	2801	175320910
chr3:175996741-175999272	chr3	175996741	175999272	2531	175999061
chr3:176016123-176022184	chr3	176016123	176022184	6061	176019562
chr3:176675477-176680243	chr3	176675477	176680243	4766	176676396
chr3:176705531-176711710	chr3	176705531	176711710	6179	176709114
chr3:176827330-176833078	chr3	176827330	176833078	5748	176830477
chr3:176861314-176867423	chr3	176861314	176867423	6109	176864838
chr3:177908607-177914071	chr3	177908607	177914071	5464	177912033
chr3:178360815-178367289	chr3	178360815	178367289	6474	178364708
chr3:178859948-178865979	chr3	178859948	178865979	6031	178863387
chr3:179038594-179044362	chr3	179038594	179044362	5768	179042159
chr3:180367353-180373522	chr3	180367353	180373522	6169	180370936
chr3:180425994-180428746	chr3	180425994	180428746	2752	180427242
chr3:180448471-180452905	chr3	180448471	180452905	4434	180452035
chr3:181479048-181482909	chr3	181479048	181482909	3861	181481203
chr3:182426092-182432110	chr3	182426092	182432110	6018	182429526
chr3:183344456-183348578	chr3	183344456	183348578	4122	183345994
chr3:187412123-187418152	chr3	187412123	187418152	6029	187415562
chr3:187862480-187868516	chr3	187862480	187868516	6036	187865920
chr3:187890220-187896214	chr3	187890220	187896214	5994	187893640
chr3:188636935-188640513	chr3	188636935	188640513	3578	188637938
chr3:190998815-190999230	chr3	190998815	190999230	415	190999037
chr3:191834175-191840650	chr3	191834175	191840650	6475	191838080
chr3:192757765-192762044	chr3	192757765	192762044	4279	192761637
chr3:195087672-195093677	chr3	195087672	195093677	6005	195091101
chr3:195214893-195219309	chr3	195214893	195219309	4416	195216736
chr3:196383143-196385003	chr3	196383143	196385003	1860	196384374
chr3:196908841-196910335	chr3	196908841	196910335	1494	196909336
chr3:197409928-197416057	chr3	197409928	197416057	6129	197413472
chr3_GL000221v1_random:65216-71368	chr3_GL000221v1_random	65216	71368	6152	68777
chr3_JH636055v2_alt:91612-94247	chr3_JH636055v2_alt	91612	94247	2635	91644
chr3_JH636055v2_alt:120289-126432	chr3_JH636055v2_alt	120289	126432	6143	123848
chr3_KI270778v1_alt:57164-58542	chr3_KI270778v1_alt	57164	58542	1378	57776
chr3_KI270780v1_alt:190116-196268	chr3_KI270780v1_alt	190116	196268	6152	193689
chr4:2109996-2113397	chr4	2109996	2113397	3401	2110814
chr4:5593579-5599733	chr4	5593579	5599733	6154	5597140
chr4:9080578-9086679	chr4	9080578	9086679	6101	9084101
chr4:9619632-9624085	chr4	9619632	9624085	4453	9621475
chr4:11077817-11078457	chr4	11077817	11078457	640	11078326
chr4:11235217-11241254	chr4	11235217	11241254	6037	11238668
chr4:11557447-11563586	chr4	11557447	11563586	6139	11561012
chr4:11792760-11798001	chr4	11792760	11798001	5241	11796141
chr4:12089981-12096125	chr4	12089981	12096125	6144	12093541
chr4:12334559-12339855	chr4	12334559	12339855	5296	12338014
chr4:12343023-12347054	chr4	12343023	12347054	4031	12344463
chr4:12461348-12467472	chr4	12461348	12467472	6124	12464862
chr4:12748272-12754295	chr4	12748272	12754295	6023	12751702
chr4:12903431-12909456	chr4	12903431	12909456	6025	12906865
chr4:13416764-13422917	chr4	13416764	13422917	6153	13420331
chr4:13800308-13804564	chr4	13800308	13804564	4256	13801971
chr4:14480751-14486827	chr4	14480751	14486827	6076	14484184
chr4:14541053-14544564	chr4	14541053	14544564	3511	14542483
chr4:14718664-14724860	chr4	14718664	14724860	6196	14722286
chr4:14755114-14761144	chr4	14755114	14761144	6030	14758552
chr4:15174010-15180043	chr4	15174010	15180043	6033	15177445
chr4:15278666-15284652	chr4	15278666	15284652	5986	15282086
chr4:15841546-15847572	chr4	15841546	15847572	6026	15844986
chr4:16557085-16563227	chr4	16557085	16563227	6142	16560641
chr4:16628635-16632765	chr4	16628635	16632765	4130	16632010
chr4:16944926-16949113	chr4	16944926	16949113	4187	16946522
chr4:17731029-17735346	chr4	17731029	17735346	4317	17732760
chr4:18093423-18096796	chr4	18093423	18096796	3373	18094210
chr4:18266541-18269942	chr4	18266541	18269942	3401	18267360
chr4:18492530-18496554	chr4	18492530	18496554	4024	18493983
chr4:19059847-19063767	chr4	19059847	19063767	3920	19063703
chr4:19394672-19399067	chr4	19394672	19399067	4395	19396488
chr4:19950303-19951798	chr4	19950303	19951798	1495	19950547
chr4:20081540-20082933	chr4	20081540	20082933	1393	20081925
chr4:20738625-20744024	chr4	20738625	20744024	5399	20742144
chr4:21159390-21165421	chr4	21159390	21165421	6031	21162829
chr4:21237491-21240385	chr4	21237491	21240385	2894	21237803
chr4:21443906-21446772	chr4	21443906	21446772	2866	21444199
chr4:21996649-22002774	chr4	21996649	22002774	6125	22000195
chr4:22125268-22129300	chr4	22125268	22129300	4032	22126721
chr4:22146427-22152457	chr4	22146427	22152457	6030	22149865
chr4:22207852-22209055	chr4	22207852	22209055	1203	22207867
chr4:22260149-22262835	chr4	22260149	22262835	2686	22260265
chr4:22307151-22310631	chr4	22307151	22310631	3480	22308036
chr4:23614771-23620793	chr4	23614771	23620793	6022	23618212
chr4:24938412-24943824	chr4	24938412	24943824	5412	24941970
chr4:25134824-25138222	chr4	25134824	25138222	3398	25135637
chr4:26591493-26594428	chr4	26591493	26594428	2935	26591912
chr4:26640435-26645841	chr4	26640435	26645841	5406	26643998
chr4:26693921-26700024	chr4	26693921	26700024	6103	26697436
chr4:26922944-26927693	chr4	26922944	26927693	4749	26925102
chr4:27105548-27108207	chr4	27105548	27108207	2659	27105667
chr4:28409883-28413589	chr4	28409883	28413589	3706	28410842
chr4:29229302-29235777	chr4	29229302	29235777	6475	29233212
chr4:29563675-29565417	chr4	29563675	29565417	1742	29565308
chr4:29932189-29936005	chr4	29932189	29936005	3816	29933424
chr4:30424434-30425517	chr4	30424434	30425517	1083	30425277
chr4:30908513-30911317	chr4	30908513	30911317	2804	30908708
chr4:32409081-32415110	chr4	32409081	32415110	6029	32412917
chr4:33002035-33006232	chr4	33002035	33006232	4197	33003667
chr4:33371125-33374250	chr4	33371125	33374250	3125	33371684
chr4:33866320-33870352	chr4	33866320	33870352	4032	33867808
chr4:34652646-34655549	chr4	34652646	34655549	2903	34652960
chr4:35416763-35419486	chr4	35416763	35419486	2723	35416971
chr4:36377043-36382634	chr4	36377043	36382634	5591	36380053
chr4:36854818-36859581	chr4	36854818	36859581	4763	36857803
chr4:36935321-36941744	chr4	36935321	36941744	6423	36939188
chr4:36976544-36977691	chr4	36976544	36977691	1147	36977151
chr4:37273266-37277145	chr4	37273266	37277145	3879	37274505
chr4:37407737-37414133	chr4	37407737	37414133	6396	37411558
chr4:38476493-38482542	chr4	38476493	38482542	6049	38480028
chr4:38847298-38853392	chr4	38847298	38853392	6094	38850804
chr4:39246375-39252517	chr4	39246375	39252517	6142	39249919
chr4:39592670-39595567	chr4	39592670	39595567	2897	39592977
chr4:41349460-41355618	chr4	41349460	41355618	6158	41353031
chr4:41905564-41908445	chr4	41905564	41908445	2881	41905826
chr4:42041757-42048239	chr4	42041757	42048239	6482	42045646
chr4:43092867-43099023	chr4	43092867	43099023	6156	43096439
chr4:43287022-43289836	chr4	43287022	43289836	2814	43287246
chr4:43654350-43660491	chr4	43654350	43660491	6141	43657906
chr4:44049303-44052288	chr4	44049303	44052288	2985	44049696
chr4:44264460-44270554	chr4	44264460	44270554	6094	44267967
chr4:44593116-44599231	chr4	44593116	44599231	6115	44596642
chr4:44604042-44604335	chr4	44604042	44604335	293	44604110
chr4:44879460-44885597	chr4	44879460	44885597	6137	44883013
chr4:45573391-45576196	chr4	45573391	45576196	2805	45573605
chr4:45587464-45589925	chr4	45587464	45589925	2461	45588022
chr4:45651708-45657333	chr4	45651708	45657333	5625	45654745
chr4:45780629-45783713	chr4	45780629	45783713	3084	45781132
chr4:45804387-45808629	chr4	45804387	45808629	4242	45806039
chr4:46213660-46216295	chr4	46213660	46216295	2635	46213704
chr4:46404685-46410810	chr4	46404685	46410810	6125	46408223
chr4:46567128-46573270	chr4	46567128	46573270	6142	46570681
chr4:47294116-47300250	chr4	47294116	47300250	6134	47297682
chr4:47352211-47352650	chr4	47352211	47352650	439	47352340
chr4:48416644-48417873	chr4	48416644	48417873	1229	48417424
chr4:48445051-48445737	chr4	48445051	48445737	686	48445185
chr4:48711074-48717284	chr4	48711074	48717284	6210	48714696
chr4:48816996-48823574	chr4	48816996	48823574	6578	48820974
chr4:49067846-49071936	chr4	49067846	49071936	4090	49071408
chr4:49074547-49078496	chr4	49074547	49078496	3949	49075909
chr4:49620917-49626617	chr4	49620917	49626617	5700	49624483
chr4:52151203-52157611	chr4	52151203	52157611	6408	52155045
chr4:52446348-52452482	chr4	52446348	52452482	6134	52449879
chr4:52458976-52464098	chr4	52458976	52464098	5122	52462528
chr4:52538471-52544498	chr4	52538471	52544498	6027	52541909
chr4:52816456-52822486	chr4	52816456	52822486	6030	52819895
chr4:52970031-52976182	chr4	52970031	52976182	6151	52973593
chr4:53031026-53035737	chr4	53031026	53035737	4711	53033887
chr4:53104882-53110041	chr4	53104882	53110041	5159	53108791
chr4:53177526-53183662	chr4	53177526	53183662	6136	53181078
chr4:53247909-53253902	chr4	53247909	53253902	5993	53251307
chr4:53297965-53304112	chr4	53297965	53304112	6147	53301525
chr4:53328731-53334762	chr4	53328731	53334762	6031	53332171
chr4:53339989-53346107	chr4	53339989	53346107	6118	53343527
chr4:53466367-53472500	chr4	53466367	53472500	6133	53469915
chr4:53564637-53570664	chr4	53564637	53570664	6027	53568070
chr4:53725266-53729669	chr4	53725266	53729669	4403	53727111
chr4:53737156-53740796	chr4	53737156	53740796	3640	53738210
chr4:53833351-53839500	chr4	53833351	53839500	6149	53836919
chr4:53877116-53883135	chr4	53877116	53883135	6019	53880549
chr4:53970821-53971552	chr4	53970821	53971552	731	53971090
chr4:54043447-54047811	chr4	54043447	54047811	4364	54045223
chr4:54243580-54249798	chr4	54243580	54249798	6218	54247143
chr4:54461949-54466266	chr4	54461949	54466266	4317	54463661
chr4:54798950-54800954	chr4	54798950	54800954	2004	54799759
chr4:54807074-54813217	chr4	54807074	54813217	6143	54810659
chr4:55041311-55047425	chr4	55041311	55047425	6114	55044845
chr4:55208803-55211428	chr4	55208803	55211428	2625	55209357
chr4:55297161-55303286	chr4	55297161	55303286	6125	55300708
chr4:55619153-55625181	chr4	55619153	55625181	6028	55622591
chr4:55691653-55696950	chr4	55691653	55696950	5297	55694371
chr4:55707647-55713794	chr4	55707647	55713794	6147	55711207
chr4:55841737-55847894	chr4	55841737	55847894	6157	55845305
chr4:56362750-56368879	chr4	56362750	56368879	6129	56366294
chr4:56712645-56718770	chr4	56712645	56718770	6125	56716187
chr4:56885828-56890030	chr4	56885828	56890030	4202	56888157
chr4:57383831-57389970	chr4	57383831	57389970	6139	57387382
chr4:57518424-57521066	chr4	57518424	57521066	2642	57518486
chr4:57718377-57719353	chr4	57718377	57719353	976	57718701
chr4:57768853-57771417	chr4	57768853	57771417	2564	57771195
chr4:57790859-57791574	chr4	57790859	57791574	715	57791470
chr4:57919667-57924235	chr4	57919667	57924235	4568	57921645
chr4:58149260-58155721	chr4	58149260	58155721	6461	58153091
chr4:58335436-58339470	chr4	58335436	58339470	4034	58336885
chr4:58339466-58341834	chr4	58339466	58341834	2368	58340650
chr4:58374405-58375662	chr4	58374405	58375662	1257	58375155
chr4:58928627-58931095	chr4	58928627	58931095	2468	58929779
chr4:59078847-59084877	chr4	59078847	59084877	6030	59082285
chr4:59184178-59187894	chr4	59184178	59187894	3716	59185306
chr4:59206451-59212619	chr4	59206451	59212619	6168	59210027
chr4:59330495-59333780	chr4	59330495	59333780	3285	59331188
chr4:59419693-59425790	chr4	59419693	59425790	6097	59423210
chr4:59430466-59433382	chr4	59430466	59433382	2916	59430798
chr4:59531316-59533491	chr4	59531316	59533491	2175	59533161
chr4:59584700-59588043	chr4	59584700	59588043	3343	59585461
chr4:59781663-59785452	chr4	59781663	59785452	3789	59782871
chr4:59843331-59847967	chr4	59843331	59847967	4636	59845371
chr4:59891983-59898112	chr4	59891983	59898112	6129	59895536
chr4:60081021-60086144	chr4	60081021	60086144	5123	60084885
chr4:60695876-60701951	chr4	60695876	60701951	6075	60699392
chr4:60918621-60919693	chr4	60918621	60919693	1072	60918756
chr4:61011661-61017788	chr4	61011661	61017788	6127	61015203
chr4:61018568-61024158	chr4	61018568	61024158	5590	61021576
chr4:61743721-61749869	chr4	61743721	61749869	6148	61747282
chr4:62309260-62315383	chr4	62309260	62315383	6123	62312821
chr4:62602276-62608302	chr4	62602276	62608302	6026	62605715
chr4:62744519-62746172	chr4	62744519	62746172	1653	62746147
chr4:63026662-63028773	chr4	63026662	63028773	2111	63027307
chr4:63098445-63103041	chr4	63098445	63103041	4596	63100474
chr4:63333601-63339723	chr4	63333601	63339723	6122	63337139
chr4:63508411-63510594	chr4	63508411	63510594	2183	63509493
chr4:63532521-63538553	chr4	63532521	63538553	6032	63535962
chr4:63589607-63596326	chr4	63589607	63596326	6719	63593171
chr4:63847366-63847831	chr4	63847366	63847831	465	63847553
chr4:64663924-64666284	chr4	64663924	64666284	2360	64666157
chr4:64799486-64805261	chr4	64799486	64805261	5775	64803027
chr4:64840275-64842785	chr4	64840275	64842785	2510	64842148
chr4:65160641-65162941	chr4	65160641	65162941	2300	65162181
chr4:65176611-65182643	chr4	65176611	65182643	6032	65180026
chr4:65518750-65521536	chr4	65518750	65521536	2786	65518889
chr4:65541100-65544943	chr4	65541100	65544943	3843	65542645
chr4:66378724-66380828	chr4	66378724	66380828	2104	66378872
chr4:66547184-66551255	chr4	66547184	66551255	4071	66548669
chr4:66713600-66720064	chr4	66713600	66720064	6464	66717488
chr4:66966819-66969521	chr4	66966819	66969521	2702	66968465
chr4:67177042-67183058	chr4	67177042	67183058	6016	67180474
chr4:67652558-67658697	chr4	67652558	67658697	6139	67656112
chr4:67811156-67815725	chr4	67811156	67815725	4569	67813241
chr4:68196169-68200204	chr4	68196169	68200204	4035	68197621
chr4:68200198-68203095	chr4	68200198	68203095	2897	68200510
chr4:68203089-68205995	chr4	68203089	68205995	2906	68203401
chr4:68420253-68426333	chr4	68420253	68426333	6080	68423750
chr4:68542455-68548583	chr4	68542455	68548583	6128	68545998
chr4:69236156-69239146	chr4	69236156	69239146	2990	69236542
chr4:69301677-69305484	chr4	69301677	69305484	3807	69302922
chr4:69603386-69608577	chr4	69603386	69608577	5191	69605997
chr4:69664009-69667565	chr4	69664009	69667565	3556	69667446
chr4:69723014-69726028	chr4	69723014	69726028	3014	69723449
chr4:70328906-70334307	chr4	70328906	70334307	5401	70331715
chr4:70375423-70378663	chr4	70375423	70378663	3240	70376068
chr4:70463958-70470390	chr4	70463958	70470390	6432	70467834
chr4:71012178-71017935	chr4	71012178	71017935	5757	71015357
chr4:71101535-71106936	chr4	71101535	71106936	5401	71104346
chr4:71175206-71181371	chr4	71175206	71181371	6165	71178778
chr4:71308427-71314945	chr4	71308427	71314945	6518	71312346
chr4:71419829-71425003	chr4	71419829	71425003	5174	71422411
chr4:71615794-71621942	chr4	71615794	71621942	6148	71619369
chr4:71947603-71953697	chr4	71947603	71953697	6094	71951132
chr4:72051238-72052616	chr4	72051238	72052616	1378	72052069
chr4:72119478-72125359	chr4	72119478	72125359	5881	72123339
chr4:72477162-72480708	chr4	72477162	72480708	3546	72478116
chr4:72593713-72599863	chr4	72593713	72599863	6150	72597273
chr4:72679341-72684779	chr4	72679341	72684779	5438	72682854
chr4:72694790-72695709	chr4	72694790	72695709	919	72695160
chr4:72730382-72736061	chr4	72730382	72736061	5679	72734130
chr4:72750756-72756428	chr4	72750756	72756428	5672	72754957
chr4:72799695-72802318	chr4	72799695	72802318	2623	72799742
chr4:72825044-72827222	chr4	72825044	72827222	2178	72825811
chr4:72868322-72873994	chr4	72868322	72873994	5672	72871440
chr4:73322465-73325323	chr4	73322465	73325323	2858	73322740
chr4:73360155-73366246	chr4	73360155	73366246	6091	73363682
chr4:73550629-73556814	chr4	73550629	73556814	6185	73554197
chr4:74129196-74132750	chr4	74129196	74132750	3554	74130160
chr4:74505330-74511474	chr4	74505330	74511474	6144	74508901
chr4:74826720-74830950	chr4	74826720	74830950	4230	74828690
chr4:75112430-75115239	chr4	75112430	75115239	2809	75113439
chr4:75126805-75132838	chr4	75126805	75132838	6033	75130246
chr4:75221757-75227510	chr4	75221757	75227510	5753	75224925
chr4:75276606-75281008	chr4	75276606	75281008	4402	75278435
chr4:75297951-75298845	chr4	75297951	75298845	894	75298565
chr4:75313477-75317758	chr4	75313477	75317758	4281	75316995
chr4:75378234-75384174	chr4	75378234	75384174	5940	75381680
chr4:75401194-75407226	chr4	75401194	75407226	6032	75404635
chr4:76477675-76484153	chr4	76477675	76484153	6478	76481566
chr4:77888909-77890831	chr4	77888909	77890831	1922	77890054
chr4:77971356-77974177	chr4	77971356	77974177	2821	77971596
chr4:78085665-78089438	chr4	78085665	78089438	3773	78086847
chr4:78105735-78111765	chr4	78105735	78111765	6030	78109173
chr4:78347980-78354013	chr4	78347980	78354013	6033	78351419
chr4:78489966-78493818	chr4	78489966	78493818	3852	78491231
chr4:79270280-79271447	chr4	79270280	79271447	1167	79270452
chr4:79519355-79521214	chr4	79519355	79521214	1859	79520738
chr4:79704552-79710581	chr4	79704552	79710581	6029	79707989
chr4:79937715-79943746	chr4	79937715	79943746	6031	79941156
chr4:79966907-79972933	chr4	79966907	79972933	6026	79970341
chr4:80687674-80693706	chr4	80687674	80693706	6032	80691117
chr4:81155197-81160144	chr4	81155197	81160144	4947	81157504
chr4:81321808-81325328	chr4	81321808	81325328	3520	81322712
chr4:81384648-81388609	chr4	81384648	81388609	3961	81386023
chr4:81475784-81480099	chr4	81475784	81480099	4315	81477512
chr4:81534535-81538306	chr4	81534535	81538306	3771	81535718
chr4:81543045-81545599	chr4	81543045	81545599	2554	81543952
chr4:82111986-82115317	chr4	82111986	82115317	3331	82112738
chr4:82175410-82181538	chr4	82175410	82181538	6128	82178964
chr4:82184119-82190281	chr4	82184119	82190281	6162	82187690
chr4:82277067-82280100	chr4	82277067	82280100	3033	82277557
chr4:82544806-82545647	chr4	82544806	82545647	841	82544971
chr4:83164062-83170208	chr4	83164062	83170208	6146	83167622
chr4:83241624-83246952	chr4	83241624	83246952	5328	83244372
chr4:83397906-83404039	chr4	83397906	83404039	6133	83401452
chr4:84073472-84078520	chr4	84073472	84078520	5048	84075932
chr4:84126785-84132814	chr4	84126785	84132814	6029	84130222
chr4:84289054-84290927	chr4	84289054	84290927	1873	84289989
chr4:84298780-84304810	chr4	84298780	84304810	6030	84302217
chr4:84344297-84347363	chr4	84344297	84347363	3066	84345025
chr4:84987206-84993388	chr4	84987206	84993388	6182	84990817
chr4:85043345-85049688	chr4	85043345	85049688	6343	85047121
chr4:85239128-85240327	chr4	85239128	85240327	1199	85239765
chr4:85324652-85328285	chr4	85324652	85328285	3633	85325702
chr4:86134671-86140696	chr4	86134671	86140696	6025	86138109
chr4:86166803-86168070	chr4	86166803	86168070	1267	86167292
chr4:86207979-86208828	chr4	86207979	86208828	849	86208163
chr4:86636596-86639837	chr4	86636596	86639837	3241	86637253
chr4:86863852-86869135	chr4	86863852	86869135	5283	86866556
chr4:87585217-87586556	chr4	87585217	87586556	1339	87585371
chr4:87638115-87642423	chr4	87638115	87642423	4308	87639841
chr4:87710373-87716399	chr4	87710373	87716399	6026	87713812
chr4:87769093-87775231	chr4	87769093	87775231	6138	87772644
chr4:87795080-87798565	chr4	87795080	87798565	3485	87795977
chr4:88125636-88128909	chr4	88125636	88128909	3273	88126351
chr4:88538950-88545052	chr4	88538950	88545052	6102	88542511
chr4:88637447-88640746	chr4	88637447	88640746	3299	88638165
chr4:88870166-88876304	chr4	88870166	88876304	6138	88873715
chr4:88899696-88904794	chr4	88899696	88904794	5098	88902181
chr4:88919559-88925734	chr4	88919559	88925734	6175	88923124
chr4:89390153-89395349	chr4	89390153	89395349	5196	89392771
chr4:89478191-89480320	chr4	89478191	89480320	2129	89480028
chr4:89647459-89649632	chr4	89647459	89649632	2173	89648152
chr4:89675499-89678082	chr4	89675499	89678082	2583	89675520
chr4:90227608-90233632	chr4	90227608	90233632	6024	90231046
chr4:90409752-90411965	chr4	90409752	90411965	2213	90411198
chr4:90911493-90917662	chr4	90911493	90917662	6169	90915089
chr4:91437491-91443691	chr4	91437491	91443691	6200	91441044
chr4:91462374-91468513	chr4	91462374	91468513	6139	91465927
chr4:91978211-91984413	chr4	91978211	91984413	6202	91981651
chr4:92001488-92005395	chr4	92001488	92005395	3907	92005225
chr4:92078684-92085126	chr4	92078684	92085126	6442	92082544
chr4:92211416-92215213	chr4	92211416	92215213	3797	92212672
chr4:92571259-92572599	chr4	92571259	92572599	1340	92572459
chr4:92601172-92604692	chr4	92601172	92604692	3520	92602086
chr4:93554806-93559119	chr4	93554806	93559119	4313	93558659
chr4:93676798-93682944	chr4	93676798	93682944	6146	93680352
chr4:94098904-94105047	chr4	94098904	94105047	6143	94102469
chr4:95663699-95669862	chr4	95663699	95669862	6163	95667280
chr4:95752928-95754082	chr4	95752928	95754082	1154	95753786
chr4:95791404-95797509	chr4	95791404	95797509	6105	95794937
chr4:95914759-95920788	chr4	95914759	95920788	6029	95918197
chr4:96335692-96338608	chr4	96335692	96338608	2916	96336029
chr4:96797734-96799217	chr4	96797734	96799217	1483	96798942
chr4:96862536-96869013	chr4	96862536	96869013	6477	96866431
chr4:97272287-97275508	chr4	97272287	97275508	3221	97274723
chr4:97336800-97343043	chr4	97336800	97343043	6243	97340443
chr4:97417608-97420241	chr4	97417608	97420241	2633	97417840
chr4:97537068-97543159	chr4	97537068	97543159	6091	97540549
chr4:97633479-97639503	chr4	97633479	97639503	6024	97636916
chr4:97736223-97742374	chr4	97736223	97742374	6151	97739788
chr4:97777927-97784080	chr4	97777927	97784080	6153	97781505
chr4:97828093-97834513	chr4	97828093	97834513	6420	97831944
chr4:97861635-97865597	chr4	97861635	97865597	3962	97863522
chr4:97905803-97909010	chr4	97905803	97909010	3207	97906440
chr4:97964870-97968744	chr4	97964870	97968744	3874	97968362
chr4:98320498-98325931	chr4	98320498	98325931	5433	98323346
chr4:98723293-98727945	chr4	98723293	98727945	4652	98726834
chr4:98762566-98764670	chr4	98762566	98764670	2104	98762882
chr4:99425024-99427074	chr4	99425024	99427074	2050	99426634
chr4:99492128-99498275	chr4	99492128	99498275	6147	99495682
chr4:99698753-99705199	chr4	99698753	99705199	6446	99702635
chr4:100433915-100437054	chr4	100433915	100437054	3139	100434449
chr4:100900162-100906584	chr4	100900162	100906584	6422	100904020
chr4:100916369-100924874	chr4	100916369	100924874	8505	100919727
chr4:101131285-101135231	chr4	101131285	101135231	3946	101132673
chr4:102480016-102482955	chr4	102480016	102482955	2939	102481470
chr4:102919436-102925562	chr4	102919436	102925562	6126	102922982
chr4:102968558-102972366	chr4	102968558	102972366	3808	102972065
chr4:103187274-103191805	chr4	103187274	103191805	4531	103189215
chr4:103385093-103391522	chr4	103385093	103391522	6429	103388953
chr4:103395530-103397692	chr4	103395530	103397692	2162	103396734
chr4:103528651-103531298	chr4	103528651	103531298	2647	103528716
chr4:103627560-103631333	chr4	103627560	103631333	3773	103628722
chr4:103636544-103639603	chr4	103636544	103639603	3059	103637012
chr4:103686733-103689411	chr4	103686733	103689411	2678	103686820
chr4:103707525-103713626	chr4	103707525	103713626	6101	103711066
chr4:104036477-104037515	chr4	104036477	104037515	1038	104037135
chr4:104376147-104379673	chr4	104376147	104379673	3526	104377106
chr4:104439456-104442795	chr4	104439456	104442795	3339	104440580
chr4:104706561-104712937	chr4	104706561	104712937	6376	104710446
chr4:104786988-104793014	chr4	104786988	104793014	6026	104790426
chr4:104802270-104803106	chr4	104802270	104803106	836	104802334
chr4:105860130-105866235	chr4	105860130	105866235	6105	105863672
chr4:105880181-105886196	chr4	105880181	105886196	6015	105883721
chr4:106103720-106109008	chr4	106103720	106109008	5288	106108180
chr4:106121098-106125014	chr4	106121098	106125014	3916	106122449
chr4:106213354-106219380	chr4	106213354	106219380	6026	106216791
chr4:106488130-106491435	chr4	106488130	106491435	3305	106488859
chr4:106672619-106675994	chr4	106672619	106675994	3375	106673442
chr4:106900237-106903504	chr4	106900237	106903504	3267	106900927
chr4:106935103-106941147	chr4	106935103	106941147	6044	106938543
chr4:107672082-107678199	chr4	107672082	107678199	6117	107675608
chr4:107956731-107962823	chr4	107956731	107962823	6092	107960237
chr4:108993985-109000126	chr4	108993985	109000126	6141	108997548
chr4:109777094-109781152	chr4	109777094	109781152	4058	109778555
chr4:110076600-110082755	chr4	110076600	110082755	6155	110080165
chr4:110420197-110422921	chr4	110420197	110422921	2724	110420374
chr4:111163728-111170181	chr4	111163728	111170181	6453	111167609
chr4:111292076-111293915	chr4	111292076	111293915	1839	111292148
chr4:111336943-111342946	chr4	111336943	111342946	6003	111340359
chr4:111377903-111384069	chr4	111377903	111384069	6166	111381481
chr4:111458039-111461730	chr4	111458039	111461730	3691	111459140
chr4:111565139-111571245	chr4	111565139	111571245	6106	111568692
chr4:111894801-111900831	chr4	111894801	111900831	6030	111898239
chr4:112086463-112092501	chr4	112086463	112092501	6038	112089907
chr4:112160424-112163572	chr4	112160424	112163572	3148	112161733
chr4:112575290-112581425	chr4	112575290	112581425	6135	112578845
chr4:113852142-113858298	chr4	113852142	113858298	6156	113855711
chr4:113987899-113990322	chr4	113987899	113990322	2423	113989606
chr4:114071183-114075035	chr4	114071183	114075035	3852	114073956
chr4:115172465-115177873	chr4	115172465	115177873	5408	115175290
chr4:115386942-115393322	chr4	115386942	115393322	6380	115390832
chr4:115811675-115817826	chr4	115811675	115817826	6151	115815233
chr4:115900073-115903784	chr4	115900073	115903784	3711	115901068
chr4:116405696-116411731	chr4	116405696	116411731	6035	116409139
chr4:116814816-116821211	chr4	116814816	116821211	6395	116818621
chr4:117950738-117954813	chr4	117950738	117954813	4075	117952016
chr4:118217829-118220623	chr4	118217829	118220623	2794	118218116
chr4:118403693-118409837	chr4	118403693	118409837	6144	118407249
chr4:119073638-119079786	chr4	119073638	119079786	6148	119077198
chr4:119197686-119203154	chr4	119197686	119203154	5468	119201230
chr4:119574940-119579852	chr4	119574940	119579852	4912	119577260
chr4:119915938-119920649	chr4	119915938	119920649	4711	119918065
chr4:120125383-120128933	chr4	120125383	120128933	3550	120126343
chr4:120460346-120464352	chr4	120460346	120464352	4006	120464182
chr4:120476539-120479499	chr4	120476539	120479499	2960	120476914
chr4:120508813-120515250	chr4	120508813	120515250	6437	120512686
chr4:120650547-120652539	chr4	120650547	120652539	1992	120651583
chr4:120741413-120747472	chr4	120741413	120747472	6059	120744855
chr4:120802411-120807540	chr4	120802411	120807540	5129	120805275
chr4:121284816-121290923	chr4	121284816	121290923	6107	121288362
chr4:121442409-121446145	chr4	121442409	121446145	3736	121443669
chr4:121497551-121498351	chr4	121497551	121498351	800	121497977
chr4:121567208-121573466	chr4	121567208	121573466	6258	121570877
chr4:121616231-121622378	chr4	121616231	121622378	6147	121619797
chr4:122110106-122116118	chr4	122110106	122116118	6012	122113529
chr4:122364712-122370328	chr4	122364712	122370328	5616	122368349
chr4:122492915-122499068	chr4	122492915	122499068	6153	122496475
chr4:123237702-123243739	chr4	123237702	123243739	6037	123241206
chr4:123513583-123515088	chr4	123513583	123515088	1505	123514848
chr4:123715160-123719211	chr4	123715160	123719211	4051	123716629
chr4:123721384-123727541	chr4	123721384	123727541	6157	123724950
chr4:124167362-124172886	chr4	124167362	124172886	5524	124171066
chr4:124361247-124367393	chr4	124361247	124367393	6146	124364804
chr4:126031432-126036101	chr4	126031432	126036101	4669	126033521
chr4:126496503-126498382	chr4	126496503	126498382	1879	126496815
chr4:126554729-126557848	chr4	126554729	126557848	3119	126555275
chr4:126669745-126675724	chr4	126669745	126675724	5979	126673160
chr4:126928255-126934284	chr4	126928255	126934284	6029	126931695
chr4:127020568-127026555	chr4	127020568	127026555	5987	127024004
chr4:127200500-127202230	chr4	127200500	127202230	1730	127201406
chr4:127472690-127478829	chr4	127472690	127478829	6139	127476238
chr4:127588930-127594962	chr4	127588930	127594962	6032	127592373
chr4:127676608-127682756	chr4	127676608	127682756	6148	127680178
chr4:127861640-127864937	chr4	127861640	127864937	3297	127863097
chr4:128213789-128219796	chr4	128213789	128219796	6007	128217217
chr4:128895551-128901681	chr4	128895551	128901681	6130	128899098
chr4:129025671-129029691	chr4	129025671	129029691	4020	129027125
chr4:129445939-129452232	chr4	129445939	129452232	6293	129449634
chr4:129590590-129593870	chr4	129590590	129593870	3280	129591297
chr4:129853905-129859930	chr4	129853905	129859930	6025	129857324
chr4:129963326-129965685	chr4	129963326	129965685	2359	129964340
chr4:130977157-130978013	chr4	130977157	130978013	856	130977878
chr4:131072771-131077040	chr4	131072771	131077040	4269	131074449
chr4:131352393-131358409	chr4	131352393	131358409	6016	131355826
chr4:131421590-131425110	chr4	131421590	131425110	3520	131422517
chr4:132459890-132463887	chr4	132459890	132463887	3997	132461323
chr4:132944445-132950433	chr4	132944445	132950433	5988	132947841
chr4:133507652-133511052	chr4	133507652	133511052	3400	133509108
chr4:134207774-134213927	chr4	134207774	134213927	6153	134211339
chr4:134571731-134574247	chr4	134571731	134574247	2516	134572557
chr4:134792428-134795557	chr4	134792428	134795557	3129	134793154
chr4:134829662-134835794	chr4	134829662	134835794	6132	134833223
chr4:134969224-134973166	chr4	134969224	134973166	3942	134970585
chr4:135447537-135453551	chr4	135447537	135453551	6014	135450961
chr4:135847323-135849301	chr4	135847323	135849301	1978	135847465
chr4:137496278-137502288	chr4	137496278	137502288	6010	137499714
chr4:137595914-137596947	chr4	137595914	137596947	1033	137596025
chr4:137783660-137789803	chr4	137783660	137789803	6143	137787216
chr4:138541917-138546528	chr4	138541917	138546528	4611	138545764
chr4:138547723-138552054	chr4	138547723	138552054	4331	138549462
chr4:140337546-140340477	chr4	140337546	140340477	2931	140337872
chr4:140413342-140419363	chr4	140413342	140419363	6021	140416774
chr4:140508200-140514266	chr4	140508200	140514266	6066	140511767
chr4:140917167-140921175	chr4	140917167	140921175	4008	140918609
chr4:140921206-140924131	chr4	140921206	140924131	2925	140921542
chr4:141162517-141168948	chr4	141162517	141168948	6431	141166374
chr4:141271462-141272722	chr4	141271462	141272722	1260	141272012
chr4:141377781-141383925	chr4	141377781	141383925	6144	141381337
chr4:141549289-141555444	chr4	141549289	141555444	6155	141552864
chr4:141815413-141821816	chr4	141815413	141821816	6403	141819257
chr4:141823412-141824218	chr4	141823412	141824218	806	141823545
chr4:141833622-141839786	chr4	141833622	141839786	6164	141837196
chr4:141965709-141971847	chr4	141965709	141971847	6138	141969267
chr4:142253344-142259388	chr4	142253344	142259388	6044	142256779
chr4:142437678-142438015	chr4	142437678	142438015	337	142437950
chr4:142624504-142626185	chr4	142624504	142626185	1681	142624554
chr4:142990876-142997042	chr4	142990876	142997042	6166	142994455
chr4:143100259-143106289	chr4	143100259	143106289	6030	143103699
chr4:143140065-143146510	chr4	143140065	143146510	6445	143143937
chr4:143166456-143172590	chr4	143166456	143172590	6134	143170002
chr4:143674188-143678544	chr4	143674188	143678544	4356	143675965
chr4:143717943-143719436	chr4	143717943	143719436	1493	143718275
chr4:144391554-144397691	chr4	144391554	144397691	6137	144395102
chr4:144482470-144488573	chr4	144482470	144488573	6103	144486007
chr4:144768558-144774706	chr4	144768558	144774706	6148	144772115
chr4:144791618-144796881	chr4	144791618	144796881	5263	144795152
chr4:144836726-144842988	chr4	144836726	144842988	6262	144840248
chr4:144996566-144999368	chr4	144996566	144999368	2802	144999190
chr4:145007083-145010833	chr4	145007083	145010833	3750	145008260
chr4:145369388-145375369	chr4	145369388	145375369	5981	145372777
chr4:145457542-145462069	chr4	145457542	145462069	4527	145461070
chr4:146350018-146356052	chr4	146350018	146356052	6034	146353461
chr4:146530559-146533650	chr4	146530559	146533650	3091	146531069
chr4:146663922-146669640	chr4	146663922	146669640	5718	146667050
chr4:146677439-146680654	chr4	146677439	146680654	3215	146678043
chr4:146803954-146810411	chr4	146803954	146810411	6457	146807813
chr4:147183617-147190030	chr4	147183617	147190030	6413	147187454
chr4:147256748-147260674	chr4	147256748	147260674	3926	147258049
chr4:147292165-147298625	chr4	147292165	147298625	6460	147296044
chr4:147434630-147440182	chr4	147434630	147440182	5552	147437592
chr4:148082263-148086453	chr4	148082263	148086453	4190	148086052
chr4:148762891-148764060	chr4	148762891	148764060	1169	148763314
chr4:148766955-148768725	chr4	148766955	148768725	1770	148767690
chr4:148815849-148819047	chr4	148815849	148819047	3198	148816465
chr4:149128445-149132417	chr4	149128445	149132417	3972	149130914
chr4:149175568-149181988	chr4	149175568	149181988	6420	149179409
chr4:149229959-149233335	chr4	149229959	149233335	3376	149231398
chr4:149468022-149474136	chr4	149468022	149474136	6114	149471542
chr4:149816060-149819696	chr4	149816060	149819696	3636	149817105
chr4:149848204-149854224	chr4	149848204	149854224	6020	149851645
chr4:149915524-149921557	chr4	149915524	149921557	6033	149918966
chr4:150270912-150277426	chr4	150270912	150277426	6514	150274857
chr4:150502570-150507814	chr4	150502570	150507814	5244	150506151
chr4:151465221-151468003	chr4	151465221	151468003	2782	151465446
chr4:151511295-151517459	chr4	151511295	151517459	6164	151514878
chr4:152921818-152925022	chr4	152921818	152925022	3204	152922431
chr4:153818041-153821399	chr4	153818041	153821399	3358	153818804
chr4:153955925-153959325	chr4	153955925	153959325	3400	153956736
chr4:154108480-154114963	chr4	154108480	154114963	6483	154112351
chr4:154646726-154651306	chr4	154646726	154651306	4580	154650421
chr4:154891689-154898150	chr4	154891689	154898150	6461	154895537
chr4:155021718-155024660	chr4	155021718	155024660	2942	155022082
chr4:155892568-155897405	chr4	155892568	155897405	4837	155894816
chr4:156367269-156373295	chr4	156367269	156373295	6026	156370706
chr4:156467726-156468126	chr4	156467726	156468126	400	156467992
chr4:156505319-156509554	chr4	156505319	156509554	4235	156509155
chr4:157622966-157625224	chr4	157622966	157625224	2258	157623397
chr4:157691504-157697429	chr4	157691504	157697429	5925	157695058
chr4:158431742-158436780	chr4	158431742	158436780	5038	158434192
chr4:158982792-158987789	chr4	158982792	158987789	4997	158985207
chr4:158987803-158990881	chr4	158987803	158990881	3078	158988316
chr4:159804371-159810375	chr4	159804371	159810375	6004	159807797
chr4:160001351-160005462	chr4	160001351	160005462	4111	160005249
chr4:160436073-160439011	chr4	160436073	160439011	2938	160436422
chr4:160574032-160580085	chr4	160574032	160580085	6053	160577469
chr4:160624397-160627313	chr4	160624397	160627313	2916	160624740
chr4:161026765-161030976	chr4	161026765	161030976	4211	161028366
chr4:161082624-161085603	chr4	161082624	161085603	2979	161083014
chr4:161638496-161639144	chr4	161638496	161639144	648	161638572
chr4:163632232-163638253	chr4	163632232	163638253	6021	163635668
chr4:163655379-163658594	chr4	163655379	163658594	3215	163656479
chr4:164100748-164106778	chr4	164100748	164106778	6030	164104189
chr4:164241613-164247620	chr4	164241613	164247620	6007	164245032
chr4:164350749-164356776	chr4	164350749	164356776	6027	164354187
chr4:164544656-164549374	chr4	164544656	164549374	4718	164546789
chr4:164563138-164569253	chr4	164563138	164569253	6115	164566666
chr4:164630154-164636681	chr4	164630154	164636681	6527	164634020
chr4:165818904-165825031	chr4	165818904	165825031	6127	165822453
chr4:166237016-166238613	chr4	166237016	166238613	1597	166237917
chr4:166266016-166271588	chr4	166266016	166271588	5572	166268962
chr4:166463312-166469345	chr4	166463312	166469345	6033	166466755
chr4:166569976-166576007	chr4	166569976	166576007	6031	166573415
chr4:166743489-166749649	chr4	166743489	166749649	6160	166747058
chr4:166755895-166761908	chr4	166755895	166761908	6013	166759317
chr4:166862886-166866659	chr4	166862886	166866659	3773	166864857
chr4:166949748-166954097	chr4	166949748	166954097	4349	166951506
chr4:167270309-167273594	chr4	167270309	167273594	3285	167271012
chr4:167857881-167863903	chr4	167857881	167863903	6022	167861331
chr4:168066906-168069667	chr4	168066906	168069667	2761	168067834
chr4:168344060-168347008	chr4	168344060	168347008	2948	168344420
chr4:168441989-168448038	chr4	168441989	168448038	6049	168445453
chr4:168934984-168941034	chr4	168934984	168941034	6050	168938870
chr4:169448685-169453420	chr4	169448685	169453420	4735	169452242
chr4:170207107-170213263	chr4	170207107	170213263	6156	170210685
chr4:170431382-170437424	chr4	170431382	170437424	6042	170434860
chr4:170639225-170645417	chr4	170639225	170645417	6192	170642825
chr4:171758830-171764612	chr4	171758830	171764612	5782	171762496
chr4:171903130-171909158	chr4	171903130	171909158	6028	171906568
chr4:172193883-172197827	chr4	172193883	172197827	3944	172196370
chr4:172454913-172461372	chr4	172454913	172461372	6459	172458788
chr4:172912250-172918401	chr4	172912250	172918401	6151	172915820
chr4:172935346-172936737	chr4	172935346	172936737	1391	172935855
chr4:173717999-173721218	chr4	173717999	173721218	3219	173720065
chr4:173785907-173792044	chr4	173785907	173792044	6137	173789465
chr4:174618874-174621927	chr4	174618874	174621927	3053	174621691
chr4:174778462-174784478	chr4	174778462	174784478	6016	174781891
chr4:175019740-175025751	chr4	175019740	175025751	6011	175023161
chr4:175208156-175208980	chr4	175208156	175208980	824	175208617
chr4:175388837-175392655	chr4	175388837	175392655	3818	175390105
chr4:175534013-175536026	chr4	175534013	175536026	2013	175534852
chr4:176692433-176698129	chr4	176692433	176698129	5696	176695553
chr4:177017217-177023392	chr4	177017217	177023392	6175	177020783
chr4:177522785-177524077	chr4	177522785	177524077	1292	177523720
chr4:178015030-178021062	chr4	178015030	178021062	6032	178018472
chr4:178636677-178642035	chr4	178636677	178642035	5358	178640551
chr4:178886275-178890079	chr4	178886275	178890079	3804	178887514
chr4:179029954-179035698	chr4	179029954	179035698	5744	179033490
chr4:179301041-179304117	chr4	179301041	179304117	3076	179301508
chr4:179546727-179550096	chr4	179546727	179550096	3369	179547527
chr4:179636522-179642706	chr4	179636522	179642706	6184	179640093
chr4:181926712-181933174	chr4	181926712	181933174	6462	181930591
chr4:184176946-184183026	chr4	184176946	184183026	6080	184180433
chr4:184208227-184214253	chr4	184208227	184214253	6026	184211662
chr4:184604981-184607954	chr4	184604981	184607954	2973	184605386
chr4:187050521-187056658	chr4	187050521	187056658	6137	187054063
chr4:187523846-187526876	chr4	187523846	187526876	3030	187524328
chr4:187843265-187847012	chr4	187843265	187847012	3747	187844419
chr4:188675140-188678862	chr4	188675140	188678862	3722	188676280
chr4:188945068-188946618	chr4	188945068	188946618	1550	188945917
chr4:189137081-189143104	chr4	189137081	189143104	6023	189140512
chr4:189351056-189351873	chr4	189351056	189351873	817	189351626
chr4:189963770-189969847	chr4	189963770	189969847	6077	189967258
chr4:189991561-189992476	chr4	189991561	189992476	915	189991627
chr4_GL000008v2_random:24354-30480	chr4_GL000008v2_random	24354	30480	6126	27890
chr4_GL000257v2_alt:113939-120030	chr4_GL000257v2_alt	113939	120030	6091	117443
chr4_GL383527v1_alt:57191-62028	chr4_GL383527v1_alt	57191	62028	4837	59439
chr4_GL383528v1_alt:134692-137595	chr4_GL383528v1_alt	134692	137595	2903	135006
chr4_KI270787v1_alt:13559-18856	chr4_KI270787v1_alt	13559	18856	5297	16277
chr4_KI270787v1_alt:29553-35700	chr4_KI270787v1_alt	29553	35700	6147	33113
chr4_KI270896v1_alt:301301-307378	chr4_KI270896v1_alt	301301	307378	6077	304789
chr4_KI270896v1_alt:329092-330007	chr4_KI270896v1_alt	329092	330007	915	329158
chr5:1709818-1715835	chr5	1709818	1715835	6017	1713245
chr5:1968618-1971481	chr5	1968618	1971481	2863	1968861
chr5:3439015-3445063	chr5	3439015	3445063	6048	3442473
chr5:3478689-3479118	chr5	3478689	3479118	429	3478810
chr5:3548987-3550141	chr5	3548987	3550141	1154	3549270
chr5:4615428-4621437	chr5	4615428	4621437	6009	4618863
chr5:4709331-4715923	chr5	4709331	4715923	6592	4713348
chr5:4763314-4763856	chr5	4763314	4763856	542	4763778
chr5:4812360-4812977	chr5	4812360	4812977	617	4812723
chr5:5477162-5480089	chr5	5477162	5480089	2927	5477561
chr5:6951811-6958295	chr5	6951811	6958295	6484	6955701
chr5:6967312-6971675	chr5	6967312	6971675	4363	6969081
chr5:7170548-7176731	chr5	7170548	7176731	6183	7174122
chr5:7193769-7199795	chr5	7193769	7199795	6026	7197207
chr5:7230590-7236741	chr5	7230590	7236741	6151	7234156
chr5:8159062-8164555	chr5	8159062	8164555	5493	8161975
chr5:8220024-8226185	chr5	8220024	8226185	6161	8223593
chr5:8283484-8286837	chr5	8283484	8286837	3353	8284244
chr5:8730856-8736988	chr5	8730856	8736988	6132	8734420
chr5:9259624-9262908	chr5	9259624	9262908	3284	9260317
chr5:9990758-9996880	chr5	9990758	9996880	6122	9994282
chr5:10005466-10008842	chr5	10005466	10008842	3376	10006255
chr5:10177396-10183769	chr5	10177396	10183769	6373	10181214
chr5:10781522-10783864	chr5	10781522	10783864	2342	10783810
chr5:12152186-12152467	chr5	12152186	12152467	281	12152405
chr5:12153224-12159648	chr5	12153224	12159648	6424	12157069
chr5:12453184-12455112	chr5	12453184	12455112	1928	12454329
chr5:13416497-13422525	chr5	13416497	13422525	6028	13419937
chr5:13795031-13798218	chr5	13795031	13798218	3187	13795624
chr5:15271411-15277431	chr5	15271411	15277431	6020	15274836
chr5:15291930-15298100	chr5	15291930	15298100	6170	15295510
chr5:15398081-15402002	chr5	15398081	15402002	3921	15399413
chr5:15872433-15876411	chr5	15872433	15876411	3978	15873840
chr5:16197672-16202604	chr5	16197672	16202604	4932	16199989
chr5:16335410-16341440	chr5	16335410	16341440	6030	16338849
chr5:18471816-18477834	chr5	18471816	18477834	6018	18475252
chr5:19080990-19082600	chr5	19080990	19082600	1610	19081547
chr5:19161336-19167360	chr5	19161336	19167360	6024	19164769
chr5:20526064-20531903	chr5	20526064	20531903	5839	20529325
chr5:20646006-20647006	chr5	20646006	20647006	1000	20646181
chr5:20725945-20726904	chr5	20725945	20726904	959	20726010
chr5:21107412-21113430	chr5	21107412	21113430	6018	21110851
chr5:22280252-22283105	chr5	22280252	22283105	2853	22280797
chr5:22358956-22363089	chr5	22358956	22363089	4133	22360503
chr5:22622455-22625311	chr5	22622455	22625311	2856	22622745
chr5:22820449-22823388	chr5	22820449	22823388	2939	22820808
chr5:24371466-24373344	chr5	24371466	24373344	1878	24371541
chr5:24978290-24981190	chr5	24978290	24981190	2900	24980216
chr5:25473002-25476677	chr5	25473002	25476677	3675	25474094
chr5:25629383-25633617	chr5	25629383	25633617	4234	25631095
chr5:25831261-25832970	chr5	25831261	25832970	1709	25831471
chr5:25938616-25939485	chr5	25938616	25939485	869	25939222
chr5:26476048-26482063	chr5	26476048	26482063	6015	26479476
chr5:26812561-26818923	chr5	26812561	26818923	6362	26816278
chr5:27201863-27204505	chr5	27201863	27204505	2642	27201929
chr5:27755268-27757117	chr5	27755268	27757117	1849	27755442
chr5:28352191-28355208	chr5	28352191	28355208	3017	28352607
chr5:28503876-28504954	chr5	28503876	28504954	1078	28504191
chr5:28798790-28804814	chr5	28798790	28804814	6024	28802225
chr5:28845347-28847809	chr5	28845347	28847809	2462	28847511
chr5:28991081-28997161	chr5	28991081	28997161	6080	28994585
chr5:32794706-32799584	chr5	32794706	32799584	4878	32798627
chr5:32824614-32827995	chr5	32824614	32827995	3381	32827481
chr5:32922313-32922676	chr5	32922313	32922676	363	32922330
chr5:33122370-33128395	chr5	33122370	33128395	6025	33125804
chr5:33388689-33392371	chr5	33388689	33392371	3682	33392258
chr5:33539828-33546021	chr5	33539828	33546021	6193	33543437
chr5:33568655-33574761	chr5	33568655	33574761	6106	33572172
chr5:33861154-33864135	chr5	33861154	33864135	2981	33862617
chr5:34147845-34154031	chr5	34147845	34154031	6186	34151277
chr5:35017638-35022736	chr5	35017638	35022736	5098	35020147
chr5:35075072-35081201	chr5	35075072	35081201	6129	35078632
chr5:35396097-35402235	chr5	35396097	35402235	6138	35399652
chr5:35494184-35500399	chr5	35494184	35500399	6215	35497808
chr5:35911739-35917876	chr5	35911739	35917876	6137	35915284
chr5:36467419-36471462	chr5	36467419	36471462	4043	36468876
chr5:36473743-36475709	chr5	36473743	36475709	1966	36473899
chr5:37522504-37528637	chr5	37522504	37528637	6133	37526057
chr5:38221843-38223353	chr5	38221843	38223353	1510	38222021
chr5:38702786-38706043	chr5	38702786	38706043	3257	38703509
chr5:39034329-39040476	chr5	39034329	39040476	6147	39037893
chr5:39343059-39349181	chr5	39343059	39349181	6122	39346595
chr5:39787652-39793671	chr5	39787652	39793671	6019	39791090
chr5:39952232-39956167	chr5	39952232	39956167	3935	39953580
chr5:40179168-40182174	chr5	40179168	40182174	3006	40179531
chr5:40335911-40342044	chr5	40335911	40342044	6133	40339460
chr5:40541305-40547335	chr5	40541305	40547335	6030	40544745
chr5:40634169-40640424	chr5	40634169	40640424	6255	40638030
chr5:40706767-40711081	chr5	40706767	40711081	4314	40708606
chr5:41022073-41028195	chr5	41022073	41028195	6122	41025609
chr5:41207349-41211396	chr5	41207349	41211396	4047	41208795
chr5:41236405-41238431	chr5	41236405	41238431	2026	41237151
chr5:41330184-41333104	chr5	41330184	41333104	2920	41330520
chr5:41744747-41746293	chr5	41744747	41746293	1546	41745974
chr5:41846996-41849066	chr5	41846996	41849066	2070	41847354
chr5:42078293-42084307	chr5	42078293	42084307	6014	42081721
chr5:42353189-42357266	chr5	42353189	42357266	4077	42356744
chr5:42659631-42665759	chr5	42659631	42665759	6128	42663168
chr5:42734714-42740780	chr5	42734714	42740780	6066	42738158
chr5:42931680-42937866	chr5	42931680	42937866	6186	42935290
chr5:43340769-43344359	chr5	43340769	43344359	3590	43344328
chr5:43402548-43408647	chr5	43402548	43408647	6099	43406071
chr5:43462827-43465964	chr5	43462827	43465964	3137	43463363
chr5:43791638-43797778	chr5	43791638	43797778	6140	43795187
chr5:43952907-43958922	chr5	43952907	43958922	6015	43956444
chr5:44013805-44019878	chr5	44013805	44019878	6073	44017295
chr5:44577924-44578706	chr5	44577924	44578706	782	44577971
chr5:44578944-44584955	chr5	44578944	44584955	6011	44582363
chr5:44623654-44626252	chr5	44623654	44626252	2598	44623677
chr5:44668502-44674529	chr5	44668502	44674529	6027	44671940
chr5:45117916-45122031	chr5	45117916	45122031	4115	45119437
chr5:45312380-45318571	chr5	45312380	45318571	6191	45315989
chr5:45346381-45352534	chr5	45346381	45352534	6153	45349948
chr5:45658440-45664470	chr5	45658440	45664470	6030	45661879
chr5:45786144-45792292	chr5	45786144	45792292	6148	45789700
chr5:45847499-45854000	chr5	45847499	45854000	6501	45851339
chr5:45931886-45933401	chr5	45931886	45933401	1515	45932632
chr5:46130900-46136997	chr5	46130900	46136997	6097	46134431
chr5:46193424-46199442	chr5	46193424	46199442	6018	46196853
chr5:46313456-46318375	chr5	46313456	46318375	4919	46315785
chr5:50147585-50151880	chr5	50147585	50151880	4295	50149311
chr5:50156151-50161079	chr5	50156151	50161079	4928	50159560
chr5:50269675-50272872	chr5	50269675	50272872	3197	50270285
chr5:50280227-50286251	chr5	50280227	50286251	6024	50283649
chr5:50295625-50298188	chr5	50295625	50298188	2563	50296150
chr5:50309128-50311243	chr5	50309128	50311243	2115	50310762
chr5:50330069-50336236	chr5	50330069	50336236	6167	50333645
chr5:50377984-50381647	chr5	50377984	50381647	3663	50379058
chr5:50386905-50393119	chr5	50386905	50393119	6214	50390554
chr5:50495184-50500735	chr5	50495184	50500735	5551	50498157
chr5:50531827-50534976	chr5	50531827	50534976	3149	50532408
chr5:50541062-50547222	chr5	50541062	50547222	6160	50544634
chr5:51140386-51143046	chr5	51140386	51143046	2660	51140462
chr5:51250746-51256770	chr5	51250746	51256770	6024	51254179
chr5:51304490-51310641	chr5	51304490	51310641	6151	51308055
chr5:51348667-51354822	chr5	51348667	51354822	6155	51352232
chr5:51951743-51957834	chr5	51951743	51957834	6091	51955359
chr5:52088227-52092569	chr5	52088227	52092569	4342	52089955
chr5:52278728-52281569	chr5	52278728	52281569	2841	52278978
chr5:52313051-52316740	chr5	52313051	52316740	3689	52314153
chr5:52533859-52539383	chr5	52533859	52539383	5524	52536797
chr5:52718498-52723929	chr5	52718498	52723929	5431	52721321
chr5:53141066-53147199	chr5	53141066	53147199	6133	53144636
chr5:53268033-53274186	chr5	53268033	53274186	6153	53271563
chr5:53495077-53499789	chr5	53495077	53499789	4712	53497201
chr5:53686734-53689784	chr5	53686734	53689784	3050	53686997
chr5:53752969-53755778	chr5	53752969	53755778	2809	53755010
chr5:53802805-53808921	chr5	53802805	53808921	6116	53806346
chr5:54197627-54200307	chr5	54197627	54200307	2680	54197720
chr5:54812944-54819110	chr5	54812944	54819110	6166	54816519
chr5:54919391-54924118	chr5	54919391	54924118	4727	54921532
chr5:54999541-55003090	chr5	54999541	55003090	3549	55000490
chr5:55014234-55018350	chr5	55014234	55018350	4116	55015774
chr5:56799529-56800220	chr5	56799529	56800220	691	56799690
chr5:57996852-58001246	chr5	57996852	58001246	4394	57998496
chr5:58215915-58221290	chr5	58215915	58221290	5375	58219464
chr5:58288061-58294158	chr5	58288061	58294158	6097	58291488
chr5:58384174-58390206	chr5	58384174	58390206	6032	58387614
chr5:58572793-58578942	chr5	58572793	58578942	6149	58576358
chr5:59010775-59016291	chr5	59010775	59016291	5516	59013719
chr5:59394720-59400744	chr5	59394720	59400744	6024	59398154
chr5:59631455-59637825	chr5	59631455	59637825	6370	59635312
chr5:60050385-60054688	chr5	60050385	60054688	4303	60052114
chr5:60103870-60110024	chr5	60103870	60110024	6154	60107432
chr5:60420575-60426695	chr5	60420575	60426695	6120	60424111
chr5:60555605-60561646	chr5	60555605	60561646	6041	60559044
chr5:60615159-60620551	chr5	60615159	60620551	5392	60618712
chr5:60728850-60734324	chr5	60728850	60734324	5474	60732417
chr5:60860389-60866437	chr5	60860389	60866437	6048	60863822
chr5:61126786-61129803	chr5	61126786	61129803	3017	61127210
chr5:61238874-61245001	chr5	61238874	61245001	6127	61242425
chr5:62291538-62295566	chr5	62291538	62295566	4028	62295175
chr5:62655618-62660602	chr5	62655618	62660602	4984	62659188
chr5:62752438-62758520	chr5	62752438	62758520	6082	62755952
chr5:62817292-62823372	chr5	62817292	62823372	6080	62820724
chr5:62837097-62843225	chr5	62837097	62843225	6128	62840648
chr5:62863148-62869300	chr5	62863148	62869300	6152	62866711
chr5:63090181-63094755	chr5	63090181	63094755	4574	63093880
chr5:63336393-63337375	chr5	63336393	63337375	982	63337319
chr5:63488541-63492238	chr5	63488541	63492238	3697	63489659
chr5:63581796-63587933	chr5	63581796	63587933	6137	63585346
chr5:63628811-63629863	chr5	63628811	63629863	1052	63629502
chr5:63971758-63973811	chr5	63971758	63973811	2053	63973102
chr5:64087186-64093327	chr5	64087186	64093327	6141	64090745
chr5:64100913-64105180	chr5	64100913	64105180	4267	64102593
chr5:64242797-64249265	chr5	64242797	64249265	6468	64246685
chr5:64470925-64473299	chr5	64470925	64473299	2374	64472635
chr5:64477092-64483253	chr5	64477092	64483253	6161	64480668
chr5:65164017-65170048	chr5	65164017	65170048	6031	65167457
chr5:65370262-65376273	chr5	65370262	65376273	6011	65373682
chr5:65407826-65409922	chr5	65407826	65409922	2096	65409572
chr5:65676340-65679340	chr5	65676340	65679340	3000	65677412
chr5:66105953-66112079	chr5	66105953	66112079	6126	66109517
chr5:66750283-66754219	chr5	66750283	66754219	3936	66753725
chr5:67703676-67708855	chr5	67703676	67708855	5179	67707234
chr5:67757565-67763694	chr5	67757565	67763694	6129	67761109
chr5:67817944-67823959	chr5	67817944	67823959	6015	67821370
chr5:67889604-67895628	chr5	67889604	67895628	6024	67893037
chr5:68061272-68065833	chr5	68061272	68065833	4561	68063252
chr5:68102236-68106325	chr5	68102236	68106325	4089	68105804
chr5:68691640-68697661	chr5	68691640	68697661	6021	68695141
chr5:71760573-71762282	chr5	71760573	71762282	1709	71761062
chr5:71851115-71854174	chr5	71851115	71854174	3059	71851584
chr5:72052136-72055103	chr5	72052136	72055103	2967	72052521
chr5:72577317-72583458	chr5	72577317	72583458	6141	72580869
chr5:72727638-72733734	chr5	72727638	72733734	6096	72731166
chr5:74706305-74712443	chr5	74706305	74712443	6138	74709861
chr5:75131334-75137172	chr5	75131334	75137172	5838	75134588
chr5:75172405-75175390	chr5	75172405	75175390	2985	75172811
chr5:75175748-75182091	chr5	75175748	75182091	6343	75179308
chr5:75642235-75648286	chr5	75642235	75648286	6051	75645673
chr5:75695698-75701728	chr5	75695698	75701728	6030	75699142
chr5:75819737-75822763	chr5	75819737	75822763	3026	75820218
chr5:75967208-75973335	chr5	75967208	75973335	6127	75970748
chr5:76122560-76123680	chr5	76122560	76123680	1120	76123301
chr5:77444895-77447887	chr5	77444895	77447887	2992	77445352
chr5:77469670-77474447	chr5	77469670	77474447	4777	77471852
chr5:77474802-77480837	chr5	77474802	77480837	6035	77478249
chr5:77500904-77507049	chr5	77500904	77507049	6145	77504448
chr5:77608675-77614811	chr5	77608675	77614811	6136	77612216
chr5:78118215-78124355	chr5	78118215	78124355	6140	78121769
chr5:78681963-78688078	chr5	78681963	78688078	6115	78685512
chr5:78709758-78715893	chr5	78709758	78715893	6135	78713308
chr5:78860356-78863769	chr5	78860356	78863769	3413	78861186
chr5:78866805-78872828	chr5	78866805	78872828	6023	78870238
chr5:79902294-79908448	chr5	79902294	79908448	6154	79905863
chr5:80314588-80315009	chr5	80314588	80315009	421	80314721
chr5:80428091-80433594	chr5	80428091	80433594	5503	80431012
chr5:80528744-80532378	chr5	80528744	80532378	3634	80529811
chr5:81028683-81034148	chr5	81028683	81034148	5465	81032223
chr5:81259730-81263311	chr5	81259730	81263311	3581	81260789
chr5:81277264-81282797	chr5	81277264	81282797	5533	81280204
chr5:81373066-81379492	chr5	81373066	81379492	6426	81376913
chr5:81591849-81598022	chr5	81591849	81598022	6173	81595415
chr5:81616090-81622140	chr5	81616090	81622140	6050	81619528
chr5:81933730-81934581	chr5	81933730	81934581	851	81933811
chr5:82932443-82938460	chr5	82932443	82938460	6017	82935876
chr5:82944071-82949420	chr5	82944071	82949420	5349	82947584
chr5:83316287-83320401	chr5	83316287	83320401	4114	83317778
chr5:84050337-84056479	chr5	84050337	84056479	6142	84053882
chr5:85431193-85437588	chr5	85431193	85437588	6395	85435017
chr5:85638451-85644538	chr5	85638451	85644538	6087	85641917
chr5:85794029-85797343	chr5	85794029	85797343	3314	85794831
chr5:86060087-86062733	chr5	86060087	86062733	2646	86060171
chr5:86510690-86516743	chr5	86510690	86516743	6053	86514128
chr5:87084421-87090565	chr5	87084421	87090565	6144	87087974
chr5:87472335-87478717	chr5	87472335	87478717	6382	87476119
chr5:87516126-87519086	chr5	87516126	87519086	2960	87516491
chr5:88052330-88058345	chr5	88052330	88058345	6015	88055767
chr5:88119937-88125587	chr5	88119937	88125587	5650	88123800
chr5:88305753-88310434	chr5	88305753	88310434	4681	88309304
chr5:88586164-88592819	chr5	88586164	88592819	6655	88590179
chr5:89161341-89165214	chr5	89161341	89165214	3873	89162397
chr5:89219912-89224332	chr5	89219912	89224332	4420	89223505
chr5:89621547-89627683	chr5	89621547	89627683	6136	89625094
chr5:89803209-89807039	chr5	89803209	89807039	3830	89804468
chr5:90031169-90037663	chr5	90031169	90037663	6494	90035076
chr5:90061984-90065510	chr5	90061984	90065510	3526	90062918
chr5:90073229-90079236	chr5	90073229	90079236	6007	90076657
chr5:90146770-90152885	chr5	90146770	90152885	6115	90150306
chr5:90208335-90214368	chr5	90208335	90214368	6033	90211766
chr5:90238824-90244365	chr5	90238824	90244365	5541	90241795
chr5:90794684-90801080	chr5	90794684	90801080	6396	90798500
chr5:90969739-90975866	chr5	90969739	90975866	6127	90973276
chr5:91555392-91561533	chr5	91555392	91561533	6141	91558945
chr5:91762133-91768161	chr5	91762133	91768161	6028	91765574
chr5:92273859-92275438	chr5	92273859	92275438	1579	92274744
chr5:93213145-93219176	chr5	93213145	93219176	6031	93216583
chr5:93261035-93267065	chr5	93261035	93267065	6030	93264477
chr5:93339324-93339744	chr5	93339324	93339744	420	93339467
chr5:93442075-93448205	chr5	93442075	93448205	6130	93445624
chr5:93486272-93489251	chr5	93486272	93489251	2979	93486670
chr5:93522544-93529042	chr5	93522544	93529042	6498	93526419
chr5:94583052-94589169	chr5	94583052	94589169	6117	94586616
chr5:94954969-94961426	chr5	94954969	94961426	6457	94958843
chr5:95211936-95215021	chr5	95211936	95215021	3085	95212437
chr5:95337631-95341730	chr5	95337631	95341730	4099	95339753
chr5:96549426-96555239	chr5	96549426	96555239	5813	96552984
chr5:97991313-97997456	chr5	97991313	97997456	6143	97994880
chr5:98024748-98029060	chr5	98024748	98029060	4312	98026473
chr5:98113450-98119596	chr5	98113450	98119596	6146	98117002
chr5:98121032-98127557	chr5	98121032	98127557	6525	98124956
chr5:98135476-98140955	chr5	98135476	98140955	5479	98138389
chr5:98222621-98225093	chr5	98222621	98225093	2472	98223318
chr5:98342992-98349146	chr5	98342992	98349146	6154	98346557
chr5:98546665-98552701	chr5	98546665	98552701	6036	98550110
chr5:98681871-98685301	chr5	98681871	98685301	3430	98683365
chr5:99037313-99043760	chr5	99037313	99043760	6447	99041195
chr5:99146176-99152358	chr5	99146176	99152358	6182	99149783
chr5:99855982-99861195	chr5	99855982	99861195	5213	99859355
chr5:100699905-100705798	chr5	100699905	100705798	5893	100703248
chr5:101162855-101168997	chr5	101162855	101168997	6142	101166417
chr5:101180130-101186147	chr5	101180130	101186147	6017	101183571
chr5:101442058-101448195	chr5	101442058	101448195	6137	101445607
chr5:101553933-101557714	chr5	101553933	101557714	3781	101555129
chr5:101795951-101796097	chr5	101795951	101796097	146	101796014
chr5:101921074-101924820	chr5	101921074	101924820	3746	101922231
chr5:102020511-102024812	chr5	102020511	102024812	4301	102022213
chr5:102131356-102137385	chr5	102131356	102137385	6029	102134796
chr5:102162952-102167112	chr5	102162952	102167112	4160	102164530
chr5:102189483-102194435	chr5	102189483	102194435	4952	102192921
chr5:102351319-102356523	chr5	102351319	102356523	5204	102354870
chr5:102671229-102677260	chr5	102671229	102677260	6031	102674662
chr5:103046752-103052769	chr5	103046752	103052769	6017	103050178
chr5:104191037-104193828	chr5	104191037	104193828	2791	104191244
chr5:104359588-104360586	chr5	104359588	104360586	998	104359919
chr5:104518587-104524616	chr5	104518587	104524616	6029	104522025
chr5:104717819-104723241	chr5	104717819	104723241	5422	104720650
chr5:105198497-105203942	chr5	105198497	105203942	5445	105201378
chr5:105600856-105602605	chr5	105600856	105602605	1749	105601169
chr5:106695232-106696735	chr5	106695232	106696735	1503	106695679
chr5:106839898-106842707	chr5	106839898	106842707	2809	106842303
chr5:107718970-107723038	chr5	107718970	107723038	4068	107722821
chr5:108049428-108051694	chr5	108049428	108051694	2266	108051160
chr5:108402770-108405696	chr5	108402770	108405696	2926	108403136
chr5:108436972-108441277	chr5	108436972	108441277	4305	108440740
chr5:108491419-108496559	chr5	108491419	108496559	5140	108493980
chr5:109000432-109003626	chr5	109000432	109003626	3194	109001078
chr5:109259387-109265418	chr5	109259387	109265418	6031	109262826
chr5:109289217-109295634	chr5	109289217	109295634	6417	109294100
chr5:109457256-109463390	chr5	109457256	109463390	6134	109460811
chr5:109538803-109544134	chr5	109538803	109544134	5331	109541574
chr5:110187964-110188977	chr5	110187964	110188977	1013	110188221
chr5:110596131-110599024	chr5	110596131	110599024	2893	110596438
chr5:110599022-110603300	chr5	110599022	110603300	4278	110600735
chr5:110668593-110670581	chr5	110668593	110670581	1988	110669555
chr5:110692314-110698450	chr5	110692314	110698450	6136	110695876
chr5:110774613-110778728	chr5	110774613	110778728	4115	110776136
chr5:110933986-110940119	chr5	110933986	110940119	6133	110937541
chr5:110985740-110991743	chr5	110985740	110991743	6003	110989161
chr5:111302238-111308262	chr5	111302238	111308262	6024	111305671
chr5:111880838-111887009	chr5	111880838	111887009	6171	111884398
chr5:112390080-112396257	chr5	112390080	112396257	6177	112393664
chr5:112503295-112509622	chr5	112503295	112509622	6327	112507107
chr5:112538668-112545103	chr5	112538668	112545103	6435	112542537
chr5:113076150-113080825	chr5	113076150	113080825	4675	113078229
chr5:113818987-113821987	chr5	113818987	113821987	3000	113819398
chr5:114598033-114602925	chr5	114598033	114602925	4892	114601551
chr5:114670871-114676900	chr5	114670871	114676900	6029	114674309
chr5:114876416-114882391	chr5	114876416	114882391	5975	114879804
chr5:115059342-115062361	chr5	115059342	115062361	3019	115059773
chr5:115117313-115123392	chr5	115117313	115123392	6079	115120818
chr5:115410306-115413718	chr5	115410306	115413718	3412	115411142
chr5:115674518-115680703	chr5	115674518	115680703	6185	115678113
chr5:116166484-116171982	chr5	116166484	116171982	5498	116169422
chr5:118382971-118389064	chr5	118382971	118389064	6093	118386531
chr5:118764410-118767579	chr5	118764410	118767579	3169	118764999
chr5:118971108-118972882	chr5	118971108	118972882	1774	118972549
chr5:118975713-118978723	chr5	118975713	118978723	3010	118976760
chr5:119439179-119445196	chr5	119439179	119445196	6017	119442609
chr5:120273525-120275333	chr5	120273525	120275333	1808	120274644
chr5:120282495-120284367	chr5	120282495	120284367	1872	120283936
chr5:120831425-120836963	chr5	120831425	120836963	5538	120834991
chr5:121064235-121070241	chr5	121064235	121070241	6006	121067649
chr5:121557043-121558819	chr5	121557043	121558819	1776	121558503
chr5:121672461-121675332	chr5	121672461	121675332	2871	121672740
chr5:121994959-121998676	chr5	121994959	121998676	3717	121996087
chr5:122205038-122210553	chr5	122205038	122210553	5515	122207974
chr5:122240435-122244924	chr5	122240435	122244924	4489	122242333
chr5:124213171-124219314	chr5	124213171	124219314	6143	124216729
chr5:124358252-124364401	chr5	124358252	124364401	6149	124361813
chr5:124423155-124429275	chr5	124423155	124429275	6120	124426710
chr5:124914330-124917323	chr5	124914330	124917323	2993	124914753
chr5:125160391-125166850	chr5	125160391	125166850	6459	125164262
chr5:125568446-125571370	chr5	125568446	125571370	2924	125569768
chr5:125732409-125736452	chr5	125732409	125736452	4043	125733861
chr5:126171639-126177995	chr5	126171639	126177995	6356	126175424
chr5:126291919-126296623	chr5	126291919	126296623	4704	126294054
chr5:127197142-127203292	chr5	127197142	127203292	6150	127200711
chr5:127729197-127733007	chr5	127729197	127733007	3810	127730446
chr5:128267817-128269132	chr5	128267817	128269132	1315	128268449
chr5:128729399-128731283	chr5	128729399	128731283	1884	128729515
chr5:129210059-129213191	chr5	129210059	129213191	3132	129210641
chr5:129310765-129313644	chr5	129310765	129313644	2879	129311074
chr5:129534289-129537074	chr5	129534289	129537074	2785	129534497
chr5:129612395-129615249	chr5	129612395	129615249	2854	129614110
chr5:129816908-129819630	chr5	129816908	129819630	2722	129817057
chr5:130086536-130089382	chr5	130086536	130089382	2846	130086791
chr5:130308396-130309791	chr5	130308396	130309791	1395	130309280
chr5:130391694-130395000	chr5	130391694	130395000	3306	130392420
chr5:130418835-130421744	chr5	130418835	130421744	2909	130419193
chr5:130522811-130526138	chr5	130522811	130526138	3327	130523558
chr5:130565424-130568020	chr5	130565424	130568020	2596	130565444
chr5:130608850-130613130	chr5	130608850	130613130	4280	130610583
chr5:130619932-130623189	chr5	130619932	130623189	3257	130620599
chr5:130732094-130738109	chr5	130732094	130738109	6015	130735533
chr5:130783490-130789657	chr5	130783490	130789657	6167	130787074
chr5:130817737-130823763	chr5	130817737	130823763	6026	130821173
chr5:130897566-130903669	chr5	130897566	130903669	6103	130901105
chr5:130925450-130929696	chr5	130925450	130929696	4246	130927123
chr5:130929701-130935182	chr5	130929701	130935182	5481	130932625
chr5:131049693-131052414	chr5	131049693	131052414	2721	131049799
chr5:131087154-131093315	chr5	131087154	131093315	6161	131090709
chr5:131344051-131349149	chr5	131344051	131349149	5098	131347573
chr5:131871013-131877156	chr5	131871013	131877156	6143	131874569
chr5:132106695-132109488	chr5	132106695	132109488	2793	132106916
chr5:132116480-132122838	chr5	132116480	132122838	6358	132120252
chr5:132158758-132162521	chr5	132158758	132162521	3763	132159930
chr5:132397846-132403147	chr5	132397846	132403147	5301	132401665
chr5:132513964-132519996	chr5	132513964	132519996	6032	132517404
chr5:132605681-132607057	chr5	132605681	132607057	1376	132606543
chr5:133583288-133589299	chr5	133583288	133589299	6011	133586707
chr5:133629307-133632158	chr5	133629307	133632158	2851	133629570
chr5:136289171-136295299	chr5	136289171	136295299	6128	136292718
chr5:137526014-137529826	chr5	137526014	137529826	3812	137527239
chr5:137539131-137543420	chr5	137539131	137543420	4289	137540851
chr5:137548162-137549288	chr5	137548162	137549288	1126	137549222
chr5:137783369-137789095	chr5	137783369	137789095	5726	137786511
chr5:137968595-137974622	chr5	137968595	137974622	6027	137972036
chr5:140452034-140457861	chr5	140452034	140457861	5827	140455288
chr5:140515514-140520942	chr5	140515514	140520942	5428	140518362
chr5:142042644-142044798	chr5	142042644	142044798	2154	142043433
chr5:143852080-143858214	chr5	143852080	143858214	6134	143855631
chr5:144713276-144718081	chr5	144713276	144718081	4805	144715490
chr5:144883765-144886394	chr5	144883765	144886394	2629	144883835
chr5:144907728-144911709	chr5	144907728	144911709	3981	144909109
chr5:144996302-144997428	chr5	144996302	144997428	1126	144996579
chr5:145149736-145153261	chr5	145149736	145153261	3525	145150676
chr5:145650781-145656911	chr5	145650781	145656911	6130	145654322
chr5:145745882-145750105	chr5	145745882	145750105	4223	145747600
chr5:145877760-145883184	chr5	145877760	145883184	5424	145880607
chr5:145893254-145897247	chr5	145893254	145897247	3993	145894707
chr5:146609485-146615534	chr5	146609485	146615534	6049	146612923
chr5:148022390-148024630	chr5	148022390	148024630	2240	148023521
chr5:148230602-148236590	chr5	148230602	148236590	5988	148234043
chr5:148254214-148254985	chr5	148254214	148254985	771	148254504
chr5:148502084-148507534	chr5	148502084	148507534	5450	148505067
chr5:148610279-148615691	chr5	148610279	148615691	5412	148613104
chr5:148942273-148948290	chr5	148942273	148948290	6017	148945700
chr5:149076438-149079327	chr5	149076438	149079327	2889	149076739
chr5:150742837-150748950	chr5	150742837	150748950	6113	150746362
chr5:150964139-150970275	chr5	150964139	150970275	6136	150967689
chr5:151835055-151837952	chr5	151835055	151837952	2897	151835347
chr5:151988907-151995040	chr5	151988907	151995040	6133	151992459
chr5:152076868-152082891	chr5	152076868	152082891	6023	152080277
chr5:152207300-152213333	chr5	152207300	152213333	6033	152210741
chr5:152586851-152592411	chr5	152586851	152592411	5560	152589926
chr5:152740936-152746968	chr5	152740936	152746968	6032	152744376
chr5:152751675-152757243	chr5	152751675	152757243	5568	152755520
chr5:152787609-152793677	chr5	152787609	152793677	6068	152791113
chr5:153181131-153183868	chr5	153181131	153183868	2737	153181288
chr5:153283015-153289081	chr5	153283015	153289081	6066	153286521
chr5:153325326-153331330	chr5	153325326	153331330	6004	153328751
chr5:153381391-153387536	chr5	153381391	153387536	6145	153384948
chr5:153723252-153729397	chr5	153723252	153729397	6145	153726810
chr5:155168337-155174487	chr5	155168337	155174487	6150	155171908
chr5:155224277-155227288	chr5	155224277	155227288	3011	155224703
chr5:155657061-155661521	chr5	155657061	155661521	4460	155658930
chr5:156519376-156520736	chr5	156519376	156520736	1360	156519442
chr5:156784925-156788942	chr5	156784925	156788942	4017	156786366
chr5:156789003-156791623	chr5	156789003	156791623	2620	156789052
chr5:156808026-156810127	chr5	156808026	156810127	2101	156809726
chr5:156984145-156988875	chr5	156984145	156988875	4730	156987989
chr5:157424361-157430466	chr5	157424361	157430466	6105	157427876
chr5:157436836-157440015	chr5	157436836	157440015	3179	157437064
chr5:157662907-157665609	chr5	157662907	157665609	2702	157663026
chr5:157720950-157727128	chr5	157720950	157727128	6178	157724527
chr5:158183139-158187742	chr5	158183139	158187742	4603	158185152
chr5:159139547-159145699	chr5	159139547	159145699	6152	159143099
chr5:159500239-159503104	chr5	159500239	159503104	2865	159500517
chr5:160592426-160598550	chr5	160592426	160598550	6124	160595966
chr5:160813008-160819890	chr5	160813008	160819890	6882	160816576
chr5:160873524-160879549	chr5	160873524	160879549	6025	160876959
chr5:161071357-161077370	chr5	161071357	161077370	6013	161074785
chr5:162477993-162479628	chr5	162477993	162479628	1635	162478086
chr5:162733034-162737549	chr5	162733034	162737549	4515	162734969
chr5:162845997-162851437	chr5	162845997	162851437	5440	162848851
chr5:163212183-163218127	chr5	163212183	163218127	5944	163215537
chr5:163237197-163239960	chr5	163237197	163239960	2763	163239720
chr5:163932525-163937515	chr5	163932525	163937515	4990	163936414
chr5:164121978-164123692	chr5	164121978	164123692	1714	164122075
chr5:164536793-164539516	chr5	164536793	164539516	2723	164536921
chr5:168630703-168637033	chr5	168630703	168637033	6330	168633522
chr5:169509050-169510564	chr5	169509050	169510564	1514	169509385
chr5:169620871-169623191	chr5	169620871	169623191	2320	169622460
chr5:169819644-169825775	chr5	169819644	169825775	6131	169823194
chr5:170966003-170967079	chr5	170966003	170967079	1076	170966117
chr5:174465904-174472053	chr5	174465904	174472053	6149	174469471
chr5:175397769-175403801	chr5	175397769	175403801	6032	175401209
chr5:175720001-175723036	chr5	175720001	175723036	3035	175720450
chr5:176051757-176057881	chr5	176051757	176057881	6124	176055305
chr5:176282585-176287631	chr5	176282585	176287631	5046	176285061
chr5:177753850-177759969	chr5	177753850	177759969	6119	177757401
chr5:177772245-177778274	chr5	177772245	177778274	6029	177775685
chr5:179101069-179107079	chr5	179101069	179107079	6010	179104503
chr5:180889405-180895846	chr5	180889405	180895846	6441	180893269
chr5:180926023-180932355	chr5	180926023	180932355	6332	180929888
chr5:181010153-181012366	chr5	181010153	181012366	2213	181011588
chr5_GL000208v1_random:65276-71304	chr5_GL000208v1_random	65276	71304	6028	68720
chr5_GL339449v2_alt:452014-454872	chr5_GL339449v2_alt	452014	454872	2858	452919
chr5_GL383530v1_alt:6526-7745	chr5_GL383530v1_alt	6526	7745	1219	7512
chr5_GL383531v1_alt:9974-15994	chr5_GL383531v1_alt	9974	15994	6020	13396
chr5_GL383531v1_alt:81461-85222	chr5_GL383531v1_alt	81461	85222	3761	82632
chr5_KI270794v1_alt:62471-65452	chr5_KI270794v1_alt	62471	65452	2981	63934
chr6:64898-66698	chr6	64898	66698	1800	65151
chr6:96114-102539	chr6	96114	102539	6425	99993
chr6:158866-159985	chr6	158866	159985	1119	159297
chr6:849734-850922	chr6	849734	850922	1188	849807
chr6:1751790-1756172	chr6	1751790	1756172	4382	1754453
chr6:1977479-1982022	chr6	1977479	1982022	4543	1981595
chr6:2049726-2050869	chr6	2049726	2050869	1143	2050452
chr6:2064967-2070431	chr6	2064967	2070431	5464	2067839
chr6:2288652-2292695	chr6	2288652	2292695	4043	2290110
chr6:2299836-2303022	chr6	2299836	2303022	3186	2300419
chr6:4228891-4235110	chr6	4228891	4235110	6219	4232552
chr6:4405353-4411105	chr6	4405353	4411105	5752	4409311
chr6:6211664-6217690	chr6	6211664	6217690	6026	6215104
chr6:6426599-6430223	chr6	6426599	6430223	3624	6427638
chr6:6668154-6672990	chr6	6668154	6672990	4836	6671736
chr6:7925704-7931830	chr6	7925704	7931830	6126	7929258
chr6:8586005-8588283	chr6	8586005	8588283	2278	8588079
chr6:9217578-9220610	chr6	9217578	9220610	3032	9218001
chr6:9443747-9449876	chr6	9443747	9449876	6129	9447292
chr6:9683582-9687801	chr6	9683582	9687801	4219	9685209
chr6:9810750-9816777	chr6	9810750	9816777	6027	9814190
chr6:9882323-9888448	chr6	9882323	9888448	6125	9885873
chr6:11298870-11304963	chr6	11298870	11304963	6093	11302440
chr6:11451809-11457954	chr6	11451809	11457954	6145	11455388
chr6:11836894-11843346	chr6	11836894	11843346	6452	11840766
chr6:12139362-12145531	chr6	12139362	12145531	6169	12142958
chr6:12549192-12555347	chr6	12549192	12555347	6155	12552768
chr6:14479992-14486139	chr6	14479992	14486139	6147	14483546
chr6:17076599-17079917	chr6	17076599	17079917	3318	17077330
chr6:18228389-18234361	chr6	18228389	18234361	5972	18231788
chr6:19130078-19132859	chr6	19130078	19132859	2781	19130272
chr6:19220828-19226980	chr6	19220828	19226980	6152	19224399
chr6:19238625-19244619	chr6	19238625	19244619	5994	19242255
chr6:19246948-19253092	chr6	19246948	19253092	6144	19250506
chr6:19481741-19487890	chr6	19481741	19487890	6149	19485301
chr6:19620601-19624491	chr6	19620601	19624491	3890	19621952
chr6:19764892-19770918	chr6	19764892	19770918	6026	19768326
chr6:23060666-23064975	chr6	23060666	23064975	4309	23062389
chr6:23234981-23235987	chr6	23234981	23235987	1006	23235644
chr6:23804047-23810075	chr6	23804047	23810075	6028	23807487
chr6:23817814-23821624	chr6	23817814	23821624	3810	23819038
chr6:24082846-24089001	chr6	24082846	24089001	6155	24086413
chr6:25158197-25164309	chr6	25158197	25164309	6112	25161742
chr6:25206953-25213372	chr6	25206953	25213372	6419	25210801
chr6:27008401-27014570	chr6	27008401	27014570	6169	27011988
chr6:28020757-28026912	chr6	28020757	28026912	6155	28024325
chr6:28621243-28627390	chr6	28621243	28627390	6147	28624804
chr6:28850217-28854923	chr6	28850217	28854923	4706	28852342
chr6:29156253-29156612	chr6	29156253	29156612	359	29156475
chr6:29273448-29279597	chr6	29273448	29279597	6149	29277009
chr6:29359515-29364516	chr6	29359515	29364516	5001	29363374
chr6:29779787-29785823	chr6	29779787	29785823	6036	29783317
chr6:30247968-30253370	chr6	30247968	30253370	5402	30250798
chr6:30430280-30436430	chr6	30430280	30436430	6150	30433847
chr6:32282077-32284822	chr6	32282077	32284822	2745	32282242
chr6:35331964-35336436	chr6	35331964	35336436	4472	35335521
chr6:36083044-36088440	chr6	36083044	36088440	5396	36086717
chr6:39454557-39460534	chr6	39454557	39460534	5977	39457945
chr6:39533018-39539230	chr6	39533018	39539230	6212	39536639
chr6:39736405-39742567	chr6	39736405	39742567	6162	39739962
chr6:41243578-41247070	chr6	41243578	41247070	3492	41244483
chr6:44747462-44753585	chr6	44747462	44753585	6123	44750997
chr6:44870634-44876665	chr6	44870634	44876665	6031	44874074
chr6:44878624-44884626	chr6	44878624	44884626	6002	44882459
chr6:44884629-44890777	chr6	44884629	44890777	6148	44888189
chr6:44900043-44906175	chr6	44900043	44906175	6132	44903605
chr6:45062447-45068476	chr6	45062447	45068476	6029	45065884
chr6:45176061-45181869	chr6	45176061	45181869	5808	45179302
chr6:45281107-45287253	chr6	45281107	45287253	6146	45284668
chr6:46119457-46125580	chr6	46119457	46125580	6123	46123005
chr6:47189202-47192142	chr6	47189202	47192142	2940	47189552
chr6:47211627-47216220	chr6	47211627	47216220	4593	47213616
chr6:47218680-47219984	chr6	47218680	47219984	1304	47219381
chr6:47270102-47275668	chr6	47270102	47275668	5566	47273088
chr6:47327837-47333990	chr6	47327837	47333990	6153	47331408
chr6:48102475-48108615	chr6	48102475	48108615	6140	48106025
chr6:48363090-48369117	chr6	48363090	48369117	6027	48366530
chr6:48493600-48496723	chr6	48493600	48496723	3123	48494134
chr6:48682212-48686019	chr6	48682212	48686019	3807	48683537
chr6:48737348-48743377	chr6	48737348	48743377	6029	48740784
chr6:49058228-49063798	chr6	49058228	49063798	5570	49061210
chr6:49276510-49281918	chr6	49276510	49281918	5408	49279336
chr6:49386880-49392906	chr6	49386880	49392906	6026	49390315
chr6:49473414-49477579	chr6	49473414	49477579	4165	49475081
chr6:49598556-49604673	chr6	49598556	49604673	6117	49602092
chr6:49670513-49673484	chr6	49670513	49673484	2971	49670901
chr6:50477537-50483641	chr6	50477537	50483641	6104	50481068
chr6:50619864-50626003	chr6	50619864	50626003	6139	50623414
chr6:51121435-51127584	chr6	51121435	51127584	6149	51125000
chr6:51224349-51230496	chr6	51224349	51230496	6147	51227914
chr6:51874783-51880802	chr6	51874783	51880802	6019	51878189
chr6:51895656-51901683	chr6	51895656	51901683	6027	51899090
chr6:52862954-52866520	chr6	52862954	52866520	3566	52864686
chr6:53386015-53389196	chr6	53386015	53389196	3181	53386609
chr6:53487492-53490916	chr6	53487492	53490916	3424	53488331
chr6:53774041-53780171	chr6	53774041	53780171	6130	53777587
chr6:54530000-54531824	chr6	54530000	54531824	1824	54531037
chr6:54555644-54558565	chr6	54555644	54558565	2921	54556018
chr6:54672223-54674017	chr6	54672223	54674017	1794	54673256
chr6:54961429-54967437	chr6	54961429	54967437	6008	54964862
chr6:55089864-55095183	chr6	55089864	55095183	5319	55092600
chr6:55587345-55590617	chr6	55587345	55590617	3272	55588980
chr6:55648288-55649013	chr6	55648288	55649013	725	55648790
chr6:55684657-55690687	chr6	55684657	55690687	6030	55688097
chr6:55735539-55741711	chr6	55735539	55741711	6172	55739091
chr6:57287804-57293981	chr6	57287804	57293981	6177	57291421
chr6:57334868-57340871	chr6	57334868	57340871	6003	57338282
chr6:57700427-57706542	chr6	57700427	57706542	6115	57703974
chr6:58211281-58213966	chr6	58211281	58213966	2685	58211382
chr6:58275917-58279430	chr6	58275917	58279430	3513	58276852
chr6:58316168-58322561	chr6	58316168	58322561	6393	58319982
chr6:58393798-58399940	chr6	58393798	58399940	6142	58397359
chr6:60599849-60605969	chr6	60599849	60605969	6120	60603390
chr6:61026011-61028884	chr6	61026011	61028884	2873	61026304
chr6:61093349-61097832	chr6	61093349	61097832	4483	61095245
chr6:61137315-61139243	chr6	61137315	61139243	1928	61138239
chr6:61183879-61189612	chr6	61183879	61189612	5733	61187030
chr6:61270619-61274496	chr6	61270619	61274496	3877	61271919
chr6:61520739-61525395	chr6	61520739	61525395	4656	61522817
chr6:61723584-61728467	chr6	61723584	61728467	4883	61725876
chr6:61774594-61777298	chr6	61774594	61777298	2704	61774715
chr6:62003450-62005007	chr6	62003450	62005007	1557	62004584
chr6:62062024-62065796	chr6	62062024	62065796	3772	62063203
chr6:62197647-62201243	chr6	62197647	62201243	3596	62198660
chr6:62312040-62318195	chr6	62312040	62318195	6155	62315613
chr6:62416571-62419293	chr6	62416571	62419293	2722	62416723
chr6:62551770-62555013	chr6	62551770	62555013	3243	62552132
chr6:62555452-62559738	chr6	62555452	62559738	4286	62557147
chr6:63166987-63173109	chr6	63166987	63173109	6122	63170535
chr6:63362245-63368134	chr6	63362245	63368134	5889	63365511
chr6:63405630-63408860	chr6	63405630	63408860	3230	63407103
chr6:63829109-63835214	chr6	63829109	63835214	6105	63832640
chr6:63852183-63853948	chr6	63852183	63853948	1765	63852556
chr6:63887362-63893726	chr6	63887362	63893726	6364	63891162
chr6:64235787-64236140	chr6	64235787	64236140	353	64235897
chr6:64311577-64318183	chr6	64311577	64318183	6606	64315340
chr6:64342249-64346712	chr6	64342249	64346712	4463	64344131
chr6:64389760-64395796	chr6	64389760	64395796	6036	64393205
chr6:64447991-64454020	chr6	64447991	64454020	6029	64451433
chr6:64544526-64546925	chr6	64544526	64546925	2399	64544944
chr6:64569759-64574421	chr6	64569759	64574421	4662	64571850
chr6:64658799-64662390	chr6	64658799	64662390	3591	64659810
chr6:65178454-65182208	chr6	65178454	65182208	3754	65179630
chr6:65374085-65378023	chr6	65374085	65378023	3938	65377978
chr6:65512548-65515951	chr6	65512548	65515951	3403	65513364
chr6:65865406-65868007	chr6	65865406	65868007	2601	65865422
chr6:65971283-65977148	chr6	65971283	65977148	5865	65974558
chr6:66248084-66250994	chr6	66248084	66250994	2910	66248432
chr6:66424653-66427630	chr6	66424653	66427630	2977	66425053
chr6:66488944-66495154	chr6	66488944	66495154	6210	66492604
chr6:66540927-66547077	chr6	66540927	66547077	6150	66544477
chr6:66591978-66592228	chr6	66591978	66592228	250	66592074
chr6:66630834-66636983	chr6	66630834	66636983	6149	66634396
chr6:66842028-66844366	chr6	66842028	66844366	2338	66843273
chr6:67095414-67101549	chr6	67095414	67101549	6135	67098971
chr6:68283873-68290045	chr6	68283873	68290045	6172	68287470
chr6:68463895-68464766	chr6	68463895	68464766	871	68464528
chr6:68537621-68539090	chr6	68537621	68539090	1469	68537734
chr6:68602429-68603043	chr6	68602429	68603043	614	68602497
chr6:69133417-69133678	chr6	69133417	69133678	261	69133542
chr6:69480207-69486354	chr6	69480207	69486354	6147	69483762
chr6:69495362-69501385	chr6	69495362	69501385	6023	69498793
chr6:69515143-69521169	chr6	69515143	69521169	6026	69518578
chr6:69560163-69566640	chr6	69560163	69566640	6477	69564046
chr6:70010347-70016552	chr6	70010347	70016552	6205	70013786
chr6:70062397-70066601	chr6	70062397	70066601	4204	70064051
chr6:70317563-70323719	chr6	70317563	70323719	6156	70321130
chr6:70782891-70788469	chr6	70782891	70788469	5578	70785876
chr6:70925175-70931345	chr6	70925175	70931345	6170	70928760
chr6:70935659-70939907	chr6	70935659	70939907	4248	70937326
chr6:70944092-70950217	chr6	70944092	70950217	6125	70947655
chr6:70974172-70980298	chr6	70974172	70980298	6126	70977723
chr6:71141089-71146364	chr6	71141089	71146364	5275	71143773
chr6:71270514-71276665	chr6	71270514	71276665	6151	71274075
chr6:72006343-72012487	chr6	72006343	72012487	6144	72009899
chr6:72469432-72475586	chr6	72469432	72475586	6154	72472997
chr6:72570139-72576167	chr6	72570139	72576167	6028	72573575
chr6:73917512-73923690	chr6	73917512	73923690	6178	73921080
chr6:74119608-74122213	chr6	74119608	74122213	2605	74119812
chr6:74227820-74228893	chr6	74227820	74228893	1073	74228759
chr6:74246644-74248027	chr6	74246644	74248027	1383	74246767
chr6:74400147-74402430	chr6	74400147	74402430	2283	74400733
chr6:74484597-74488786	chr6	74484597	74488786	4189	74487437
chr6:74660015-74666151	chr6	74660015	74666151	6136	74663568
chr6:74903761-74909912	chr6	74903761	74909912	6151	74907327
chr6:75008360-75011226	chr6	75008360	75011226	2866	75008641
chr6:75012967-75018458	chr6	75012967	75018458	5491	75015877
chr6:75570774-75572552	chr6	75570774	75572552	1778	75572483
chr6:76099706-76103537	chr6	76099706	76103537	3831	76100966
chr6:76735334-76738076	chr6	76735334	76738076	2742	76735487
chr6:76958965-76964983	chr6	76958965	76964983	6018	76962408
chr6:77251532-77257669	chr6	77251532	77257669	6137	77255080
chr6:77748837-77754264	chr6	77748837	77754264	5427	77751690
chr6:77862081-77868224	chr6	77862081	77868224	6143	77865653
chr6:77908663-77910693	chr6	77908663	77910693	2030	77909632
chr6:77918986-77920418	chr6	77918986	77920418	1432	77920073
chr6:78068296-78072091	chr6	78068296	78072091	3795	78069506
chr6:78111696-78113352	chr6	78111696	78113352	1656	78112030
chr6:78467208-78473345	chr6	78467208	78473345	6137	78470755
chr6:78646742-78652881	chr6	78646742	78652881	6139	78650290
chr6:78679161-78682455	chr6	78679161	78682455	3294	78679875
chr6:78694312-78700460	chr6	78694312	78700460	6148	78697869
chr6:78758153-78764142	chr6	78758153	78764142	5989	78761688
chr6:78920945-78924807	chr6	78920945	78924807	3862	78924491
chr6:78971515-78977529	chr6	78971515	78977529	6014	78974947
chr6:79284672-79290791	chr6	79284672	79290791	6119	79288225
chr6:79347176-79352933	chr6	79347176	79352933	5757	79350336
chr6:79577656-79583766	chr6	79577656	79583766	6110	79581213
chr6:80612144-80618209	chr6	80612144	80618209	6065	80615632
chr6:80684430-80689353	chr6	80684430	80689353	4923	80686773
chr6:80745556-80750377	chr6	80745556	80750377	4821	80747793
chr6:80800855-80804099	chr6	80800855	80804099	3244	80801900
chr6:80820818-80826145	chr6	80820818	80826145	5327	80823560
chr6:80847739-80853776	chr6	80847739	80853776	6037	80851181
chr6:80918378-80920950	chr6	80918378	80920950	2572	80920077
chr6:81433358-81436998	chr6	81433358	81436998	3640	81436919
chr6:81468849-81474171	chr6	81468849	81474171	5322	81471577
chr6:81578563-81584696	chr6	81578563	81584696	6133	81582112
chr6:81972028-81976207	chr6	81972028	81976207	4179	81973633
chr6:82101303-82107312	chr6	82101303	82107312	6009	82104723
chr6:82152415-82157393	chr6	82152415	82157393	4978	82154814
chr6:82469506-82475649	chr6	82469506	82475649	6143	82473065
chr6:82512321-82518423	chr6	82512321	82518423	6102	82515834
chr6:82558403-82564423	chr6	82558403	82564423	6020	82561836
chr6:82632830-82638205	chr6	82632830	82638205	5375	82635617
chr6:82648153-82651496	chr6	82648153	82651496	3343	82648914
chr6:82852026-82857088	chr6	82852026	82857088	5062	82854498
chr6:83333952-83339981	chr6	83333952	83339981	6029	83337391
chr6:83942178-83948514	chr6	83942178	83948514	6336	83945997
chr6:84179670-84181499	chr6	84179670	84181499	1829	84179918
chr6:84204236-84207726	chr6	84204236	84207726	3490	84205148
chr6:84602211-84604963	chr6	84602211	84604963	2752	84602383
chr6:84608436-84614463	chr6	84608436	84614463	6027	84611875
chr6:84626355-84632366	chr6	84626355	84632366	6011	84629778
chr6:84699337-84705492	chr6	84699337	84705492	6155	84702908
chr6:84935930-84942132	chr6	84935930	84942132	6202	84939564
chr6:84981464-84986017	chr6	84981464	84986017	4553	84983618
chr6:84990974-84993648	chr6	84990974	84993648	2674	84991204
chr6:85202003-85208119	chr6	85202003	85208119	6116	85205562
chr6:85213639-85217961	chr6	85213639	85217961	4322	85215374
chr6:85307045-85313201	chr6	85307045	85313201	6156	85310613
chr6:85366966-85368407	chr6	85366966	85368407	1441	85367986
chr6:85582430-85585394	chr6	85582430	85585394	2964	85582846
chr6:85815945-85822083	chr6	85815945	85822083	6138	85819495
chr6:86006624-86008944	chr6	86006624	86008944	2320	86008445
chr6:86033062-86035921	chr6	86033062	86035921	2859	86033244
chr6:86569573-86575720	chr6	86569573	86575720	6147	86573134
chr6:86646406-86648630	chr6	86646406	86648630	2224	86647346
chr6:86731396-86736491	chr6	86731396	86736491	5095	86734651
chr6:86876364-86879539	chr6	86876364	86879539	3175	86876952
chr6:86897717-86903738	chr6	86897717	86903738	6021	86901148
chr6:86921165-86927317	chr6	86921165	86927317	6152	86924732
chr6:87139685-87145758	chr6	87139685	87145758	6073	87143256
chr6:87303148-87307191	chr6	87303148	87307191	4043	87304599
chr6:88253620-88259773	chr6	88253620	88259773	6153	88257175
chr6:88335709-88339343	chr6	88335709	88339343	3634	88336754
chr6:88353708-88358545	chr6	88353708	88358545	4837	88355944
chr6:88390727-88396876	chr6	88390727	88396876	6149	88394282
chr6:88406498-88412530	chr6	88406498	88412530	6032	88409946
chr6:88433305-88437208	chr6	88433305	88437208	3903	88434616
chr6:88643386-88647026	chr6	88643386	88647026	3640	88644426
chr6:88827088-88833578	chr6	88827088	88833578	6490	88831012
chr6:90030401-90033369	chr6	90030401	90033369	2968	90030778
chr6:90053981-90060141	chr6	90053981	90060141	6160	90057548
chr6:90163927-90167061	chr6	90163927	90167061	3134	90164487
chr6:90562108-90568220	chr6	90562108	90568220	6112	90565637
chr6:90622817-90627750	chr6	90622817	90627750	4933	90626676
chr6:91210988-91211637	chr6	91210988	91211637	649	91211250
chr6:91591714-91594967	chr6	91591714	91594967	3253	91592381
chr6:91959045-91959580	chr6	91959045	91959580	535	91959176
chr6:91973168-91974790	chr6	91973168	91974790	1622	91973653
chr6:92078286-92084443	chr6	92078286	92084443	6157	92081870
chr6:92420759-92424537	chr6	92420759	92424537	3778	92424321
chr6:92626295-92628852	chr6	92626295	92628852	2557	92627914
chr6:92951872-92958015	chr6	92951872	92958015	6143	92955426
chr6:92995182-93001314	chr6	92995182	93001314	6132	92998726
chr6:93032019-93035631	chr6	93032019	93035631	3612	93035581
chr6:93547386-93549008	chr6	93547386	93549008	1622	93548229
chr6:94240307-94243479	chr6	94240307	94243479	3172	94240898
chr6:94511257-94517686	chr6	94511257	94517686	6429	94515134
chr6:94757768-94763915	chr6	94757768	94763915	6147	94761330
chr6:94824163-94830307	chr6	94824163	94830307	6144	94827720
chr6:94851129-94857158	chr6	94851129	94857158	6029	94854566
chr6:94942134-94948159	chr6	94942134	94948159	6025	94945568
chr6:95378102-95380979	chr6	95378102	95380979	2877	95378405
chr6:95471436-95477584	chr6	95471436	95477584	6148	95474986
chr6:95719127-95720649	chr6	95719127	95720649	1522	95720154
chr6:95758386-95764412	chr6	95758386	95764412	6026	95761825
chr6:95817684-95819212	chr6	95817684	95819212	1528	95818063
chr6:95863901-95865392	chr6	95863901	95865392	1491	95864410
chr6:95982394-95983918	chr6	95982394	95983918	1524	95983813
chr6:96191197-96194211	chr6	96191197	96194211	3014	96191655
chr6:96438197-96442764	chr6	96438197	96442764	4567	96440175
chr6:96637755-96643476	chr6	96637755	96643476	5721	96641217
chr6:97737044-97739763	chr6	97737044	97739763	2719	97737167
chr6:97794643-97800532	chr6	97794643	97800532	5889	97798195
chr6:98391592-98394653	chr6	98391592	98394653	3061	98394285
chr6:98411959-98414993	chr6	98411959	98414993	3034	98412426
chr6:98416502-98422520	chr6	98416502	98422520	6018	98419937
chr6:98703059-98708329	chr6	98703059	98708329	5270	98706495
chr6:98763208-98763946	chr6	98763208	98763946	738	98763715
chr6:98910687-98916828	chr6	98910687	98916828	6141	98914240
chr6:99204281-99210436	chr6	99204281	99210436	6155	99207851
chr6:99447524-99453186	chr6	99447524	99453186	5662	99450608
chr6:99655158-99658409	chr6	99655158	99658409	3251	99657433
chr6:99823597-99829594	chr6	99823597	99829594	5997	99827004
chr6:99855904-99860264	chr6	99855904	99860264	4360	99858773
chr6:100030152-100032763	chr6	100030152	100032763	2611	100030169
chr6:100071731-100072475	chr6	100071731	100072475	744	100072025
chr6:100196461-100202490	chr6	100196461	100202490	6029	100199900
chr6:100354703-100360725	chr6	100354703	100360725	6022	100358140
chr6:101062008-101065667	chr6	101062008	101065667	3659	101065572
chr6:101188160-101194082	chr6	101188160	101194082	5922	101191703
chr6:102088197-102094226	chr6	102088197	102094226	6029	102091634
chr6:102169866-102175696	chr6	102169866	102175696	5830	102173106
chr6:102265739-102267278	chr6	102265739	102267278	1539	102266156
chr6:102276587-102277426	chr6	102276587	102277426	839	102276840
chr6:102284306-102287295	chr6	102284306	102287295	2989	102285850
chr6:102722105-102725773	chr6	102722105	102725773	3668	102725544
chr6:103003641-103009026	chr6	103003641	103009026	5385	103006444
chr6:103248222-103253275	chr6	103248222	103253275	5053	103250698
chr6:103316543-103317092	chr6	103316543	103317092	549	103316807
chr6:103524018-103527725	chr6	103524018	103527725	3707	103525462
chr6:103709031-103715056	chr6	103709031	103715056	6025	103712464
chr6:103801842-103807999	chr6	103801842	103807999	6157	103805411
chr6:104088130-104091588	chr6	104088130	104091588	3458	104088995
chr6:104374607-104380755	chr6	104374607	104380755	6148	104378174
chr6:104452399-104457460	chr6	104452399	104457460	5061	104454875
chr6:104489393-104495424	chr6	104489393	104495424	6031	104492832
chr6:104670787-104677213	chr6	104670787	104677213	6426	104674644
chr6:104737315-104743324	chr6	104737315	104743324	6009	104740734
chr6:104756574-104762708	chr6	104756574	104762708	6134	104760122
chr6:104799760-104805872	chr6	104799760	104805872	6112	104803266
chr6:105338423-105344208	chr6	105338423	105344208	5785	105341958
chr6:105415011-105421154	chr6	105415011	105421154	6143	105418583
chr6:105716122-105722275	chr6	105716122	105722275	6153	105719691
chr6:106262563-106269055	chr6	106262563	106269055	6492	106266419
chr6:106404578-106411023	chr6	106404578	106411023	6445	106408446
chr6:108410815-108416935	chr6	108410815	108416935	6120	108414346
chr6:108514249-108518663	chr6	108514249	108518663	4414	108516075
chr6:109133556-109136577	chr6	109133556	109136577	3021	109133986
chr6:109566762-109567563	chr6	109566762	109567563	801	109567504
chr6:109593297-109596015	chr6	109593297	109596015	2718	109593438
chr6:109647210-109651236	chr6	109647210	109651236	4026	109648665
chr6:109651232-109652439	chr6	109651232	109652439	1207	109651978
chr6:109682444-109684592	chr6	109682444	109684592	2148	109682822
chr6:110259003-110265127	chr6	110259003	110265127	6124	110262542
chr6:110904342-110910070	chr6	110904342	110910070	5728	110907855
chr6:111637343-111638302	chr6	111637343	111638302	959	111638175
chr6:112540948-112546067	chr6	112540948	112546067	5119	112544932
chr6:112552513-112553779	chr6	112552513	112553779	1266	112553113
chr6:112703745-112709778	chr6	112703745	112709778	6033	112707180
chr6:112813021-112819047	chr6	112813021	112819047	6026	112816459
chr6:112868991-112872953	chr6	112868991	112872953	3962	112870371
chr6:113226487-113232515	chr6	113226487	113232515	6028	113229925
chr6:113531117-113537147	chr6	113531117	113537147	6030	113534557
chr6:115009066-115014475	chr6	115009066	115014475	5409	115011890
chr6:115081909-115086721	chr6	115081909	115086721	4812	115084141
chr6:115121250-115125215	chr6	115121250	115125215	3965	115124814
chr6:115175227-115181228	chr6	115175227	115181228	6001	115178643
chr6:115222081-115228219	chr6	115222081	115228219	6138	115225636
chr6:115250072-115256240	chr6	115250072	115256240	6168	115253649
chr6:115515840-115522268	chr6	115515840	115522268	6428	115519668
chr6:115644847-115649287	chr6	115644847	115649287	4440	115648722
chr6:115742295-115747145	chr6	115742295	115747145	4850	115744558
chr6:115935054-115941505	chr6	115935054	115941505	6451	115938896
chr6:115960032-115966060	chr6	115960032	115966060	6028	115963471
chr6:116041456-116046791	chr6	116041456	116046791	5335	116044159
chr6:116342691-116348145	chr6	116342691	116348145	5454	116346193
chr6:116638696-116644847	chr6	116638696	116644847	6151	116642260
chr6:116738084-116741007	chr6	116738084	116741007	2923	116738424
chr6:116818563-116822872	chr6	116818563	116822872	4309	116820282
chr6:117102131-117108163	chr6	117102131	117108163	6032	117105571
chr6:117123856-117124775	chr6	117123856	117124775	919	117123896
chr6:117175392-117180998	chr6	117175392	117180998	5606	117178450
chr6:117181817-117187827	chr6	117181817	117187827	6010	117185256
chr6:117244752-117250783	chr6	117244752	117250783	6031	117248191
chr6:117721294-117727439	chr6	117721294	117727439	6145	117724854
chr6:117999580-118002613	chr6	117999580	118002613	3033	118000023
chr6:118426811-118432950	chr6	118426811	118432950	6139	118430369
chr6:118433332-118436191	chr6	118433332	118436191	2859	118433640
chr6:118796901-118799883	chr6	118796901	118799883	2982	118797322
chr6:119399993-119406105	chr6	119399993	119406105	6112	119403534
chr6:119417672-119424079	chr6	119417672	119424079	6407	119421511
chr6:120363917-120366186	chr6	120363917	120366186	2269	120365316
chr6:120432586-120438712	chr6	120432586	120438712	6126	120436134
chr6:120688739-120694768	chr6	120688739	120694768	6029	120692184
chr6:120726333-120729473	chr6	120726333	120729473	3140	120726883
chr6:120748350-120754492	chr6	120748350	120754492	6142	120751908
chr6:120819832-120823867	chr6	120819832	120823867	4035	120821275
chr6:121100509-121103743	chr6	121100509	121103743	3234	121101161
chr6:121162716-121168725	chr6	121162716	121168725	6009	121166133
chr6:121285623-121291160	chr6	121285623	121291160	5537	121288577
chr6:121368804-121373757	chr6	121368804	121373757	4953	121371821
chr6:122761879-122764546	chr6	122761879	122764546	2667	122761964
chr6:122985872-122991404	chr6	122985872	122991404	5532	122989776
chr6:123244012-123248122	chr6	123244012	123248122	4110	123246661
chr6:123472074-123478070	chr6	123472074	123478070	5996	123475482
chr6:124238675-124243050	chr6	124238675	124243050	4375	124240319
chr6:124804502-124810643	chr6	124804502	124810643	6141	124808058
chr6:125039282-125041066	chr6	125039282	125041066	1784	125040515
chr6:125318947-125322076	chr6	125318947	125322076	3129	125319484
chr6:125395924-125402244	chr6	125395924	125402244	6320	125399657
chr6:126241340-126243939	chr6	126241340	126243939	2599	126241368
chr6:126283162-126284755	chr6	126283162	126284755	1593	126283640
chr6:126326598-126332742	chr6	126326598	126332742	6144	126330165
chr6:126505772-126511668	chr6	126505772	126511668	5896	126509095
chr6:126673551-126679569	chr6	126673551	126679569	6018	126676989
chr6:126726285-126732395	chr6	126726285	126732395	6110	126729812
chr6:126750034-126752528	chr6	126750034	126752528	2494	126750992
chr6:126984155-126988669	chr6	126984155	126988669	4514	126986045
chr6:127593292-127599292	chr6	127593292	127599292	6000	127596713
chr6:127926200-127932339	chr6	127926200	127932339	6139	127929757
chr6:128202705-128205437	chr6	128202705	128205437	2732	128202828
chr6:128296325-128300872	chr6	128296325	128300872	4547	128298303
chr6:128829462-128835615	chr6	128829462	128835615	6153	128833024
chr6:128998385-129004416	chr6	128998385	129004416	6031	129001824
chr6:129835434-129841581	chr6	129835434	129841581	6147	129839003
chr6:130348199-130352219	chr6	130348199	130352219	4020	130349644
chr6:130475515-130481667	chr6	130475515	130481667	6152	130479079
chr6:130540710-130544758	chr6	130540710	130544758	4048	130542164
chr6:130569890-130572566	chr6	130569890	130572566	2676	130570014
chr6:130636135-130638261	chr6	130636135	130638261	2126	130637560
chr6:130701315-130707767	chr6	130701315	130707767	6452	130705184
chr6:131086336-131092461	chr6	131086336	131092461	6125	131089895
chr6:131542249-131545041	chr6	131542249	131545041	2792	131542463
chr6:133518705-133522128	chr6	133518705	133522128	3423	133519569
chr6:133614306-133620743	chr6	133614306	133620743	6437	133618180
chr6:133649977-133653226	chr6	133649977	133653226	3249	133650636
chr6:133930653-133936859	chr6	133930653	133936859	6206	133934259
chr6:135511642-135513246	chr6	135511642	135513246	1604	135512875
chr6:136000726-136006368	chr6	136000726	136006368	5642	136003776
chr6:136222024-136222921	chr6	136222024	136222921	897	136222280
chr6:137069832-137076310	chr6	137069832	137076310	6478	137073714
chr6:138076455-138080869	chr6	138076455	138080869	4414	138079520
chr6:138364784-138366770	chr6	138364784	138366770	1986	138366238
chr6:139210497-139216630	chr6	139210497	139216630	6133	139214052
chr6:140868221-140871935	chr6	140868221	140871935	3714	140869346
chr6:141566105-141572136	chr6	141566105	141572136	6031	141569544
chr6:141746025-141752036	chr6	141746025	141752036	6011	141749449
chr6:141814814-141820842	chr6	141814814	141820842	6028	141818253
chr6:141916863-141922880	chr6	141916863	141922880	6017	141920290
chr6:141969527-141975701	chr6	141969527	141975701	6174	141973095
chr6:142577013-142583172	chr6	142577013	142583172	6159	142580564
chr6:145663482-145668174	chr6	145663482	145668174	4692	145665588
chr6:152028158-152034290	chr6	152028158	152034290	6132	152031714
chr6:152078502-152083797	chr6	152078502	152083797	5295	152082036
chr6:152608998-152615129	chr6	152608998	152615129	6131	152612573
chr6:152879912-152882611	chr6	152879912	152882611	2699	152880728
chr6:153110644-153117088	chr6	153110644	153117088	6444	153114505
chr6:153730658-153733196	chr6	153730658	153733196	2538	153731087
chr6:153867112-153870029	chr6	153867112	153870029	2917	153867463
chr6:154172169-154178299	chr6	154172169	154178299	6130	154175746
chr6:156034135-156040165	chr6	156034135	156040165	6030	156037573
chr6:156361254-156367276	chr6	156361254	156367276	6022	156364684
chr6:156604704-156610838	chr6	156604704	156610838	6134	156608248
chr6:156667131-156669248	chr6	156667131	156669248	2117	156667401
chr6:158526257-158528889	chr6	158526257	158528889	2632	158526294
chr6:159670614-159676755	chr6	159670614	159676755	6141	159674170
chr6:159704140-159710266	chr6	159704140	159710266	6126	159707691
chr6:160183307-160187534	chr6	160183307	160187534	4227	160184954
chr6:164957348-164960339	chr6	164957348	164960339	2991	164957724
chr6:165303279-165306483	chr6	165303279	165306483	3204	165303895
chr6:166185251-166187730	chr6	166185251	166187730	2479	166185387
chr6:166425283-166429446	chr6	166425283	166429446	4163	166426875
chr6:166788874-166795015	chr6	166788874	166795015	6141	166792428
chr6:166884811-166890997	chr6	166884811	166890997	6186	166888384
chr6:167260458-167264783	chr6	167260458	167264783	4325	167262177
chr6:168976145-168979078	chr6	168976145	168979078	2933	168976491
chr6:169357552-169362476	chr6	169357552	169362476	4924	169359888
chr6:170349708-170354642	chr6	170349708	170354642	4934	170353324
chr6_GL000250v2_alt:115801-120507	chr6_GL000250v2_alt	115801	120507	4706	117926
chr6_GL000250v2_alt:421879-422238	chr6_GL000250v2_alt	421879	422238	359	422101
chr6_GL000250v2_alt:539083-545231	chr6_GL000250v2_alt	539083	545231	6148	542643
chr6_GL000250v2_alt:1045621-1051657	chr6_GL000250v2_alt	1045621	1051657	6036	1049151
chr6_GL000250v2_alt:1759776-1765926	chr6_GL000250v2_alt	1759776	1765926	6150	1763343
chr6_GL000251v2_alt:111109-117257	chr6_GL000251v2_alt	111109	117257	6148	114671
chr6_GL000251v2_alt:340732-345438	chr6_GL000251v2_alt	340732	345438	4706	342857
chr6_GL000251v2_alt:642801-643160	chr6_GL000251v2_alt	642801	643160	359	643023
chr6_GL000251v2_alt:760016-766165	chr6_GL000251v2_alt	760016	766165	6149	763577
chr6_GL000251v2_alt:846105-851103	chr6_GL000251v2_alt	846105	851103	4998	849961
chr6_GL000251v2_alt:1263571-1269607	chr6_GL000251v2_alt	1263571	1269607	6036	1267101
chr6_GL000251v2_alt:1727735-1733134	chr6_GL000251v2_alt	1727735	1733134	5399	1730564
chr6_GL000251v2_alt:1909961-1916111	chr6_GL000251v2_alt	1909961	1916111	6150	1913528
chr6_GL000251v2_alt:3720491-3723237	chr6_GL000251v2_alt	3720491	3723237	2746	3720656
chr6_GL000252v2_alt:115819-120525	chr6_GL000252v2_alt	115819	120525	4706	117944
chr6_GL000252v2_alt:421860-422219	chr6_GL000252v2_alt	421860	422219	359	422082
chr6_GL000252v2_alt:539060-545208	chr6_GL000252v2_alt	539060	545208	6148	542620
chr6_GL000252v2_alt:1042772-1048808	chr6_GL000252v2_alt	1042772	1048808	6036	1046302
chr6_GL000252v2_alt:1503836-1509238	chr6_GL000252v2_alt	1503836	1509238	5402	1506666
chr6_GL000252v2_alt:1686130-1692280	chr6_GL000252v2_alt	1686130	1692280	6150	1689697
chr6_GL000252v2_alt:3523497-3526243	chr6_GL000252v2_alt	3523497	3526243	2746	3523662
chr6_GL000252v2_alt:3859803-3865829	chr6_GL000252v2_alt	3859803	3865829	6026	3863237
chr6_GL000253v2_alt:115774-120480	chr6_GL000253v2_alt	115774	120480	4706	117899
chr6_GL000253v2_alt:421816-422175	chr6_GL000253v2_alt	421816	422175	359	422038
chr6_GL000253v2_alt:539023-545171	chr6_GL000253v2_alt	539023	545171	6148	542583
chr6_GL000253v2_alt:625119-631620	chr6_GL000253v2_alt	625119	631620	6501	628975
chr6_GL000253v2_alt:1042367-1048399	chr6_GL000253v2_alt	1042367	1048399	6032	1045893
chr6_GL000253v2_alt:1206982-1213011	chr6_GL000253v2_alt	1206982	1213011	6029	1210419
chr6_GL000253v2_alt:1558203-1563603	chr6_GL000253v2_alt	1558203	1563603	5400	1561033
chr6_GL000253v2_alt:1740517-1746667	chr6_GL000253v2_alt	1740517	1746667	6150	1744084
chr6_GL000253v2_alt:3587067-3589812	chr6_GL000253v2_alt	3587067	3589812	2745	3587232
chr6_GL000253v2_alt:4034201-4040227	chr6_GL000253v2_alt	4034201	4040227	6026	4037635
chr6_GL000254v2_alt:115813-120519	chr6_GL000254v2_alt	115813	120519	4706	117938
chr6_GL000254v2_alt:421994-422353	chr6_GL000254v2_alt	421994	422353	359	422216
chr6_GL000254v2_alt:625341-631842	chr6_GL000254v2_alt	625341	631842	6501	629197
chr6_GL000254v2_alt:1042438-1048474	chr6_GL000254v2_alt	1042438	1048474	6036	1045968
chr6_GL000254v2_alt:1774316-1780466	chr6_GL000254v2_alt	1774316	1780466	6150	1777882
chr6_GL000255v2_alt:115798-120504	chr6_GL000255v2_alt	115798	120504	4706	117923
chr6_GL000255v2_alt:421843-422202	chr6_GL000255v2_alt	421843	422202	359	422065
chr6_GL000255v2_alt:1042773-1048809	chr6_GL000255v2_alt	1042773	1048809	6036	1046303
chr6_GL000255v2_alt:1503062-1508464	chr6_GL000255v2_alt	1503062	1508464	5402	1505892
chr6_GL000255v2_alt:1685363-1691513	chr6_GL000255v2_alt	1685363	1691513	6150	1688930
chr6_GL000255v2_alt:3505458-3508203	chr6_GL000255v2_alt	3505458	3508203	2745	3505623
chr6_GL000256v2_alt:159464-164170	chr6_GL000256v2_alt	159464	164170	4706	161589
chr6_GL000256v2_alt:465621-465980	chr6_GL000256v2_alt	465621	465980	359	465843
chr6_GL000256v2_alt:582850-588998	chr6_GL000256v2_alt	582850	588998	6148	586410
chr6_GL000256v2_alt:668965-675459	chr6_GL000256v2_alt	668965	675459	6494	672821
chr6_GL000256v2_alt:1085937-1091973	chr6_GL000256v2_alt	1085937	1091973	6036	1089467
chr6_GL000256v2_alt:1546448-1551848	chr6_GL000256v2_alt	1546448	1551848	5400	1549278
chr6_GL000256v2_alt:3598347-3601092	chr6_GL000256v2_alt	3598347	3601092	2745	3598512
chr6_GL000256v2_alt:3906940-3910776	chr6_GL000256v2_alt	3906940	3910776	3836	3910506
chr6_GL383533v1_alt:107808-111386	chr6_GL383533v1_alt	107808	111386	3578	109259
chr6_KI270798v1_alt:76946-81880	chr6_KI270798v1_alt	76946	81880	4934	80562
chr6_KI270799v1_alt:21014-26246	chr6_KI270799v1_alt	21014	26246	5232	24601
chr6_KI270799v1_alt:34009-40031	chr6_KI270799v1_alt	34009	40031	6022	37445
chr6_KI270800v1_alt:97181-99782	chr6_KI270800v1_alt	97181	99782	2601	97197
chr6_KI270801v1_alt:271398-277537	chr6_KI270801v1_alt	271398	277537	6139	274955
chr6_KI270801v1_alt:552039-554771	chr6_KI270801v1_alt	552039	554771	2732	552162
chr6_KI270801v1_alt:645659-650206	chr6_KI270801v1_alt	645659	650206	4547	647637
chr7:2743552-2749674	chr7	2743552	2749674	6122	2747094
chr7:3121545-3127690	chr7	3121545	3127690	6145	3125102
chr7:3815701-3816680	chr7	3815701	3816680	979	3816670
chr7:7465092-7471120	chr7	7465092	7471120	6028	7468532
chr7:7544201-7547598	chr7	7544201	7547598	3397	7545006
chr7:7600270-7604230	chr7	7600270	7604230	3960	7601646
chr7:8096324-8102268	chr7	8096324	8102268	5944	8099698
chr7:8239428-8245573	chr7	8239428	8245573	6145	8242990
chr7:8878665-8879805	chr7	8878665	8879805	1140	8879369
chr7:9250560-9257027	chr7	9250560	9257027	6467	9254406
chr7:9436392-9442524	chr7	9436392	9442524	6132	9439950
chr7:9903287-9904021	chr7	9903287	9904021	734	9903609
chr7:10168424-10171419	chr7	10168424	10171419	2995	10171029
chr7:10270217-10276378	chr7	10270217	10276378	6161	10273773
chr7:10372560-10378699	chr7	10372560	10378699	6139	10376111
chr7:10503059-10507095	chr7	10503059	10507095	4036	10504513
chr7:10626864-10631824	chr7	10626864	10631824	4960	10629240
chr7:10695593-10702015	chr7	10695593	10702015	6422	10699441
chr7:10741611-10747080	chr7	10741611	10747080	5469	10745474
chr7:11395825-11398554	chr7	11395825	11398554	2729	11396704
chr7:11510183-11512929	chr7	11510183	11512929	2746	11510348
chr7:11674973-11681399	chr7	11674973	11681399	6426	11678772
chr7:12141725-12145091	chr7	12141725	12145091	3366	12142523
chr7:12182424-12184316	chr7	12182424	12184316	1892	12182801
chr7:12497211-12503238	chr7	12497211	12503238	6027	12500654
chr7:13767076-13770018	chr7	13767076	13770018	2942	13767426
chr7:13806269-13812292	chr7	13806269	13812292	6023	13809701
chr7:13812313-13815660	chr7	13812313	13815660	3347	13813128
chr7:14278870-14285021	chr7	14278870	14285021	6151	14282436
chr7:14296581-14299111	chr7	14296581	14299111	2530	14297130
chr7:14313260-14319290	chr7	14313260	14319290	6030	14316708
chr7:14647630-14653668	chr7	14647630	14653668	6038	14651071
chr7:14704544-14710005	chr7	14704544	14710005	5461	14707391
chr7:15064778-15065656	chr7	15064778	15065656	878	15065369
chr7:15378470-15382183	chr7	15378470	15382183	3713	15379677
chr7:15517372-15523845	chr7	15517372	15523845	6473	15521271
chr7:15547309-15553333	chr7	15547309	15553333	6024	15550741
chr7:15940231-15946255	chr7	15940231	15946255	6024	15943667
chr7:16216428-16222457	chr7	16216428	16222457	6029	16219867
chr7:16572092-16574799	chr7	16572092	16574799	2707	16572230
chr7:17162982-17164340	chr7	17162982	17164340	1358	17163460
chr7:19045739-19051889	chr7	19045739	19051889	6150	19049314
chr7:19196709-19199847	chr7	19196709	19199847	3138	19197259
chr7:19226607-19233015	chr7	19226607	19233015	6408	19230439
chr7:20067809-20073950	chr7	20067809	20073950	6141	20071360
chr7:20089179-20092555	chr7	20089179	20092555	3376	20092006
chr7:20567561-20572479	chr7	20567561	20572479	4918	20569895
chr7:21621161-21624004	chr7	21621161	21624004	2843	21621396
chr7:21930726-21933814	chr7	21930726	21933814	3088	21931201
chr7:22528296-22534331	chr7	22528296	22534331	6035	22531736
chr7:22924196-22930356	chr7	22924196	22930356	6160	22927759
chr7:23035734-23039855	chr7	23035734	23039855	4121	23039167
chr7:23321058-23327074	chr7	23321058	23327074	6016	23324495
chr7:23796748-23800759	chr7	23796748	23800759	4011	23798174
chr7:23847687-23850982	chr7	23847687	23850982	3295	23848412
chr7:23947171-23953317	chr7	23947171	23953317	6146	23950733
chr7:25448850-25451588	chr7	25448850	25451588	2738	25448999
chr7:25603033-25609049	chr7	25603033	25609049	6016	25606460
chr7:25743832-25749863	chr7	25743832	25749863	6031	25747270
chr7:25925119-25925973	chr7	25925119	25925973	854	25925429
chr7:26833413-26837339	chr7	26833413	26837339	3926	26834769
chr7:26931576-26936271	chr7	26931576	26936271	4695	26933675
chr7:27855171-27856047	chr7	27855171	27856047	876	27855787
chr7:27981996-27986629	chr7	27981996	27986629	4633	27985527
chr7:29530106-29534545	chr7	29530106	29534545	4439	29531986
chr7:29579936-29585963	chr7	29579936	29585963	6027	29583371
chr7:30439242-30445274	chr7	30439242	30445274	6032	30442682
chr7:30537513-30543634	chr7	30537513	30543634	6121	30541043
chr7:31619616-31625782	chr7	31619616	31625782	6166	31623178
chr7:31926927-31930558	chr7	31926927	31930558	3631	31930333
chr7:31963968-31970152	chr7	31963968	31970152	6184	31967534
chr7:32081883-32088040	chr7	32081883	32088040	6157	32085427
chr7:32181111-32184806	chr7	32181111	32184806	3695	32182224
chr7:32307744-32313917	chr7	32307744	32313917	6173	32311328
chr7:32464528-32470565	chr7	32464528	32470565	6037	32467976
chr7:32708015-32714180	chr7	32708015	32714180	6165	32711567
chr7:33169990-33171417	chr7	33169990	33171417	1427	33170026
chr7:34431327-34437453	chr7	34431327	34437453	6126	34434892
chr7:34456943-34463336	chr7	34456943	34463336	6393	34460762
chr7:34515610-34519305	chr7	34515610	34519305	3695	34516707
chr7:34575797-34581960	chr7	34575797	34581960	6163	34579356
chr7:34634334-34639004	chr7	34634334	34639004	4670	34636447
chr7:34799407-34803727	chr7	34799407	34803727	4320	34801141
chr7:34813935-34820307	chr7	34813935	34820307	6372	34817491
chr7:34906239-34912252	chr7	34906239	34912252	6013	34909676
chr7:35092957-35098972	chr7	35092957	35098972	6015	35096391
chr7:35151816-35157957	chr7	35151816	35157957	6141	35155370
chr7:36119955-36126150	chr7	36119955	36126150	6195	36123534
chr7:36704353-36706164	chr7	36704353	36706164	1811	36704564
chr7:36712588-36716970	chr7	36712588	36716970	4382	36714401
chr7:37120163-37126300	chr7	37120163	37126300	6137	37123711
chr7:37153166-37159311	chr7	37153166	37159311	6145	37156741
chr7:38203045-38205333	chr7	38203045	38205333	2288	38205060
chr7:39274142-39277068	chr7	39274142	39277068	2926	39274474
chr7:40364729-40367426	chr7	40364729	40367426	2697	40364836
chr7:40445121-40445757	chr7	40445121	40445757	636	40445571
chr7:42786232-42788854	chr7	42786232	42788854	2622	42786280
chr7:42796954-42802324	chr7	42796954	42802324	5370	42799684
chr7:43059096-43065116	chr7	43059096	43065116	6020	43062535
chr7:44421349-44425324	chr7	44421349	44425324	3975	44422710
chr7:45315282-45321419	chr7	45315282	45321419	6137	45318841
chr7:45332556-45339019	chr7	45332556	45339019	6463	45336405
chr7:46141187-46143118	chr7	46141187	46143118	1931	46141387
chr7:46561971-46564567	chr7	46561971	46564567	2596	46562069
chr7:46590735-46596946	chr7	46590735	46596946	6211	46594468
chr7:46820756-46825657	chr7	46820756	46825657	4901	46823066
chr7:47159675-47165794	chr7	47159675	47165794	6119	47163229
chr7:48672995-48676803	chr7	48672995	48676803	3808	48674233
chr7:48684944-48691089	chr7	48684944	48691089	6145	48688502
chr7:48729429-48732954	chr7	48729429	48732954	3525	48730369
chr7:48884781-48885680	chr7	48884781	48885680	899	48885512
chr7:49649738-49655883	chr7	49649738	49655883	6145	49653302
chr7:50043402-50047305	chr7	50043402	50047305	3903	50044738
chr7:50886927-50891666	chr7	50886927	50891666	4739	50890428
chr7:50898842-50904874	chr7	50898842	50904874	6032	50902282
chr7:51671137-51675000	chr7	51671137	51675000	3863	51672413
chr7:51889909-51895941	chr7	51889909	51895941	6032	51893344
chr7:52102421-52106632	chr7	52102421	52106632	4211	52104055
chr7:52329581-52332882	chr7	52329581	52332882	3301	52330311
chr7:53330550-53330822	chr7	53330550	53330822	272	53330802
chr7:53824243-53826080	chr7	53824243	53826080	1837	53825958
chr7:54218125-54222793	chr7	54218125	54222793	4668	54221675
chr7:54232493-54234022	chr7	54232493	54234022	1529	54233791
chr7:55454202-55456952	chr7	55454202	55456952	2750	55454373
chr7:56584796-56590824	chr7	56584796	56590824	6028	56588233
chr7:57036531-57042552	chr7	57036531	57042552	6021	57039968
chr7:60960478-60966619	chr7	60960478	60966619	6141	60964028
chr7:61722913-61725417	chr7	61722913	61725417	2504	61723639
chr7:62151568-62154898	chr7	62151568	62154898	3330	62152294
chr7:62603534-62606320	chr7	62603534	62606320	2786	62604836
chr7:62639291-62642929	chr7	62639291	62642929	3638	62640596
chr7:62666867-62673006	chr7	62666867	62673006	6139	62670418
chr7:62858907-62864926	chr7	62858907	62864926	6019	62862347
chr7:62902278-62905452	chr7	62902278	62905452	3174	62902859
chr7:62949787-62952555	chr7	62949787	62952555	2768	62950003
chr7:63060805-63064564	chr7	63060805	63064564	3759	63063659
chr7:63312295-63312531	chr7	63312295	63312531	236	63312420
chr7:63407565-63412512	chr7	63407565	63412512	4947	63411451
chr7:63469627-63472504	chr7	63469627	63472504	2877	63469924
chr7:63732464-63738593	chr7	63732464	63738593	6129	63736014
chr7:63943705-63947774	chr7	63943705	63947774	4069	63945164
chr7:64160533-64166633	chr7	64160533	64166633	6100	64164060
chr7:65282623-65283497	chr7	65282623	65283497	874	65283269
chr7:65283493-65283998	chr7	65283493	65283998	505	65283644
chr7:65414792-65420880	chr7	65414792	65420880	6088	65418308
chr7:65480283-65486433	chr7	65480283	65486433	6150	65483853
chr7:70197328-70203357	chr7	70197328	70203357	6029	70200767
chr7:70838049-70844315	chr7	70838049	70844315	6266	70841741
chr7:72142015-72148104	chr7	72142015	72148104	6089	72145545
chr7:76728485-76734513	chr7	76728485	76734513	6028	76731922
chr7:78288584-78294084	chr7	78288584	78294084	5500	78291506
chr7:78319340-78322765	chr7	78319340	78322765	3425	78320195
chr7:78668687-78670759	chr7	78668687	78670759	2072	78669495
chr7:78887745-78893889	chr7	78887745	78893889	6144	78891302
chr7:79915077-79919714	chr7	79915077	79919714	4637	79918630
chr7:80019831-80025465	chr7	80019831	80025465	5634	80023681
chr7:80326457-80328959	chr7	80326457	80328959	2502	80326712
chr7:80688748-80695119	chr7	80688748	80695119	6371	80692561
chr7:80713105-80719172	chr7	80713105	80719172	6067	80716546
chr7:81054390-81056616	chr7	81054390	81056616	2226	81055121
chr7:81879877-81881995	chr7	81879877	81881995	2118	81881264
chr7:81911293-81912465	chr7	81911293	81912465	1172	81912321
chr7:82652080-82654984	chr7	82652080	82654984	2904	82652406
chr7:83024096-83030124	chr7	83024096	83030124	6028	83027530
chr7:83341314-83347749	chr7	83341314	83347749	6435	83345194
chr7:84062409-84068436	chr7	84062409	84068436	6027	84065844
chr7:84402951-84409055	chr7	84402951	84409055	6104	84406473
chr7:84517739-84522417	chr7	84517739	84522417	4678	84519934
chr7:85249854-85255879	chr7	85249854	85255879	6025	85253292
chr7:85753062-85757273	chr7	85753062	85757273	4211	85754728
chr7:86174045-86180106	chr7	86174045	86180106	6061	86177500
chr7:86230344-86233667	chr7	86230344	86233667	3323	86231079
chr7:86340208-86346233	chr7	86340208	86346233	6025	86343646
chr7:86375397-86380743	chr7	86375397	86380743	5346	86378909
chr7:86548570-86550447	chr7	86548570	86550447	1877	86549761
chr7:86550850-86555083	chr7	86550850	86555083	4233	86552503
chr7:86587147-86589468	chr7	86587147	86589468	2321	86589370
chr7:86799973-86800949	chr7	86799973	86800949	976	86800713
chr7:86981685-86985673	chr7	86981685	86985673	3988	86985266
chr7:87039756-87045768	chr7	87039756	87045768	6012	87043185
chr7:87238723-87244161	chr7	87238723	87244161	5438	87241573
chr7:87304067-87310554	chr7	87304067	87310554	6487	87307989
chr7:87319584-87322209	chr7	87319584	87322209	2625	87319627
chr7:87464899-87468654	chr7	87464899	87468654	3755	87468458
chr7:87819290-87823048	chr7	87819290	87823048	3758	87820462
chr7:88006164-88008935	chr7	88006164	88008935	2771	88006325
chr7:88077364-88083495	chr7	88077364	88083495	6131	88080915
chr7:88630748-88633563	chr7	88630748	88633563	2815	88630969
chr7:88857051-88857785	chr7	88857051	88857785	734	88857687
chr7:88874732-88876056	chr7	88874732	88876056	1324	88875734
chr7:89279866-89280909	chr7	89279866	89280909	1043	89280829
chr7:90202096-90204956	chr7	90202096	90204956	2860	90202375
chr7:90806490-90812630	chr7	90806490	90812630	6140	90810044
chr7:91173443-91179517	chr7	91173443	91179517	6074	91176883
chr7:91216614-91218357	chr7	91216614	91218357	1743	91217683
chr7:91406076-91406483	chr7	91406076	91406483	407	91406177
chr7:91506736-91512867	chr7	91506736	91512867	6131	91510281
chr7:91583270-91589300	chr7	91583270	91589300	6030	91586709
chr7:91589650-91595794	chr7	91589650	91595794	6144	91593218
chr7:91647232-91650378	chr7	91647232	91650378	3146	91647799
chr7:92957112-92961411	chr7	92957112	92961411	4299	92958844
chr7:93078484-93082527	chr7	93078484	93082527	4043	93079962
chr7:93108335-93114446	chr7	93108335	93114446	6111	93111882
chr7:93121548-93127502	chr7	93121548	93127502	5954	93124903
chr7:93341964-93347980	chr7	93341964	93347980	6016	93345403
chr7:93487841-93492294	chr7	93487841	93492294	4453	93489833
chr7:94191175-94193772	chr7	94191175	94193772	2597	94191631
chr7:94783957-94786106	chr7	94783957	94786106	2149	94784370
chr7:94794534-94800526	chr7	94794534	94800526	5992	94797946
chr7:95079384-95080690	chr7	95079384	95080690	1306	95079513
chr7:95381324-95385358	chr7	95381324	95385358	4034	95382777
chr7:95385377-95389098	chr7	95385377	95389098	3721	95386556
chr7:95567454-95568982	chr7	95567454	95568982	1528	95567775
chr7:95941946-95945033	chr7	95941946	95945033	3087	95942446
chr7:96255810-96260216	chr7	96255810	96260216	4406	96257639
chr7:96288293-96294436	chr7	96288293	96294436	6143	96291852
chr7:96811919-96815056	chr7	96811919	96815056	3137	96812454
chr7:97058898-97061897	chr7	97058898	97061897	2999	97060063
chr7:97238658-97239680	chr7	97238658	97239680	1022	97239012
chr7:97333137-97336201	chr7	97333137	97336201	3064	97333626
chr7:97536008-97539032	chr7	97536008	97539032	3024	97536443
chr7:97613656-97619688	chr7	97613656	97619688	6032	97617098
chr7:97710645-97711568	chr7	97710645	97711568	923	97711081
chr7:97760436-97766553	chr7	97760436	97766553	6117	97763964
chr7:97779472-97784021	chr7	97779472	97784021	4549	97781450
chr7:97785607-97791738	chr7	97785607	97791738	6131	97789140
chr7:97810373-97816490	chr7	97810373	97816490	6117	97813907
chr7:99744007-99747527	chr7	99744007	99747527	3520	99744953
chr7:99773055-99776874	chr7	99773055	99776874	3819	99774266
chr7:99809199-99815231	chr7	99809199	99815231	6032	99812640
chr7:102722555-102728733	chr7	102722555	102728733	6178	102726113
chr7:102780677-102786841	chr7	102780677	102786841	6164	102784258
chr7:102960150-102962987	chr7	102960150	102962987	2837	102960408
chr7:103016327-103022487	chr7	103016327	103022487	6160	103019898
chr7:103108439-103112765	chr7	103108439	103112765	4326	103110143
chr7:103244596-103250743	chr7	103244596	103250743	6147	103248155
chr7:103504465-103510637	chr7	103504465	103510637	6172	103508108
chr7:103741901-103747423	chr7	103741901	103747423	5522	103744839
chr7:103786407-103790340	chr7	103786407	103790340	3933	103787758
chr7:103872986-103875437	chr7	103872986	103875437	2451	103873780
chr7:103882508-103885060	chr7	103882508	103885060	2552	103882861
chr7:103899024-103901906	chr7	103899024	103901906	2882	103899366
chr7:104209736-104215889	chr7	104209736	104215889	6153	104213306
chr7:104276530-104282690	chr7	104276530	104282690	6160	104280098
chr7:104864133-104870254	chr7	104864133	104870254	6121	104867652
chr7:106211443-106216075	chr7	106211443	106216075	4632	106213522
chr7:106321944-106325531	chr7	106321944	106325531	3587	106322943
chr7:106359831-106364648	chr7	106359831	106364648	4817	106362102
chr7:106671761-106675311	chr7	106671761	106675311	3550	106675297
chr7:106709407-106715579	chr7	106709407	106715579	6172	106712986
chr7:106724150-106726991	chr7	106724150	106726991	2841	106725187
chr7:107507907-107514058	chr7	107507907	107514058	6151	107511469
chr7:107517995-107522186	chr7	107517995	107522186	4191	107519718
chr7:109011781-109014247	chr7	109011781	109014247	2466	109013142
chr7:109381435-109386667	chr7	109381435	109386667	5232	109384080
chr7:109719133-109725270	chr7	109719133	109725270	6137	109722682
chr7:109794983-109801140	chr7	109794983	109801140	6157	109798544
chr7:109860479-109863651	chr7	109860479	109863651	3172	109861066
chr7:109908644-109914225	chr7	109908644	109914225	5581	109911635
chr7:110472219-110478325	chr7	110472219	110478325	6106	110475782
chr7:110743477-110749909	chr7	110743477	110749909	6432	110747324
chr7:111445694-111451725	chr7	111445694	111451725	6031	111449133
chr7:111499821-111505980	chr7	111499821	111505980	6159	111503394
chr7:111963193-111969223	chr7	111963193	111969223	6030	111966631
chr7:112916452-112921936	chr7	112916452	112921936	5484	112920023
chr7:113533338-113538585	chr7	113533338	113538585	5247	113536779
chr7:113600731-113603742	chr7	113600731	113603742	3011	113601224
chr7:113742900-113748900	chr7	113742900	113748900	6000	113746331
chr7:113855968-113862447	chr7	113855968	113862447	6479	113859840
chr7:114054935-114061069	chr7	114054935	114061069	6134	114058493
chr7:115593823-115599724	chr7	115593823	115599724	5901	115597157
chr7:115889811-115893476	chr7	115889811	115893476	3665	115890905
chr7:115947830-115949950	chr7	115947830	115949950	2120	115948272
chr7:115989279-115995357	chr7	115989279	115995357	6078	115992778
chr7:116371251-116377392	chr7	116371251	116377392	6141	116374811
chr7:116408860-116414874	chr7	116408860	116414874	6014	116412296
chr7:116748273-116751481	chr7	116748273	116751481	3208	116749029
chr7:117526158-117529529	chr7	117526158	117529529	3371	117526937
chr7:117966817-117969712	chr7	117966817	117969712	2895	117967125
chr7:119215248-119216731	chr7	119215248	119216731	1483	119215316
chr7:119306318-119306961	chr7	119306318	119306961	643	119306576
chr7:119586709-119592736	chr7	119586709	119592736	6027	119590145
chr7:119854820-119860951	chr7	119854820	119860951	6131	119858364
chr7:120900747-120906862	chr7	120900747	120906862	6115	120904276
chr7:121249719-121253472	chr7	121249719	121253472	3753	121250891
chr7:122238520-122244551	chr7	122238520	122244551	6031	122241961
chr7:122721208-122724182	chr7	122721208	122724182	2974	122721613
chr7:122834316-122840443	chr7	122834316	122840443	6127	122837853
chr7:123428019-123430006	chr7	123428019	123430006	1987	123428588
chr7:123894496-123900648	chr7	123894496	123900648	6152	123898057
chr7:124900533-124906652	chr7	124900533	124906652	6119	124904090
chr7:125046011-125050112	chr7	125046011	125050112	4101	125049875
chr7:126602742-126603605	chr7	126602742	126603605	863	126602809
chr7:126613401-126619522	chr7	126613401	126619522	6121	126616950
chr7:127450973-127457096	chr7	127450973	127457096	6123	127454515
chr7:128292011-128298140	chr7	128292011	128298140	6129	128295568
chr7:130577797-130583509	chr7	130577797	130583509	5712	130580920
chr7:131315127-131321601	chr7	131315127	131321601	6474	131319019
chr7:132664481-132665348	chr7	132664481	132665348	867	132665115
chr7:133210518-133214214	chr7	133210518	133214214	3696	133211747
chr7:134239096-134245229	chr7	134239096	134245229	6133	134242627
chr7:134976002-134982155	chr7	134976002	134982155	6153	134979566
chr7:135066747-135072925	chr7	135066747	135072925	6178	135070299
chr7:136764715-136766109	chr7	136764715	136766109	1394	136765425
chr7:136831191-136837216	chr7	136831191	136837216	6025	136834626
chr7:137105228-137108325	chr7	137105228	137108325	3097	137105753
chr7:137136346-137139788	chr7	137136346	137139788	3442	137137191
chr7:137181608-137187601	chr7	137181608	137187601	5993	137185049
chr7:137424398-137430564	chr7	137424398	137430564	6166	137427975
chr7:138038618-138042216	chr7	138038618	138042216	3598	138039631
chr7:140763509-140766450	chr7	140763509	140766450	2941	140763871
chr7:141032606-141038752	chr7	141032606	141038752	6146	141036020
chr7:142209914-142214726	chr7	142209914	142214726	4812	142213747
chr7:143088273-143094435	chr7	143088273	143094435	6162	143091837
chr7:143748668-143752764	chr7	143748668	143752764	4096	143752303
chr7:144120638-144121842	chr7	144120638	144121842	1204	144120735
chr7:144615518-144618643	chr7	144615518	144618643	3125	144616056
chr7:145341108-145343878	chr7	145341108	145343878	2770	145341294
chr7:145561496-145564595	chr7	145561496	145564595	3099	145564338
chr7:145659179-145664684	chr7	145659179	145664684	5505	145662117
chr7:145966590-145972707	chr7	145966590	145972707	6117	145970123
chr7:146157281-146161427	chr7	146157281	146161427	4146	146160776
chr7:146305654-146308988	chr7	146305654	146308988	3334	146306320
chr7:146644615-146645047	chr7	146644615	146645047	432	146644905
chr7:146905784-146911817	chr7	146905784	146911817	6033	146909227
chr7:146928453-146934611	chr7	146928453	146934611	6158	146932011
chr7:147355183-147356566	chr7	147355183	147356566	1383	147355859
chr7:148531002-148535111	chr7	148531002	148535111	4109	148532540
chr7:150116785-150122258	chr7	150116785	150122258	5473	150120661
chr7:150496244-150502258	chr7	150496244	150502258	6014	150499673
chr7:150542953-150548795	chr7	150542953	150548795	5842	150546221
chr7:150597094-150602628	chr7	150597094	150602628	5534	150600647
chr7:150605597-150609905	chr7	150605597	150609905	4308	150609160
chr7:150680256-150683292	chr7	150680256	150683292	3036	150681976
chr7:150708225-150712266	chr7	150708225	150712266	4041	150709675
chr7:150807555-150813715	chr7	150807555	150813715	6160	150811132
chr7:153304573-153308340	chr7	153304573	153308340	3767	153305767
chr7:153814179-153815325	chr7	153814179	153815325	1146	153814532
chr7:157509923-157513076	chr7	157509923	157513076	3153	157510491
chr7:159079192-159082629	chr7	159079192	159082629	3437	159080041
chr7:159284240-159288400	chr7	159284240	159288400	4160	159288027
chr7_KI270803v1_alt:171794-176606	chr7_KI270803v1_alt	171794	176606	4812	175627
chr8:156283-162706	chr8	156283	162706	6423	160161
chr8:558735-560580	chr8	558735	560580	1845	559318
chr8:1607577-1613555	chr8	1607577	1613555	5978	1610963
chr8:1715839-1716919	chr8	1715839	1716919	1080	1716400
chr8:2367139-2370368	chr8	2367139	2370368	3229	2367780
chr8:2397987-2404043	chr8	2397987	2404043	6056	2401452
chr8:2413733-2419762	chr8	2413733	2419762	6029	2417174
chr8:4058563-4060442	chr8	4058563	4060442	1879	4059867
chr8:4176603-4180590	chr8	4176603	4180590	3987	4178004
chr8:4854406-4860419	chr8	4854406	4860419	6013	4857838
chr8:5187029-5193146	chr8	5187029	5193146	6117	5190575
chr8:5928684-5932285	chr8	5928684	5932285	3601	5929710
chr8:6382546-6387236	chr8	6382546	6387236	4690	6385219
chr8:6651672-6655456	chr8	6651672	6655456	3784	6652876
chr8:8156962-8160849	chr8	8156962	8160849	3887	8158268
chr8:8470859-8476906	chr8	8470859	8476906	6047	8474298
chr8:9658440-9662755	chr8	9658440	9662755	4315	9660161
chr8:9818213-9822277	chr8	9818213	9822277	4064	9819708
chr8:9876784-9882704	chr8	9876784	9882704	5920	9880173
chr8:9991294-9995053	chr8	9991294	9995053	3759	9992443
chr8:14803216-14809243	chr8	14803216	14809243	6027	14806655
chr8:14868771-14870282	chr8	14868771	14870282	1511	14869013
chr8:15429746-15430854	chr8	15429746	15430854	1108	15430051
chr8:16278396-16279497	chr8	16278396	16279497	1101	16278944
chr8:16417302-16420918	chr8	16417302	16420918	3616	16418336
chr8:16670119-16674066	chr8	16670119	16674066	3947	16673551
chr8:16943968-16949995	chr8	16943968	16949995	6027	16947406
chr8:18466887-18473065	chr8	18466887	18473065	6178	18470485
chr8:19930161-19936300	chr8	19930161	19936300	6139	19933720
chr8:20742703-20748777	chr8	20742703	20748777	6074	20746219
chr8:21431057-21437502	chr8	21431057	21437502	6445	21434922
chr8:21825719-21831739	chr8	21825719	21831739	6020	21829154
chr8:23311985-23314802	chr8	23311985	23314802	2817	23312223
chr8:24559229-24562369	chr8	24559229	24562369	3140	24562264
chr8:24839573-24845719	chr8	24839573	24845719	6146	24843133
chr8:25012097-25015130	chr8	25012097	25015130	3033	25012542
chr8:25526373-25526998	chr8	25526373	25526998	625	25526859
chr8:26395612-26401579	chr8	26395612	26401579	5967	26398991
chr8:27113618-27119645	chr8	27113618	27119645	6027	27117053
chr8:29449215-29455343	chr8	29449215	29455343	6128	29452761
chr8:31442205-31445535	chr8	31442205	31445535	3330	31442948
chr8:31509598-31510301	chr8	31509598	31510301	703	31509713
chr8:31566107-31571502	chr8	31566107	31571502	5395	31568921
chr8:32818064-32819664	chr8	32818064	32819664	1600	32818903
chr8:33361939-33366412	chr8	33361939	33366412	4473	33363844
chr8:34037449-34037835	chr8	34037449	34037835	386	34037785
chr8:34056887-34060924	chr8	34056887	34060924	4037	34058340
chr8:34214932-34221078	chr8	34214932	34221078	6146	34218492
chr8:34438300-34443846	chr8	34438300	34443846	5546	34441930
chr8:34540425-34546387	chr8	34540425	34546387	5962	34543794
chr8:34589383-34590131	chr8	34589383	34590131	748	34589861
chr8:34725567-34726721	chr8	34725567	34726721	1154	34725791
chr8:34739506-34744193	chr8	34739506	34744193	4687	34741610
chr8:35994667-35996041	chr8	35994667	35996041	1374	35994692
chr8:36006108-36011170	chr8	36006108	36011170	5062	36010026
chr8:36727870-36731905	chr8	36727870	36731905	4035	36729331
chr8:37460279-37466395	chr8	37460279	37466395	6116	37463808
chr8:39434001-39439167	chr8	39434001	39439167	5166	39436597
chr8:39809748-39813927	chr8	39809748	39813927	4179	39811351
chr8:40432212-40438240	chr8	40432212	40438240	6028	40435652
chr8:40647061-40653096	chr8	40647061	40653096	6035	40650500
chr8:41225008-41231111	chr8	41225008	41231111	6103	41228529
chr8:41480247-41483247	chr8	41480247	41483247	3000	41480631
chr8:43480071-43486196	chr8	43480071	43486196	6125	43483616
chr8:43488461-43493939	chr8	43488461	43493939	5478	43491297
chr8:46727529-46731550	chr8	46727529	46731550	4021	46728973
chr8:46797331-46803471	chr8	46797331	46803471	6140	46800883
chr8:46831156-46836001	chr8	46831156	46836001	4845	46833415
chr8:46893982-46900118	chr8	46893982	46900118	6136	46897521
chr8:46945646-46948603	chr8	46945646	46948603	2957	46946007
chr8:47018708-47024752	chr8	47018708	47024752	6044	47022166
chr8:47071414-47074132	chr8	47071414	47074132	2718	47071564
chr8:47075514-47080484	chr8	47075514	47080484	4970	47079073
chr8:47154225-47157085	chr8	47154225	47157085	2860	47155296
chr8:47158290-47164269	chr8	47158290	47164269	5979	47161679
chr8:47316969-47323101	chr8	47316969	47323101	6132	47320521
chr8:47400835-47405291	chr8	47400835	47405291	4456	47402777
chr8:47484871-47491006	chr8	47484871	47491006	6135	47488426
chr8:47623150-47627399	chr8	47623150	47627399	4249	47624811
chr8:48206238-48212003	chr8	48206238	48212003	5765	48209219
chr8:48353825-48357892	chr8	48353825	48357892	4067	48355301
chr8:48485587-48491678	chr8	48485587	48491678	6091	48489139
chr8:49677369-49680049	chr8	49677369	49680049	2680	49677461
chr8:49970923-49973526	chr8	49970923	49973526	2603	49970943
chr8:50669011-50672207	chr8	50669011	50672207	3196	50669615
chr8:51492297-51498465	chr8	51492297	51498465	6168	51495854
chr8:51638322-51642366	chr8	51638322	51642366	4044	51639777
chr8:51796163-51799402	chr8	51796163	51799402	3239	51796748
chr8:52506471-52512618	chr8	52506471	52512618	6147	52510034
chr8:53609643-53615529	chr8	53609643	53615529	5886	53612945
chr8:53679718-53683642	chr8	53679718	53683642	3924	53681049
chr8:53932322-53937061	chr8	53932322	53937061	4739	53935680
chr8:54667813-54668207	chr8	54667813	54668207	394	54667912
chr8:54976590-54980667	chr8	54976590	54980667	4077	54980444
chr8:54986741-54991166	chr8	54986741	54991166	4425	54988577
chr8:55049901-55055999	chr8	55049901	55055999	6098	55053414
chr8:55476428-55482556	chr8	55476428	55482556	6128	55479975
chr8:55573045-55575512	chr8	55573045	55575512	2467	55574834
chr8:55615745-55621599	chr8	55615745	55621599	5854	55619319
chr8:55656150-55662303	chr8	55656150	55662303	6153	55659718
chr8:56278311-56280076	chr8	56278311	56280076	1765	56278524
chr8:56415221-56421252	chr8	56415221	56421252	6031	56418659
chr8:56429110-56433641	chr8	56429110	56433641	4531	56432657
chr8:56551663-56553706	chr8	56551663	56553706	2043	56553263
chr8:56847186-56849900	chr8	56847186	56849900	2714	56849837
chr8:57485170-57487365	chr8	57485170	57487365	2195	57485552
chr8:57567707-57570421	chr8	57567707	57570421	2714	57567879
chr8:57706915-57709556	chr8	57706915	57709556	2641	57706946
chr8:58370157-58376173	chr8	58370157	58376173	6016	58373595
chr8:58727600-58730795	chr8	58727600	58730795	3195	58728221
chr8:58914690-58920717	chr8	58914690	58920717	6027	58918128
chr8:59381047-59384498	chr8	59381047	59384498	3451	59384383
chr8:59534832-59538987	chr8	59534832	59538987	4155	59536403
chr8:59881856-59888008	chr8	59881856	59888008	6152	59885418
chr8:60162478-60166517	chr8	60162478	60166517	4039	60163932
chr8:60447769-60451735	chr8	60447769	60451735	3966	60451634
chr8:61188605-61193531	chr8	61188605	61193531	4926	61190948
chr8:61482721-61486096	chr8	61482721	61486096	3375	61483516
chr8:61992004-61994101	chr8	61992004	61994101	2097	61992048
chr8:61994302-62000327	chr8	61994302	62000327	6025	61997735
chr8:62223126-62229596	chr8	62223126	62229596	6470	62227020
chr8:62789585-62790436	chr8	62789585	62790436	851	62789886
chr8:62800633-62806816	chr8	62800633	62806816	6183	62804187
chr8:62814375-62815778	chr8	62814375	62815778	1403	62815294
chr8:64102228-64108366	chr8	64102228	64108366	6138	64105783
chr8:64955572-64961717	chr8	64955572	64961717	6145	64959125
chr8:65120644-65126660	chr8	65120644	65126660	6016	65124068
chr8:65379637-65386163	chr8	65379637	65386163	6526	65383519
chr8:65426356-65430823	chr8	65426356	65430823	4467	65429911
chr8:65436282-65439459	chr8	65436282	65439459	3177	65436868
chr8:66069485-66072204	chr8	66069485	66072204	2719	66069633
chr8:66233704-66236780	chr8	66233704	66236780	3076	66234206
chr8:66317805-66323394	chr8	66317805	66323394	5589	66321361
chr8:67896413-67900398	chr8	67896413	67900398	3985	67897825
chr8:68271693-68273034	chr8	68271693	68273034	1341	68272742
chr8:68276303-68280681	chr8	68276303	68280681	4378	68279856
chr8:68362478-68367911	chr8	68362478	68367911	5433	68365320
chr8:68459800-68465948	chr8	68459800	68465948	6148	68463365
chr8:68743353-68749398	chr8	68743353	68749398	6045	68746808
chr8:69021338-69025143	chr8	69021338	69025143	3805	69022554
chr8:69125806-69129033	chr8	69125806	69129033	3227	69127199
chr8:69254219-69260249	chr8	69254219	69260249	6030	69257658
chr8:69279891-69286362	chr8	69279891	69286362	6471	69283752
chr8:69823184-69827310	chr8	69823184	69827310	4126	69824701
chr8:69843300-69849423	chr8	69843300	69849423	6123	69846848
chr8:69863577-69866985	chr8	69863577	69866985	3408	69864396
chr8:69907255-69913694	chr8	69907255	69913694	6439	69911104
chr8:70752713-70755925	chr8	70752713	70755925	3212	70753339
chr8:70808322-70814458	chr8	70808322	70814458	6136	70811865
chr8:70849241-70850179	chr8	70849241	70850179	938	70850043
chr8:70855119-70860135	chr8	70855119	70860135	5016	70857539
chr8:70877554-70882273	chr8	70877554	70882273	4719	70879734
chr8:71406360-71412376	chr8	71406360	71412376	6016	71409798
chr8:71451793-71457894	chr8	71451793	71457894	6101	71455332
chr8:71581618-71587762	chr8	71581618	71587762	6144	71585176
chr8:71820261-71826403	chr8	71820261	71826403	6142	71823818
chr8:72291053-72297285	chr8	72291053	72297285	6232	72294694
chr8:72321140-72327130	chr8	72321140	72327130	5990	72324536
chr8:72479440-72485463	chr8	72479440	72485463	6023	72482871
chr8:72712682-72718823	chr8	72712682	72718823	6141	72716236
chr8:73056349-73061906	chr8	73056349	73061906	5557	73059325
chr8:73568856-73574918	chr8	73568856	73574918	6062	73572323
chr8:74015888-74022085	chr8	74015888	74022085	6197	74019494
chr8:74252452-74256546	chr8	74252452	74256546	4094	74253967
chr8:74866519-74872545	chr8	74866519	74872545	6026	74869961
chr8:75278367-75284402	chr8	75278367	75284402	6035	75281807
chr8:75324221-75330225	chr8	75324221	75330225	6004	75327647
chr8:75444000-75448442	chr8	75444000	75448442	4442	75445854
chr8:75599609-75602769	chr8	75599609	75602769	3160	75600192
chr8:76063621-76068426	chr8	76063621	76068426	4805	76066031
chr8:76108324-76109925	chr8	76108324	76109925	1601	76108907
chr8:76308116-76314119	chr8	76308116	76314119	6003	76311535
chr8:76360007-76365824	chr8	76360007	76365824	5817	76363560
chr8:77022462-77025356	chr8	77022462	77025356	2894	77022776
chr8:77045310-77048298	chr8	77045310	77048298	2988	77045688
chr8:77088411-77094444	chr8	77088411	77094444	6033	77091857
chr8:77204041-77204565	chr8	77204041	77204565	524	77204356
chr8:77364545-77369654	chr8	77364545	77369654	5109	77367074
chr8:77940513-77946526	chr8	77940513	77946526	6013	77943941
chr8:78350507-78356689	chr8	78350507	78356689	6182	78354071
chr8:78444885-78450991	chr8	78444885	78450991	6106	78448415
chr8:79033666-79040102	chr8	79033666	79040102	6436	79037484
chr8:79114268-79118066	chr8	79114268	79118066	3798	79115495
chr8:79710622-79711728	chr8	79710622	79711728	1106	79711613
chr8:79982276-79988432	chr8	79982276	79988432	6156	79985850
chr8:80003520-80009422	chr8	80003520	80009422	5902	80006845
chr8:80649191-80655347	chr8	80649191	80655347	6156	80652742
chr8:80799482-80804857	chr8	80799482	80804857	5375	80802259
chr8:80822965-80828180	chr8	80822965	80828180	5215	80826498
chr8:81167824-81168614	chr8	81167824	81168614	790	81168477
chr8:81427211-81433232	chr8	81427211	81433232	6021	81430645
chr8:81768216-81774242	chr8	81768216	81774242	6026	81771651
chr8:82582790-82586317	chr8	82582790	82586317	3527	82583751
chr8:83267121-83271382	chr8	83267121	83271382	4261	83268821
chr8:83280499-83281792	chr8	83280499	83281792	1293	83281241
chr8:83447142-83453169	chr8	83447142	83453169	6027	83450581
chr8:83495736-83497798	chr8	83495736	83497798	2062	83497186
chr8:84729375-84730662	chr8	84729375	84730662	1287	84729958
chr8:84838985-84845133	chr8	84838985	84845133	6148	84842542
chr8:84996817-84999411	chr8	84996817	84999411	2594	84996846
chr8:85012241-85015289	chr8	85012241	85015289	3048	85012758
chr8:85716457-85720119	chr8	85716457	85720119	3662	85717523
chr8:85737906-85741568	chr8	85737906	85741568	3662	85738972
chr8:86077293-86079081	chr8	86077293	86079081	1788	86077887
chr8:87301621-87304649	chr8	87301621	87304649	3028	87302062
chr8:87385133-87391253	chr8	87385133	87391253	6120	87388675
chr8:87485727-87487321	chr8	87485727	87487321	1594	87486610
chr8:87624830-87630833	chr8	87624830	87630833	6003	87628249
chr8:87648620-87654204	chr8	87648620	87654204	5584	87651606
chr8:87793144-87799385	chr8	87793144	87799385	6241	87796702
chr8:88148848-88154880	chr8	88148848	88154880	6032	88152288
chr8:88574093-88580230	chr8	88574093	88580230	6137	88577633
chr8:88685705-88691760	chr8	88685705	88691760	6055	88689145
chr8:88899674-88903056	chr8	88899674	88903056	3382	88900486
chr8:89155274-89158738	chr8	89155274	89158738	3464	89156167
chr8:89162874-89166591	chr8	89162874	89166591	3717	89166431
chr8:89218189-89224363	chr8	89218189	89224363	6174	89221797
chr8:89373916-89380072	chr8	89373916	89380072	6156	89377477
chr8:89427459-89427982	chr8	89427459	89427982	523	89427923
chr8:89457544-89461635	chr8	89457544	89461635	4091	89461085
chr8:89535240-89541269	chr8	89535240	89541269	6029	89538675
chr8:89597857-89600422	chr8	89597857	89600422	2565	89599005
chr8:89673074-89678276	chr8	89673074	89678276	5202	89675692
chr8:89678284-89684515	chr8	89678284	89684515	6231	89681934
chr8:89708196-89714343	chr8	89708196	89714343	6147	89711752
chr8:90045265-90051184	chr8	90045265	90051184	5919	90048610
chr8:90264106-90270252	chr8	90264106	90270252	6146	90267667
chr8:90375820-90381589	chr8	90375820	90381589	5769	90378995
chr8:91558668-91564687	chr8	91558668	91564687	6019	91562096
chr8:91570578-91573404	chr8	91570578	91573404	2826	91570853
chr8:91727709-91730135	chr8	91727709	91730135	2426	91728040
chr8:91777110-91778204	chr8	91777110	91778204	1094	91777820
chr8:91787809-91793551	chr8	91787809	91793551	5742	91791339
chr8:91793551-91799568	chr8	91793551	91799568	6017	91796986
chr8:91820956-91824633	chr8	91820956	91824633	3677	91822061
chr8:91869518-91875534	chr8	91869518	91875534	6016	91872948
chr8:91891362-91897361	chr8	91891362	91897361	5999	91894773
chr8:93405812-93411825	chr8	93405812	93411825	6013	93409246
chr8:93466325-93471713	chr8	93466325	93471713	5388	93469894
chr8:93483262-93489389	chr8	93483262	93489389	6127	93486800
chr8:96070416-96076555	chr8	96070416	96076555	6139	96073975
chr8:96116677-96122696	chr8	96116677	96122696	6019	96120108
chr8:96192205-96193215	chr8	96192205	96193215	1010	96192318
chr8:97295603-97301657	chr8	97295603	97301657	6054	97299039
chr8:98260275-98266293	chr8	98260275	98266293	6018	98263703
chr8:98614445-98620471	chr8	98614445	98620471	6026	98617887
chr8:98650350-98656495	chr8	98650350	98656495	6145	98653907
chr8:98710156-98716294	chr8	98710156	98716294	6138	98713701
chr8:98738605-98744745	chr8	98738605	98744745	6140	98742155
chr8:99202443-99202751	chr8	99202443	99202751	308	99202621
chr8:99424374-99425895	chr8	99424374	99425895	1521	99425139
chr8:99666201-99666936	chr8	99666201	99666936	735	99666232
chr8:99691565-99695711	chr8	99691565	99695711	4146	99693119
chr8:99738837-99744983	chr8	99738837	99744983	6146	99742399
chr8:99966928-99972752	chr8	99966928	99972752	5824	99970803
chr8:99990636-99996273	chr8	99990636	99996273	5637	99993689
chr8:100031805-100036126	chr8	100031805	100036126	4321	100033599
chr8:100110733-100113794	chr8	100110733	100113794	3061	100112168
chr8:100852321-100858465	chr8	100852321	100858465	6144	100855878
chr8:101425780-101431879	chr8	101425780	101431879	6099	101429294
chr8:101671033-101677223	chr8	101671033	101677223	6190	101674632
chr8:101678069-101684093	chr8	101678069	101684093	6024	101681501
chr8:101696764-101699933	chr8	101696764	101699933	3169	101697369
chr8:101709979-101714714	chr8	101709979	101714714	4735	101713855
chr8:101891500-101897529	chr8	101891500	101897529	6029	101894937
chr8:101999898-102006042	chr8	101999898	102006042	6144	102003454
chr8:102132755-102138891	chr8	102132755	102138891	6136	102136317
chr8:102316940-102323098	chr8	102316940	102323098	6158	102320514
chr8:103549090-103553602	chr8	103549090	103553602	4512	103551022
chr8:103790883-103795584	chr8	103790883	103795584	4701	103793006
chr8:103951318-103957769	chr8	103951318	103957769	6451	103955174
chr8:104308596-104314727	chr8	104308596	104314727	6131	104312134
chr8:105201240-105202470	chr8	105201240	105202470	1230	105201454
chr8:105896671-105901055	chr8	105896671	105901055	4384	105900603
chr8:106023328-106029434	chr8	106023328	106029434	6106	106026869
chr8:106560724-106567124	chr8	106560724	106567124	6400	106564557
chr8:106883080-106885884	chr8	106883080	106885884	2804	106883300
chr8:107110251-107111659	chr8	107110251	107111659	1408	107111099
chr8:107240608-107246613	chr8	107240608	107246613	6005	107244042
chr8:107473901-107476597	chr8	107473901	107476597	2696	107474011
chr8:108060124-108065182	chr8	108060124	108065182	5058	108062607
chr8:108105389-108109379	chr8	108105389	108109379	3990	108107725
chr8:108123480-108127542	chr8	108123480	108127542	4062	108124969
chr8:108166801-108172416	chr8	108166801	108172416	5615	108169821
chr8:108679877-108681525	chr8	108679877	108681525	1648	108680090
chr8:108930482-108936587	chr8	108930482	108936587	6105	108933999
chr8:109674636-109676483	chr8	109674636	109676483	1847	109675713
chr8:109821844-109822776	chr8	109821844	109822776	932	109822205
chr8:109826694-109829932	chr8	109826694	109829932	3238	109827345
chr8:109858630-109864778	chr8	109858630	109864778	6148	109862189
chr8:110820767-110821968	chr8	110820767	110821968	1201	110820965
chr8:110952164-110957638	chr8	110952164	110957638	5474	110955066
chr8:111202400-111207077	chr8	111202400	111207077	4677	111204479
chr8:111632089-111636262	chr8	111632089	111636262	4173	111633677
chr8:111985295-111991589	chr8	111985295	111991589	6294	111989134
chr8:112084543-112087958	chr8	112084543	112087958	3415	112085388
chr8:112184942-112188028	chr8	112184942	112188028	3086	112185449
chr8:112533274-112537179	chr8	112533274	112537179	3905	112534604
chr8:112594005-112600030	chr8	112594005	112600030	6025	112597441
chr8:113499946-113501347	chr8	113499946	113501347	1401	113500361
chr8:113610657-113613130	chr8	113610657	113613130	2473	113611674
chr8:114162725-114168762	chr8	114162725	114168762	6037	114166174
chr8:114188652-114193116	chr8	114188652	114193116	4464	114190528
chr8:114504030-114510051	chr8	114504030	114510051	6021	114507460
chr8:115370380-115374484	chr8	115370380	115374484	4104	115373918
chr8:115753161-115759177	chr8	115753161	115759177	6016	115756585
chr8:116390729-116396864	chr8	116390729	116396864	6135	116394311
chr8:116410345-116416460	chr8	116410345	116416460	6115	116413884
chr8:117191437-117197574	chr8	117191437	117197574	6137	117194988
chr8:117435702-117438324	chr8	117435702	117438324	2622	117435731
chr8:117487084-117492772	chr8	117487084	117492772	5688	117490235
chr8:117636951-117639767	chr8	117636951	117639767	2816	117636991
chr8:118548537-118554688	chr8	118548537	118554688	6151	118552101
chr8:118855564-118857103	chr8	118855564	118857103	1539	118855908
chr8:119109692-119112349	chr8	119109692	119112349	2657	119109791
chr8:119233073-119233946	chr8	119233073	119233946	873	119233750
chr8:119233946-119239916	chr8	119233946	119239916	5970	119237362
chr8:119254189-119257361	chr8	119254189	119257361	3172	119254769
chr8:119292033-119298187	chr8	119292033	119298187	6154	119295593
chr8:119306804-119312921	chr8	119306804	119312921	6117	119310344
chr8:119377922-119381978	chr8	119377922	119381978	4056	119380231
chr8:119521003-119527155	chr8	119521003	119527155	6152	119524582
chr8:120348977-120354404	chr8	120348977	120354404	5427	120351812
chr8:121026480-121028051	chr8	121026480	121028051	1571	121027615
chr8:121417870-121424035	chr8	121417870	121424035	6165	121421452
chr8:121911075-121911835	chr8	121911075	121911835	760	121911829
chr8:122001270-122007235	chr8	122001270	122007235	5965	122004655
chr8:122244418-122250436	chr8	122244418	122250436	6018	122247854
chr8:125582886-125588889	chr8	125582886	125588889	6003	125586274
chr8:126199419-126204425	chr8	126199419	126204425	5006	126202968
chr8:126341585-126347597	chr8	126341585	126347597	6012	126345017
chr8:126457999-126463437	chr8	126457999	126463437	5438	126460831
chr8:127044006-127046320	chr8	127044006	127046320	2314	127044557
chr8:127311575-127315431	chr8	127311575	127315431	3856	127315018
chr8:128343641-128349674	chr8	128343641	128349674	6033	128347085
chr8:128714351-128720388	chr8	128714351	128720388	6037	128717795
chr8:128744603-128750633	chr8	128744603	128750633	6030	128748047
chr8:128759848-128765995	chr8	128759848	128765995	6147	128763420
chr8:128801232-128807379	chr8	128801232	128807379	6147	128804788
chr8:129324372-129329792	chr8	129324372	129329792	5420	129327213
chr8:129732686-129738821	chr8	129732686	129738821	6135	129736217
chr8:131250361-131256478	chr8	131250361	131256478	6117	131253897
chr8:131266454-131269341	chr8	131266454	131269341	2887	131266770
chr8:131635171-131641188	chr8	131635171	131641188	6017	131638607
chr8:131770949-131776926	chr8	131770949	131776926	5977	131774338
chr8:131960878-131966221	chr8	131960878	131966221	5343	131963645
chr8:132598698-132601926	chr8	132598698	132601926	3228	132599348
chr8:132647325-132650529	chr8	132647325	132650529	3204	132647933
chr8:133865908-133869505	chr8	133865908	133869505	3597	133866928
chr8:134667623-134672332	chr8	134667623	134672332	4709	134671177
chr8:135259101-135265130	chr8	135259101	135265130	6029	135262540
chr8:135335387-135341541	chr8	135335387	135341541	6154	135338950
chr8:135875862-135881890	chr8	135875862	135881890	6028	135879298
chr8:136034069-136034959	chr8	136034069	136034959	890	136034207
chr8:137242314-137244157	chr8	137242314	137244157	1843	137243938
chr8:138116165-138122224	chr8	138116165	138122224	6059	138119603
chr8:138153318-138158990	chr8	138153318	138158990	5672	138156870
chr8:138335411-138339270	chr8	138335411	138339270	3859	138336681
chr8:138406241-138407909	chr8	138406241	138407909	1668	138406333
chr8:138443773-138447820	chr8	138443773	138447820	4047	138445227
chr8:138703662-138709792	chr8	138703662	138709792	6130	138707211
chr8:140382163-140388390	chr8	140382163	140388390	6227	140385741
chr8:141260608-141263374	chr8	141260608	141263374	2766	141260799
chr8:142849960-142856074	chr8	142849960	142856074	6114	142853498
chr8:142880162-142883509	chr8	142880162	142883509	3347	142880924
chr8:144570305-144573618	chr8	144570305	144573618	3313	144571056
chr8_KI270810v1_alt:159627-165649	chr8_KI270810v1_alt	159627	165649	6022	163057
chr8_KI270810v1_alt:193269-199298	chr8_KI270810v1_alt	193269	199298	6029	196712
chr8_KI270810v1_alt:208513-214660	chr8_KI270810v1_alt	208513	214660	6147	212084
chr8_KI270810v1_alt:249907-256054	chr8_KI270810v1_alt	249907	256054	6147	253463
chr8_KI270821v1_alt:579255-585170	chr8_KI270821v1_alt	579255	585170	5915	582716
chr8_KI270822v1_alt:560383-564562	chr8_KI270822v1_alt	560383	564562	4179	561986
chr8_KI270900v1_alt:217307-223284	chr8_KI270900v1_alt	217307	223284	5977	220692
chr8_KI270926v1_alt:20773-26750	chr8_KI270926v1_alt	20773	26750	5977	24158
chr8_KI270926v1_alt:128499-129579	chr8_KI270926v1_alt	128499	129579	1080	129060
chr9:139648-145712	chr9	139648	145712	6064	143118
chr9:1147406-1150355	chr9	1147406	1150355	2949	1147774
chr9:1223881-1229900	chr9	1223881	1229900	6019	1227310
chr9:1558434-1564568	chr9	1558434	1564568	6134	1561987
chr9:1749540-1755665	chr9	1749540	1755665	6125	1753084
chr9:1860887-1865128	chr9	1860887	1865128	4241	1862559
chr9:2444328-2447811	chr9	2444328	2447811	3483	2445198
chr9:2773425-2775753	chr9	2773425	2775753	2328	2774354
chr9:3106937-3110323	chr9	3106937	3110323	3386	3109824
chr9:3312678-3318534	chr9	3312678	3318534	5856	3315949
chr9:4466665-4472767	chr9	4466665	4472767	6102	4470178
chr9:4531071-4537200	chr9	4531071	4537200	6129	4534636
chr9:4605799-4611811	chr9	4605799	4611811	6012	4609220
chr9:5031771-5037865	chr9	5031771	5037865	6094	5035307
chr9:5241049-5243281	chr9	5241049	5243281	2232	5241940
chr9:5280034-5282833	chr9	5280034	5282833	2799	5280234
chr9:5292770-5299173	chr9	5292770	5299173	6403	5296596
chr9:5962145-5965069	chr9	5962145	5965069	2924	5962482
chr9:6135847-6141850	chr9	6135847	6141850	6003	6139256
chr9:6295355-6301521	chr9	6295355	6301521	6166	6298920
chr9:6335882-6342007	chr9	6335882	6342007	6125	6339424
chr9:6376264-6382430	chr9	6376264	6382430	6166	6379842
chr9:7217147-7222136	chr9	7217147	7222136	4989	7219552
chr9:7482123-7483500	chr9	7482123	7483500	1377	7482173
chr9:7667772-7668589	chr9	7667772	7668589	817	7667867
chr9:7712932-7719043	chr9	7712932	7719043	6111	7716470
chr9:8333418-8337593	chr9	8333418	8337593	4175	8335072
chr9:9081916-9084563	chr9	9081916	9084563	2647	9082035
chr9:9243165-9245778	chr9	9243165	9245778	2613	9243215
chr9:9425928-9432047	chr9	9425928	9432047	6119	9429475
chr9:9931213-9937220	chr9	9931213	9937220	6007	9934650
chr9:10140329-10143287	chr9	10140329	10143287	2958	10140672
chr9:10300249-10306428	chr9	10300249	10306428	6179	10303837
chr9:10473937-10478157	chr9	10473937	10478157	4220	10475558
chr9:10750787-10751980	chr9	10750787	10751980	1193	10751138
chr9:10778293-10784424	chr9	10778293	10784424	6131	10781844
chr9:10948798-10952661	chr9	10948798	10952661	3863	10950066
chr9:11285871-11289044	chr9	11285871	11289044	3173	11286443
chr9:11942866-11945839	chr9	11942866	11945839	2973	11945027
chr9:12333994-12340033	chr9	12333994	12340033	6039	12337442
chr9:12505506-12508944	chr9	12505506	12508944	3438	12506359
chr9:12558891-12559649	chr9	12558891	12559649	758	12559016
chr9:13037883-13043909	chr9	13037883	13043909	6026	13041323
chr9:13663183-13665086	chr9	13663183	13665086	1903	13663694
chr9:13795444-13798676	chr9	13795444	13798676	3232	13796100
chr9:13995393-14000932	chr9	13995393	14000932	5539	13998330
chr9:14457370-14460527	chr9	14457370	14460527	3157	14457941
chr9:14663995-14670015	chr9	14663995	14670015	6020	14667424
chr9:14681813-14686218	chr9	14681813	14686218	4405	14683625
chr9:14949416-14955872	chr9	14949416	14955872	6456	14953285
chr9:14968325-14973143	chr9	14968325	14973143	4818	14970540
chr9:15025833-15031344	chr9	15025833	15031344	5511	15028762
chr9:15037172-15040581	chr9	15037172	15040581	3409	15037998
chr9:15050673-15054819	chr9	15050673	15054819	4146	15053011
chr9:15628037-15634187	chr9	15628037	15634187	6150	15631594
chr9:15644266-15650411	chr9	15644266	15650411	6145	15647821
chr9:15746631-15752905	chr9	15746631	15752905	6274	15750393
chr9:15817209-15823334	chr9	15817209	15823334	6125	15820761
chr9:15902552-15908659	chr9	15902552	15908659	6107	15906097
chr9:15988448-15994589	chr9	15988448	15994589	6141	15992003
chr9:16223083-16229454	chr9	16223083	16229454	6371	16226876
chr9:17539561-17545580	chr9	17539561	17545580	6019	17542998
chr9:17546310-17549141	chr9	17546310	17549141	2831	17546551
chr9:17913481-17914901	chr9	17913481	17914901	1420	17914095
chr9:18304911-18311360	chr9	18304911	18311360	6449	18308760
chr9:18711233-18717230	chr9	18711233	18717230	5997	18714672
chr9:19001678-19004881	chr9	19001678	19004881	3203	19002318
chr9:19706702-19709910	chr9	19706702	19709910	3208	19707330
chr9:19833096-19837170	chr9	19833096	19837170	4074	19836652
chr9:19905883-19909480	chr9	19905883	19909480	3597	19906900
chr9:20102714-20108858	chr9	20102714	20108858	6144	20106272
chr9:20162400-20166794	chr9	20162400	20166794	4394	20162554
chr9:21220115-21223371	chr9	21220115	21223371	3256	21220792
chr9:21343535-21345851	chr9	21343535	21345851	2316	21344169
chr9:21536697-21541948	chr9	21536697	21541948	5251	21539358
chr9:21895879-21899384	chr9	21895879	21899384	3505	21896806
chr9:21910908-21914794	chr9	21910908	21914794	3886	21912206
chr9:22177101-22183145	chr9	22177101	22183145	6044	22180554
chr9:23105114-23111270	chr9	23105114	23111270	6156	23108650
chr9:23225534-23226123	chr9	23225534	23226123	589	23225658
chr9:23395777-23400347	chr9	23395777	23400347	4570	23397770
chr9:23991702-23997834	chr9	23991702	23997834	6132	23995269
chr9:24280172-24283494	chr9	24280172	24283494	3322	24280923
chr9:24858498-24861378	chr9	24858498	24861378	2880	24861361
chr9:24888445-24894183	chr9	24888445	24894183	5738	24892299
chr9:25102006-25108083	chr9	25102006	25108083	6077	25105558
chr9:25168445-25170026	chr9	25168445	25170026	1581	25169669
chr9:25763506-25770070	chr9	25763506	25770070	6564	25767446
chr9:25982529-25988735	chr9	25982529	25988735	6206	25986135
chr9:26044753-26048868	chr9	26044753	26048868	4115	26046280
chr9:26249770-26255795	chr9	26249770	26255795	6025	26253208
chr9:26277105-26283550	chr9	26277105	26283550	6445	26280980
chr9:26445522-26449701	chr9	26445522	26449701	4179	26447117
chr9:26480862-26482517	chr9	26480862	26482517	1655	26481394
chr9:26586379-26588506	chr9	26586379	26588506	2127	26587809
chr9:26834834-26837332	chr9	26834834	26837332	2498	26835581
chr9:27220506-27226733	chr9	27220506	27226733	6227	27224185
chr9:27239370-27245520	chr9	27239370	27245520	6150	27242934
chr9:27251179-27255812	chr9	27251179	27255812	4633	27255050
chr9:27648158-27651717	chr9	27648158	27651717	3559	27649059
chr9:27690519-27696535	chr9	27690519	27696535	6016	27693957
chr9:28243651-28246144	chr9	28243651	28246144	2493	28244879
chr9:28306341-28309595	chr9	28306341	28309595	3254	28307003
chr9:28348134-28354162	chr9	28348134	28354162	6028	28351574
chr9:28553073-28558157	chr9	28553073	28558157	5084	28555571
chr9:28878019-28879245	chr9	28878019	28879245	1226	28878412
chr9:28949099-28951276	chr9	28949099	28951276	2177	28949684
chr9:28989909-28996028	chr9	28989909	28996028	6119	28993440
chr9:29080975-29083593	chr9	29080975	29083593	2618	29081000
chr9:29270221-29276349	chr9	29270221	29276349	6128	29273762
chr9:29451910-29456736	chr9	29451910	29456736	4826	29454145
chr9:30106864-30112891	chr9	30106864	30112891	6027	30110302
chr9:30539475-30545465	chr9	30539475	30545465	5990	30542878
chr9:30594047-30597322	chr9	30594047	30597322	3275	30596100
chr9:31052381-31053816	chr9	31052381	31053816	1435	31052971
chr9:31294065-31300087	chr9	31294065	31300087	6022	31297504
chr9:31375488-31376899	chr9	31375488	31376899	1411	31375962
chr9:31552573-31553659	chr9	31552573	31553659	1086	31553033
chr9:31959379-31966330	chr9	31959379	31966330	6951	31963740
chr9:32098543-32104174	chr9	32098543	32104174	5631	32102048
chr9:32149073-32155113	chr9	32149073	32155113	6040	32152510
chr9:32187870-32191011	chr9	32187870	32191011	3141	32188431
chr9:32307714-32308446	chr9	32307714	32308446	732	32307861
chr9:32508302-32514736	chr9	32508302	32514736	6434	32512142
chr9:32684142-32690264	chr9	32684142	32690264	6122	32687690
chr9:32710379-32716388	chr9	32710379	32716388	6009	32713799
chr9:32729016-32735047	chr9	32729016	32735047	6031	32732455
chr9:32957812-32963956	chr9	32957812	32963956	6144	32961385
chr9:33085449-33091567	chr9	33085449	33091567	6118	33088994
chr9:33668370-33673489	chr9	33668370	33673489	5119	33670907
chr9:33725330-33728217	chr9	33725330	33728217	2887	33725632
chr9:34878249-34884385	chr9	34878249	34884385	6136	34881786
chr9:38779398-38785511	chr9	38779398	38785511	6113	38782921
chr9:39274395-39279954	chr9	39274395	39279954	5559	39277349
chr9:39426460-39431442	chr9	39426460	39431442	4982	39428891
chr9:40467350-40472775	chr9	40467350	40472775	5425	40470521
chr9:40875958-40879920	chr9	40875958	40879920	3962	40877342
chr9:40915781-40921920	chr9	40915781	40921920	6139	40919352
chr9:41149958-41155994	chr9	41149958	41155994	6036	41153427
chr9:42037282-42042241	chr9	42037282	42042241	4959	42039661
chr9:42116222-42120981	chr9	42116222	42120981	4759	42118100
chr9:42251321-42256298	chr9	42251321	42256298	4977	42253751
chr9:43097175-43101120	chr9	43097175	43101120	3945	43098866
chr9:60985203-60990185	chr9	60985203	60990185	4982	60987634
chr9:62003382-62009504	chr9	62003382	62009504	6122	62006914
chr9:63187465-63188801	chr9	63187465	63188801	1336	63188713
chr9:63302888-63308313	chr9	63302888	63308313	5425	63306059
chr9:63844628-63849587	chr9	63844628	63849587	4959	63846999
chr9:63979761-63985834	chr9	63979761	63985834	6073	63983241
chr9:64608831-64612787	chr9	64608831	64612787	3956	64610532
chr9:65061993-65068014	chr9	65061993	65068014	6021	65065432
chr9:65306103-65312178	chr9	65306103	65312178	6075	65309585
chr9:65939006-65940202	chr9	65939006	65940202	1196	65940114
chr9:69477110-69483129	chr9	69477110	69483129	6019	69480547
chr9:69506051-69512070	chr9	69506051	69512070	6019	69509494
chr9:69681863-69683221	chr9	69681863	69683221	1358	69682466
chr9:70234019-70240150	chr9	70234019	70240150	6131	70237573
chr9:70240311-70246471	chr9	70240311	70246471	6160	70243869
chr9:70756175-70759978	chr9	70756175	70759978	3803	70757408
chr9:71407104-71413258	chr9	71407104	71413258	6154	71410682
chr9:71597279-71601976	chr9	71597279	71601976	4697	71599400
chr9:72450718-72453753	chr9	72450718	72453753	3035	72451161
chr9:73311126-73311588	chr9	73311126	73311588	462	73311307
chr9:73782737-73789187	chr9	73782737	73789187	6450	73786604
chr9:74166162-74169592	chr9	74166162	74169592	3430	74167521
chr9:74424274-74430304	chr9	74424274	74430304	6030	74427712
chr9:75629448-75632650	chr9	75629448	75632650	3202	75630073
chr9:76670038-76676075	chr9	76670038	76676075	6037	76673478
chr9:77411685-77414734	chr9	77411685	77414734	3049	77412168
chr9:77623471-77629886	chr9	77623471	77629886	6415	77627307
chr9:77970555-77971783	chr9	77970555	77971783	1228	77971203
chr9:78054235-78060371	chr9	78054235	78060371	6136	78057790
chr9:78075588-78079760	chr9	78075588	78079760	4172	78078519
chr9:78336499-78340789	chr9	78336499	78340789	4290	78338201
chr9:78874536-78878680	chr9	78874536	78878680	4144	78876069
chr9:79438972-79444977	chr9	79438972	79444977	6005	79442394
chr9:79544529-79549734	chr9	79544529	79549734	5205	79547141
chr9:79733829-79734970	chr9	79733829	79734970	1141	79734783
chr9:79852753-79855461	chr9	79852753	79855461	2708	79852878
chr9:80117346-80122336	chr9	80117346	80122336	4990	80119745
chr9:80295160-80297981	chr9	80295160	80297981	2821	80295417
chr9:80526318-80530448	chr9	80526318	80530448	4130	80529055
chr9:80532537-80532823	chr9	80532537	80532823	286	80532649
chr9:80610825-80613164	chr9	80610825	80613164	2339	80611344
chr9:80816256-80820715	chr9	80816256	80820715	4459	80819419
chr9:80915880-80918967	chr9	80915880	80918967	3087	80916392
chr9:81162296-81168596	chr9	81162296	81168596	6300	81166006
chr9:81217155-81223297	chr9	81217155	81223297	6142	81220718
chr9:81432296-81438437	chr9	81432296	81438437	6141	81435852
chr9:82376572-82381102	chr9	82376572	82381102	4530	82379428
chr9:84625974-84629296	chr9	84625974	84629296	3322	84626715
chr9:85433088-85439559	chr9	85433088	85439559	6471	85436964
chr9:85758876-85762765	chr9	85758876	85762765	3889	85760193
chr9:86157088-86163107	chr9	86157088	86163107	6019	86160527
chr9:86204596-86206488	chr9	86204596	86206488	1892	86205353
chr9:86389971-86396129	chr9	86389971	86396129	6158	86393546
chr9:87041882-87047900	chr9	87041882	87047900	6018	87045315
chr9:87902138-87908249	chr9	87902138	87908249	6111	87905665
chr9:88297435-88300669	chr9	88297435	88300669	3234	88298093
chr9:88597321-88603641	chr9	88597321	88603641	6320	88600880
chr9:88907557-88911222	chr9	88907557	88911222	3665	88910535
chr9:89128334-89133917	chr9	89128334	89133917	5583	89131332
chr9:89909491-89910564	chr9	89909491	89910564	1073	89909986
chr9:90149604-90155634	chr9	90149604	90155634	6030	90153043
chr9:90192189-90198087	chr9	90192189	90198087	5898	90195747
chr9:90686272-90691756	chr9	90686272	90691756	5484	90689837
chr9:91282636-91285469	chr9	91282636	91285469	2833	91282886
chr9:92214410-92220428	chr9	92214410	92220428	6018	92217848
chr9:93841920-93843147	chr9	93841920	93843147	1227	93842168
chr9:94044846-94051360	chr9	94044846	94051360	6514	94047992
chr9:94216743-94222880	chr9	94216743	94222880	6137	94220309
chr9:95254280-95260702	chr9	95254280	95260702	6422	95258114
chr9:95697585-95703604	chr9	95697585	95703604	6019	95701016
chr9:96797005-96803185	chr9	96797005	96803185	6180	96800599
chr9:96823863-96826555	chr9	96823863	96826555	2692	96823978
chr9:97205143-97211302	chr9	97205143	97211302	6159	97208714
chr9:98508277-98513668	chr9	98508277	98513668	5391	98511831
chr9:99498741-99504759	chr9	99498741	99504759	6018	99502178
chr9:99988561-99994665	chr9	99988561	99994665	6104	99992091
chr9:100527228-100533251	chr9	100527228	100533251	6023	100530660
chr9:100690713-100696740	chr9	100690713	100696740	6027	100694153
chr9:100777638-100781301	chr9	100777638	100781301	3663	100778712
chr9:100798209-100801688	chr9	100798209	100801688	3479	100799104
chr9:100869583-100872933	chr9	100869583	100872933	3350	100870341
chr9:101290800-101296956	chr9	101290800	101296956	6156	101294376
chr9:101818386-101821978	chr9	101818386	101821978	3592	101819405
chr9:101836783-101839962	chr9	101836783	101839962	3179	101837357
chr9:102317291-102320603	chr9	102317291	102320603	3312	102318022
chr9:102337202-102343354	chr9	102337202	102343354	6152	102340767
chr9:102817608-102819715	chr9	102817608	102819715	2107	102817956
chr9:102901926-102905805	chr9	102901926	102905805	3879	102903306
chr9:103237485-103241471	chr9	103237485	103241471	3986	103240924
chr9:103752874-103753707	chr9	103752874	103753707	833	103753679
chr9:103860072-103864565	chr9	103860072	103864565	4493	103861969
chr9:104054450-104057392	chr9	104054450	104057392	2942	104054827
chr9:104716087-104720058	chr9	104716087	104720058	3971	104717468
chr9:105515391-105519740	chr9	105515391	105519740	4349	105519228
chr9:105563175-105569299	chr9	105563175	105569299	6124	105566719
chr9:105763404-105765097	chr9	105763404	105765097	1693	105763655
chr9:106604988-106611130	chr9	106604988	106611130	6142	106608537
chr9:106809184-106815350	chr9	106809184	106815350	6166	106812740
chr9:108503080-108507115	chr9	108503080	108507115	4035	108504531
chr9:108507112-108509951	chr9	108507112	108509951	2839	108507398
chr9:109835393-109841527	chr9	109835393	109841527	6134	109838959
chr9:110393398-110399498	chr9	110393398	110399498	6100	110396917
chr9:110417102-110423126	chr9	110417102	110423126	6024	110420541
chr9:110666274-110667601	chr9	110666274	110667601	1327	110666422
chr9:110791097-110797129	chr9	110791097	110797129	6032	110794537
chr9:111080973-111082108	chr9	111080973	111082108	1135	111081011
chr9:111199925-111202691	chr9	111199925	111202691	2766	111200097
chr9:111338188-111341126	chr9	111338188	111341126	2938	111339658
chr9:112978869-112981870	chr9	112978869	112981870	3001	112979319
chr9:114872392-114874187	chr9	114872392	114874187	1795	114873761
chr9:115723563-115729988	chr9	115723563	115729988	6425	115727401
chr9:115859642-115860821	chr9	115859642	115860821	1179	115860068
chr9:115919039-115920738	chr9	115919039	115920738	1699	115919377
chr9:116612164-116615887	chr9	116612164	116615887	3723	116613300
chr9:116679584-116683069	chr9	116679584	116683069	3485	116680448
chr9:118504546-118510677	chr9	118504546	118510677	6131	118508105
chr9:119169116-119175132	chr9	119169116	119175132	6016	119172555
chr9:119502617-119506717	chr9	119502617	119506717	4100	119505747
chr9:120055235-120061264	chr9	120055235	120061264	6029	120058676
chr9:120427787-120431275	chr9	120427787	120431275	3488	120428681
chr9:121099026-121104533	chr9	121099026	121104533	5507	121101975
chr9:122712001-122715958	chr9	122712001	122715958	3957	122713373
chr9:122762667-122766012	chr9	122762667	122766012	3345	122763405
chr9:123903370-123909365	chr9	123903370	123909365	5995	123906782
chr9:125010048-125016177	chr9	125010048	125016177	6129	125013604
chr9:126950504-126952129	chr9	126950504	126952129	1625	126951242
chr9:126993664-126999178	chr9	126993664	126999178	5514	126996606
chr9:132526540-132529519	chr9	132526540	132529519	2979	132526928
chr9:133310021-133316045	chr9	133310021	133316045	6024	133313451
chr9:134589317-134589739	chr9	134589317	134589739	422	134589640
chr9:135843899-135847065	chr9	135843899	135847065	3166	135844943
chr9_GL383539v1_alt:67942-69319	chr9_GL383539v1_alt	67942	69319	1377	67992
chr9_KI270823v1_alt:342003-348159	chr9_KI270823v1_alt	342003	348159	6156	345579
chrUn_GL000195v1:60020-63056	chrUn_GL000195v1	60020	63056	3036	60603
chrUn_GL000214v1:16861-22053	chrUn_GL000214v1	16861	22053	5192	19481
chrUn_GL000219v1:34100-40135	chrUn_GL000219v1	34100	40135	6035	37544
chrUn_GL000219v1:112280-114251	chrUn_GL000219v1	112280	114251	1971	112753
chrUn_KI270435v1:28230-34368	chrUn_KI270435v1	28230	34368	6138	31792
chrUn_KI270442v1:113598-119625	chrUn_KI270442v1	113598	119625	6027	117026
chrUn_KI270442v1:129596-133841	chrUn_KI270442v1	129596	133841	4245	131253
chrUn_KI270442v1:193873-198464	chrUn_KI270442v1	193873	198464	4591	195878
chrUn_KI270442v1:254024-260175	chrUn_KI270442v1	254024	260175	6151	257587
chrUn_KI270442v1:302002-306636	chrUn_KI270442v1	302002	306636	4634	305549
chrUn_KI270519v1:72743-78888	chrUn_KI270519v1	72743	78888	6145	76298
chrUn_KI270538v1:65899-71924	chrUn_KI270538v1	65899	71924	6025	69333
chrUn_KI270581v1:3066-7046	chrUn_KI270581v1	3066	7046	3980	5355
chrUn_KI270741v1:153009-157432	chrUn_KI270741v1	153009	157432	4423	156453
chrUn_KI270742v1:95140-101292	chrUn_KI270742v1	95140	101292	6152	98701
chrUn_KI270743v1:9059-15189	chrUn_KI270743v1	9059	15189	6130	12600
chrUn_KI270743v1:194328-199664	chrUn_KI270743v1	194328	199664	5336	197102
chrUn_KI270744v1:153631-156768	chrUn_KI270744v1	153631	156768	3137	156238
chrUn_KI270749v1:86303-89858	chrUn_KI270749v1	86303	89858	3555	87290
chrUn_KI270751v1:58557-64694	chrUn_KI270751v1	58557	64694	6137	62128
chrX:3059320-3065435	chrX	3059320	3065435	6115	3062878
chrX:4451358-4455208	chrX	4451358	4455208	3850	4455199
chrX:5480456-5486466	chrX	5480456	5486466	6010	5483879
chrX:5766462-5767505	chrX	5766462	5767505	1043	5767377
chrX:6933211-6938641	chrX	6933211	6938641	5430	6936058
chrX:7524332-7528919	chrX	7524332	7528919	4587	7526697
chrX:8772834-8779018	chrX	8772834	8779018	6184	8776525
chrX:10226050-10227531	chrX	10226050	10227531	1481	10226971
chrX:10638084-10644167	chrX	10638084	10644167	6083	10641590
chrX:10715059-10721211	chrX	10715059	10721211	6152	10718621
chrX:10869836-10873938	chrX	10869836	10873938	4102	10873403
chrX:10999119-11002369	chrX	10999119	11002369	3250	10999780
chrX:11359601-11362650	chrX	11359601	11362650	3049	11360080
chrX:11522047-11523558	chrX	11522047	11523558	1511	11522809
chrX:11573988-11574887	chrX	11573988	11574887	899	11574149
chrX:11707248-11713279	chrX	11707248	11713279	6031	11710687
chrX:11845330-11848075	chrX	11845330	11848075	2745	11845453
chrX:12106426-12112571	chrX	12106426	12112571	6145	12109994
chrX:12472534-12477469	chrX	12472534	12477469	4935	12474886
chrX:12539932-12544242	chrX	12539932	12544242	4310	12541664
chrX:12926214-12928913	chrX	12926214	12928913	2699	12926321
chrX:13406059-13408228	chrX	13406059	13408228	2169	13407510
chrX:13724626-13729626	chrX	13724626	13729626	5000	13728174
chrX:13976483-13978924	chrX	13976483	13978924	2441	13978252
chrX:14369731-14375231	chrX	14369731	14375231	5500	14372655
chrX:14391832-14396877	chrX	14391832	14396877	5045	14394391
chrX:14809187-14815329	chrX	14809187	14815329	6142	14812739
chrX:15088421-15094558	chrX	15088421	15094558	6137	15091974
chrX:16321645-16327801	chrX	16321645	16327801	6156	16325213
chrX:16360076-16366218	chrX	16360076	16366218	6142	16363629
chrX:16497356-16503511	chrX	16497356	16503511	6155	16500907
chrX:16598096-16599238	chrX	16598096	16599238	1142	16598632
chrX:18105518-18110908	chrX	18105518	18110908	5390	18108325
chrX:19142668-19148700	chrX	19142668	19148700	6032	19146108
chrX:19417065-19423189	chrX	19417065	19423189	6124	19420607
chrX:19509238-19510977	chrX	19509238	19510977	1739	19510159
chrX:20275604-20279105	chrX	20275604	20279105	3501	20277133
chrX:20771374-20776574	chrX	20771374	20776574	5200	20774738
chrX:20845443-20851624	chrX	20845443	20851624	6181	20849037
chrX:20874260-20880729	chrX	20874260	20880729	6469	20878164
chrX:21092108-21095462	chrX	21092108	21095462	3354	21092861
chrX:21139560-21140742	chrX	21139560	21140742	1182	21139910
chrX:21230875-21231838	chrX	21230875	21231838	963	21231682
chrX:21339462-21345718	chrX	21339462	21345718	6256	21343135
chrX:21544587-21550754	chrX	21544587	21550754	6167	21548495
chrX:22238142-22244439	chrX	22238142	22244439	6297	22241851
chrX:22609188-22615319	chrX	22609188	22615319	6131	22612729
chrX:22658667-22660747	chrX	22658667	22660747	2080	22660096
chrX:22676858-22682604	chrX	22676858	22682604	5746	22680385
chrX:22790732-22794578	chrX	22790732	22794578	3846	22792652
chrX:22866376-22872852	chrX	22866376	22872852	6476	22870259
chrX:23238516-23244575	chrX	23238516	23244575	6059	23241954
chrX:23258400-23262059	chrX	23258400	23262059	3659	23259482
chrX:24336529-24339440	chrX	24336529	24339440	2911	24336859
chrX:25328668-25334188	chrX	25328668	25334188	5520	25331611
chrX:25772423-25775961	chrX	25772423	25775961	3538	25773374
chrX:25935146-25939818	chrX	25935146	25939818	4672	25937246
chrX:26182226-26186356	chrX	26182226	26186356	4130	26183773
chrX:26334008-26340104	chrX	26334008	26340104	6096	26337550
chrX:26491159-26492515	chrX	26491159	26492515	1356	26491311
chrX:27225590-27227519	chrX	27225590	27227519	1929	27225888
chrX:27644680-27644752	chrX	27644680	27644752	72	27644704
chrX:27758585-27764733	chrX	27758585	27764733	6148	27762126
chrX:28206791-28212789	chrX	28206791	28212789	5998	28210199
chrX:28455640-28459806	chrX	28455640	28459806	4166	28458754
chrX:30012178-30015061	chrX	30012178	30015061	2883	30012477
chrX:31531726-31535639	chrX	31531726	31535639	3913	31534060
chrX:31688094-31691128	chrX	31688094	31691128	3034	31688543
chrX:32312621-32315524	chrX	32312621	32315524	2903	32313010
chrX:32730898-32736929	chrX	32730898	32736929	6031	32734338
chrX:33405993-33406327	chrX	33405993	33406327	334	33406131
chrX:33507808-33509268	chrX	33507808	33509268	1460	33508180
chrX:34167157-34169233	chrX	34167157	34169233	2076	34167854
chrX:34415190-34421162	chrX	34415190	34421162	5972	34418581
chrX:35138379-35140995	chrX	35138379	35140995	2616	35138395
chrX:35901236-35902900	chrX	35901236	35902900	1664	35902155
chrX:37398040-37403626	chrX	37398040	37403626	5586	37401058
chrX:37560946-37564128	chrX	37560946	37564128	3182	37561538
chrX:37748287-37748796	chrX	37748287	37748796	509	37748777
chrX:37768611-37774761	chrX	37768611	37774761	6150	37772172
chrX:39090976-39093101	chrX	39090976	39093101	2125	39092687
chrX:41564648-41568251	chrX	41564648	41568251	3603	41565660
chrX:41808585-41814752	chrX	41808585	41814752	6167	41812163
chrX:42004299-42010329	chrX	42004299	42010329	6030	42007736
chrX:42506724-42513168	chrX	42506724	42513168	6444	42510606
chrX:42589683-42595809	chrX	42589683	42595809	6126	42593219
chrX:42652812-42656856	chrX	42652812	42656856	4044	42654267
chrX:42888370-42894396	chrX	42888370	42894396	6026	42891780
chrX:43781985-43783235	chrX	43781985	43783235	1250	43782565
chrX:44252830-44258609	chrX	44252830	44258609	5779	44256710
chrX:46086818-46093273	chrX	46086818	46093273	6455	46090690
chrX:46103860-46110008	chrX	46103860	46110008	6148	46107425
chrX:46655357-46661385	chrX	46655357	46661385	6028	46658797
chrX:47789696-47792833	chrX	47789696	47792833	3137	47791427
chrX:48433480-48438697	chrX	48433480	48438697	5217	48437015
chrX:48869850-48874138	chrX	48869850	48874138	4288	48871561
chrX:50060143-50066175	chrX	50060143	50066175	6032	50063583
chrX:50737603-50740338	chrX	50737603	50740338	2735	50737752
chrX:51113128-51117875	chrX	51113128	51117875	4747	51115287
chrX:51246451-51249290	chrX	51246451	51249290	2839	51246697
chrX:51262091-51268161	chrX	51262091	51268161	6070	51265574
chrX:51576975-51581780	chrX	51576975	51581780	4805	51579225
chrX:51623141-51629261	chrX	51623141	51629261	6120	51626679
chrX:51644758-51650770	chrX	51644758	51650770	6012	51648194
chrX:52111122-52117265	chrX	52111122	52117265	6143	52114688
chrX:52119155-52125312	chrX	52119155	52125312	6157	52122723
chrX:52159921-52165314	chrX	52159921	52165314	5393	52163477
chrX:52170777-52176924	chrX	52170777	52176924	6147	52174342
chrX:52222105-52228125	chrX	52222105	52228125	6020	52225536
chrX:52291785-52297932	chrX	52291785	52297932	6147	52295341
chrX:52877764-52881822	chrX	52877764	52881822	4058	52879216
chrX:53783362-53789523	chrX	53783362	53789523	6161	53786910
chrX:53888926-53894539	chrX	53888926	53894539	5613	53891946
chrX:54143165-54146317	chrX	54143165	54146317	3152	54143739
chrX:54667725-54669574	chrX	54667725	54669574	1849	54668383
chrX:54679147-54681498	chrX	54679147	54681498	2351	54680472
chrX:54697499-54702045	chrX	54697499	54702045	4546	54701055
chrX:54829326-54830942	chrX	54829326	54830942	1616	54829864
chrX:54938374-54942399	chrX	54938374	54942399	4025	54939817
chrX:55241315-55244279	chrX	55241315	55244279	2964	55241692
chrX:55345202-55348236	chrX	55345202	55348236	3034	55345650
chrX:55396514-55401932	chrX	55396514	55401932	5418	55400096
chrX:55416116-55420875	chrX	55416116	55420875	4759	55419797
chrX:55426516-55432678	chrX	55426516	55432678	6162	55430101
chrX:55627239-55631768	chrX	55627239	55631768	4529	55629224
chrX:55689388-55693024	chrX	55689388	55693024	3636	55690461
chrX:55702125-55708588	chrX	55702125	55708588	6463	55706006
chrX:55827091-55832491	chrX	55827091	55832491	5400	55830647
chrX:55936391-55942528	chrX	55936391	55942528	6137	55939950
chrX:56008224-56013110	chrX	56008224	56013110	4886	56012027
chrX:56183880-56190030	chrX	56183880	56190030	6150	56187447
chrX:56194093-56200236	chrX	56194093	56200236	6143	56197662
chrX:56292513-56297093	chrX	56292513	56297093	4580	56294526
chrX:56319673-56323980	chrX	56319673	56323980	4307	56323214
chrX:56370882-56376280	chrX	56370882	56376280	5398	56373689
chrX:56438110-56442149	chrX	56438110	56442149	4039	56439562
chrX:56636008-56642163	chrX	56636008	56642163	6155	56639575
chrX:56673700-56679846	chrX	56673700	56679846	6146	56677258
chrX:56695884-56701916	chrX	56695884	56701916	6032	56699324
chrX:56869002-56875125	chrX	56869002	56875125	6123	56872547
chrX:56896026-56900071	chrX	56896026	56900071	4045	56897484
chrX:56970531-56972908	chrX	56970531	56972908	2377	56971069
chrX:57094905-57100758	chrX	57094905	57100758	5853	57098195
chrX:57271026-57275268	chrX	57271026	57275268	4242	57274333
chrX:57275546-57279610	chrX	57275546	57279610	4064	57276999
chrX:57295486-57301607	chrX	57295486	57301607	6121	57299028
chrX:57313485-57320856	chrX	57313485	57320856	7371	57318595
chrX:57336543-57338063	chrX	57336543	57338063	1520	57337330
chrX:57381570-57385292	chrX	57381570	57385292	3722	57382750
chrX:57458529-57464428	chrX	57458529	57464428	5899	57462232
chrX:57467124-57472422	chrX	57467124	57472422	5298	57470671
chrX:57479847-57480406	chrX	57479847	57480406	559	57480186
chrX:57501756-57507892	chrX	57501756	57507892	6136	57505301
chrX:57559480-57563525	chrX	57559480	57563525	4045	57560936
chrX:57571488-57573874	chrX	57571488	57573874	2386	57572724
chrX:57625678-57629380	chrX	57625678	57629380	3702	57627117
chrX:57629388-57635409	chrX	57629388	57635409	6021	57632828
chrX:57662326-57664836	chrX	57662326	57664836	2510	57662625
chrX:57684358-57690416	chrX	57684358	57690416	6058	57687825
chrX:57708529-57713904	chrX	57708529	57713904	5375	57712088
chrX:57744004-57750263	chrX	57744004	57750263	6259	57747693
chrX:57855381-57859635	chrX	57855381	57859635	4254	57858536
chrX:57863194-57869305	chrX	57863194	57869305	6111	57866717
chrX:57953449-57956773	chrX	57953449	57956773	3324	57954228
chrX:58108097-58114248	chrX	58108097	58114248	6151	58111665
chrX:58397228-58401785	chrX	58397228	58401785	4557	58399199
chrX:58478139-58479637	chrX	58478139	58479637	1498	58478164
chrX:58510362-58516787	chrX	58510362	58516787	6425	58514203
chrX:62517103-62523125	chrX	62517103	62523125	6022	62520536
chrX:62742585-62748352	chrX	62742585	62748352	5767	62745755
chrX:62782921-62783733	chrX	62782921	62783733	812	62783384
chrX:62821723-62825745	chrX	62821723	62825745	4022	62823157
chrX:62855626-62858084	chrX	62855626	62858084	2458	62856355
chrX:62887815-62894254	chrX	62887815	62894254	6439	62891663
chrX:62946944-62951714	chrX	62946944	62951714	4770	62949146
chrX:63067341-63070514	chrX	63067341	63070514	3173	63067911
chrX:63102918-63109062	chrX	63102918	63109062	6144	63106496
chrX:63479530-63484467	chrX	63479530	63484467	4937	63481893
chrX:63492091-63498252	chrX	63492091	63498252	6161	63495665
chrX:63519156-63525277	chrX	63519156	63525277	6121	63522689
chrX:63797473-63803907	chrX	63797473	63803907	6434	63801318
chrX:63838642-63844790	chrX	63838642	63844790	6148	63842200
chrX:63904831-63908945	chrX	63904831	63908945	4114	63906595
chrX:63936578-63941437	chrX	63936578	63941437	4859	63938844
chrX:63986928-63989280	chrX	63986928	63989280	2352	63987515
chrX:64141660-64144676	chrX	64141660	64144676	3016	64142071
chrX:64153899-64158372	chrX	64153899	64158372	4473	64155737
chrX:64282840-64289023	chrX	64282840	64289023	6183	64286386
chrX:64363616-64369772	chrX	64363616	64369772	6156	64367183
chrX:64517527-64520007	chrX	64517527	64520007	2480	64519533
chrX:64618959-64620273	chrX	64618959	64620273	1314	64619419
chrX:64635270-64635506	chrX	64635270	64635506	236	64635389
chrX:64808404-64814530	chrX	64808404	64814530	6126	64811940
chrX:64878690-64884685	chrX	64878690	64884685	5995	64882089
chrX:64934544-64940025	chrX	64934544	64940025	5481	64938359
chrX:65003891-65006718	chrX	65003891	65006718	2827	65004155
chrX:65176569-65179418	chrX	65176569	65179418	2849	65176853
chrX:65224382-65230547	chrX	65224382	65230547	6165	65227957
chrX:65282496-65283633	chrX	65282496	65283633	1137	65282897
chrX:65308251-65312155	chrX	65308251	65312155	3904	65309570
chrX:65378596-65384525	chrX	65378596	65384525	5929	65382026
chrX:65458097-65461872	chrX	65458097	65461872	3775	65459281
chrX:65778304-65781476	chrX	65778304	65781476	3172	65778913
chrX:65799093-65801884	chrX	65799093	65801884	2791	65800052
chrX:65964415-65967676	chrX	65964415	65967676	3261	65965091
chrX:66347285-66352091	chrX	66347285	66352091	4806	66349523
chrX:66453841-66459991	chrX	66453841	66459991	6150	66457403
chrX:66566004-66567769	chrX	66566004	66567769	1765	66566650
chrX:66575651-66577277	chrX	66575651	66577277	1626	66577259
chrX:66582813-66584303	chrX	66582813	66584303	1490	66583944
chrX:66798960-66805034	chrX	66798960	66805034	6074	66802352
chrX:66942792-66948066	chrX	66942792	66948066	5274	66946230
chrX:66952866-66955051	chrX	66952866	66955051	2185	66953235
chrX:67026177-67032317	chrX	67026177	67032317	6140	67029743
chrX:67057359-67058612	chrX	67057359	67058612	1253	67057725
chrX:67195299-67197928	chrX	67195299	67197928	2629	67196316
chrX:67234097-67239007	chrX	67234097	67239007	4910	67237655
chrX:67268465-67272568	chrX	67268465	67272568	4103	67269982
chrX:67361819-67364106	chrX	67361819	67364106	2287	67362572
chrX:67398028-67398969	chrX	67398028	67398969	941	67398882
chrX:67456155-67462574	chrX	67456155	67462574	6419	67460020
chrX:67488333-67494506	chrX	67488333	67494506	6173	67491917
chrX:67514514-67517754	chrX	67514514	67517754	3240	67515911
chrX:67821970-67825140	chrX	67821970	67825140	3170	67822559
chrX:67942528-67948687	chrX	67942528	67948687	6159	67946094
chrX:67964640-67967281	chrX	67964640	67967281	2641	67964699
chrX:67991591-67994540	chrX	67991591	67994540	2949	67992331
chrX:68010626-68013161	chrX	68010626	68013161	2535	68012731
chrX:68102132-68105811	chrX	68102132	68105811	3679	68102950
chrX:68168064-68169102	chrX	68168064	68169102	1038	68169078
chrX:68216915-68222939	chrX	68216915	68222939	6024	68220355
chrX:68224756-68230924	chrX	68224756	68230924	6168	68228332
chrX:68602274-68608404	chrX	68602274	68608404	6130	68605817
chrX:68736250-68742398	chrX	68736250	68742398	6148	68739812
chrX:69350757-69356897	chrX	69350757	69356897	6140	69354315
chrX:69448371-69454392	chrX	69448371	69454392	6021	69451801
chrX:69983878-69987287	chrX	69983878	69987287	3409	69984695
chrX:70100105-70104258	chrX	70100105	70104258	4153	70101667
chrX:70600325-70601535	chrX	70600325	70601535	1210	70601442
chrX:70638902-70644939	chrX	70638902	70644939	6037	70642343
chrX:70728178-70734314	chrX	70728178	70734314	6136	70731728
chrX:70755624-70761735	chrX	70755624	70761735	6111	70759192
chrX:70780333-70786481	chrX	70780333	70786481	6148	70783901
chrX:70812602-70814342	chrX	70812602	70814342	1740	70813021
chrX:70838498-70844621	chrX	70838498	70844621	6123	70842055
chrX:70864769-70869031	chrX	70864769	70869031	4262	70866470
chrX:70892745-70894345	chrX	70892745	70894345	1600	70894147
chrX:71829672-71836106	chrX	71829672	71836106	6434	71833521
chrX:72442657-72446687	chrX	72442657	72446687	4030	72444110
chrX:72446692-72449580	chrX	72446692	72449580	2888	72447013
chrX:72585447-72591573	chrX	72585447	72591573	6126	72589003
chrX:72670442-72672022	chrX	72670442	72672022	1580	72670509
chrX:72889430-72895602	chrX	72889430	72895602	6172	72893047
chrX:72906633-72909260	chrX	72906633	72909260	2627	72906717
chrX:72967768-72970683	chrX	72967768	72970683	2915	72968078
chrX:72980711-72986876	chrX	72980711	72986876	6165	72984303
chrX:73052060-73058499	chrX	73052060	73058499	6439	73055923
chrX:73059663-73065814	chrX	73059663	73065814	6151	73063232
chrX:73106142-73112170	chrX	73106142	73112170	6028	73109582
chrX:73116909-73122938	chrX	73116909	73122938	6029	73120350
chrX:73184900-73190725	chrX	73184900	73190725	5825	73188414
chrX:73229844-73235732	chrX	73229844	73235732	5888	73233160
chrX:73281377-73287502	chrX	73281377	73287502	6125	73284915
chrX:73306106-73309530	chrX	73306106	73309530	3424	73309343
chrX:73374722-73380848	chrX	73374722	73380848	6126	73378239
chrX:73380992-73387014	chrX	73380992	73387014	6022	73384422
chrX:73500774-73504533	chrX	73500774	73504533	3759	73501882
chrX:73511014-73517074	chrX	73511014	73517074	6060	73514482
chrX:73542581-73546602	chrX	73542581	73546602	4021	73544030
chrX:73546601-73551102	chrX	73546601	73551102	4501	73548517
chrX:73600784-73602248	chrX	73600784	73602248	1464	73602141
chrX:73692763-73696717	chrX	73692763	73696717	3954	73694228
chrX:73701955-73707545	chrX	73701955	73707545	5590	73704970
chrX:73771502-73776590	chrX	73771502	73776590	5088	73773990
chrX:73887139-73891302	chrX	73887139	73891302	4163	73888707
chrX:73896004-73898836	chrX	73896004	73898836	2832	73896377
chrX:74695718-74701870	chrX	74695718	74701870	6152	74699282
chrX:74712706-74718083	chrX	74712706	74718083	5377	74715519
chrX:74863185-74864384	chrX	74863185	74864384	1199	74863685
chrX:74882161-74887558	chrX	74882161	74887558	5397	74885722
chrX:74953403-74958004	chrX	74953403	74958004	4601	74956817
chrX:75126329-75129597	chrX	75126329	75129597	3268	75126982
chrX:75231937-75237961	chrX	75231937	75237961	6024	75235361
chrX:75247137-75253201	chrX	75247137	75253201	6064	75250635
chrX:75267587-75270166	chrX	75267587	75270166	2579	75268332
chrX:75451827-75454667	chrX	75451827	75454667	2840	75453464
chrX:75491646-75495944	chrX	75491646	75495944	4298	75493357
chrX:75511661-75513243	chrX	75511661	75513243	1582	75511711
chrX:75514806-75517747	chrX	75514806	75517747	2941	75515149
chrX:75586528-75592512	chrX	75586528	75592512	5984	75589928
chrX:75614270-75615934	chrX	75614270	75615934	1664	75615214
chrX:75616399-75622529	chrX	75616399	75622529	6130	75619951
chrX:75755058-75756129	chrX	75755058	75756129	1071	75755307
chrX:75845246-75846297	chrX	75845246	75846297	1051	75845713
chrX:75925016-75928703	chrX	75925016	75928703	3687	75928521
chrX:75958784-75959917	chrX	75958784	75959917	1133	75959769
chrX:76068803-76074837	chrX	76068803	76074837	6034	76072243
chrX:76159024-76165491	chrX	76159024	76165491	6467	76162880
chrX:76210967-76215333	chrX	76210967	76215333	4366	76212742
chrX:76267405-76273429	chrX	76267405	76273429	6024	76270844
chrX:76287997-76294015	chrX	76287997	76294015	6018	76291429
chrX:76379416-76385828	chrX	76379416	76385828	6412	76383255
chrX:76414830-76420151	chrX	76414830	76420151	5321	76418314
chrX:76559551-76565702	chrX	76559551	76565702	6151	76563116
chrX:76568046-76574210	chrX	76568046	76574210	6164	76571598
chrX:76672388-76674411	chrX	76672388	76674411	2023	76673205
chrX:76759541-76762439	chrX	76759541	76762439	2898	76759878
chrX:76844457-76847722	chrX	76844457	76847722	3265	76845129
chrX:76884309-76888356	chrX	76884309	76888356	4047	76885762
chrX:76924366-76930511	chrX	76924366	76930511	6145	76927926
chrX:76933925-76937822	chrX	76933925	76937822	3897	76937798
chrX:76945913-76948133	chrX	76945913	76948133	2220	76946676
chrX:76978611-76984765	chrX	76978611	76984765	6154	76982173
chrX:77046226-77052252	chrX	77046226	77052252	6026	77049665
chrX:77089274-77095414	chrX	77089274	77095414	6140	77092829
chrX:77227348-77228885	chrX	77227348	77228885	1537	77228193
chrX:77244267-77250292	chrX	77244267	77250292	6025	77247706
chrX:77305042-77310585	chrX	77305042	77310585	5543	77308005
chrX:77315539-77318658	chrX	77315539	77318658	3119	77316175
chrX:77318902-77325035	chrX	77318902	77325035	6133	77322441
chrX:77333958-77340098	chrX	77333958	77340098	6140	77337526
chrX:77389913-77396319	chrX	77389913	77396319	6406	77393767
chrX:77470641-77476770	chrX	77470641	77476770	6129	77474189
chrX:77496496-77500699	chrX	77496496	77500699	4203	77498136
chrX:77530645-77533792	chrX	77530645	77533792	3147	77531207
chrX:77539543-77543954	chrX	77539543	77543954	4411	77541392
chrX:77719449-77723283	chrX	77719449	77723283	3834	77720750
chrX:78177566-78179165	chrX	78177566	78179165	1599	78179017
chrX:78179162-78179658	chrX	78179162	78179658	496	78179304
chrX:78188849-78195000	chrX	78188849	78195000	6151	78192413
chrX:78409862-78414779	chrX	78409862	78414779	4917	78412190
chrX:78549325-78553265	chrX	78549325	78553265	3940	78552223
chrX:79196565-79201431	chrX	79196565	79201431	4866	79198783
chrX:79224935-79225785	chrX	79224935	79225785	850	79225110
chrX:79277351-79280383	chrX	79277351	79280383	3032	79277782
chrX:79389544-79391933	chrX	79389544	79391933	2389	79390095
chrX:79483004-79487391	chrX	79483004	79487391	4387	79485651
chrX:79493851-79498668	chrX	79493851	79498668	4817	79497361
chrX:79507342-79510088	chrX	79507342	79510088	2746	79507509
chrX:79901676-79905876	chrX	79901676	79905876	4200	79902453
chrX:79923865-79926354	chrX	79923865	79926354	2489	79925563
chrX:79926799-79932829	chrX	79926799	79932829	6030	79930238
chrX:80189756-80192515	chrX	80189756	80192515	2759	80191021
chrX:80273426-80279879	chrX	80273426	80279879	6453	80277316
chrX:80321415-80325569	chrX	80321415	80325569	4154	80323003
chrX:80383868-80386568	chrX	80383868	80386568	2700	80383988
chrX:80405241-80411257	chrX	80405241	80411257	6016	80408672
chrX:80462184-80468712	chrX	80462184	80468712	6528	80466133
chrX:80593493-80596557	chrX	80593493	80596557	3064	80593975
chrX:80650595-80656722	chrX	80650595	80656722	6127	80654136
chrX:80766637-80771565	chrX	80766637	80771565	4928	80770175
chrX:80936569-80942693	chrX	80936569	80942693	6124	80940124
chrX:81026834-81032986	chrX	81026834	81032986	6152	81030399
chrX:81143378-81149629	chrX	81143378	81149629	6251	81147072
chrX:81175903-81181203	chrX	81175903	81181203	5300	81178625
chrX:81449935-81454780	chrX	81449935	81454780	4845	81452815
chrX:81686045-81688835	chrX	81686045	81688835	2790	81687494
chrX:81743176-81749309	chrX	81743176	81749309	6133	81746721
chrX:81792122-81797219	chrX	81792122	81797219	5097	81794634
chrX:81841153-81847184	chrX	81841153	81847184	6031	81844592
chrX:81940337-81946429	chrX	81940337	81946429	6092	81943789
chrX:81981453-81987740	chrX	81981453	81987740	6287	81985166
chrX:82326098-82328854	chrX	82326098	82328854	2756	82326293
chrX:82714375-82714972	chrX	82714375	82714972	597	82714438
chrX:82856479-82859238	chrX	82856479	82859238	2759	82856644
chrX:83085729-83086490	chrX	83085729	83086490	761	83086101
chrX:83094921-83097635	chrX	83094921	83097635	2714	83095044
chrX:83154295-83157343	chrX	83154295	83157343	3048	83154750
chrX:83286297-83292422	chrX	83286297	83292422	6125	83289853
chrX:83407138-83413200	chrX	83407138	83413200	6062	83410634
chrX:83542396-83548420	chrX	83542396	83548420	6024	83545834
chrX:83750500-83756648	chrX	83750500	83756648	6148	83754059
chrX:83778887-83780595	chrX	83778887	83780595	1708	83780324
chrX:83839860-83844072	chrX	83839860	83844072	4212	83841490
chrX:83928747-83929035	chrX	83928747	83929035	288	83928871
chrX:83955774-83959198	chrX	83955774	83959198	3424	83957213
chrX:84008825-84013115	chrX	84008825	84013115	4290	84012421
chrX:84398135-84402219	chrX	84398135	84402219	4084	84399638
chrX:84555542-84561688	chrX	84555542	84561688	6146	84559104
chrX:84700359-84703226	chrX	84700359	84703226	2867	84700630
chrX:84993497-84994976	chrX	84993497	84994976	1479	84993672
chrX:85146837-85153009	chrX	85146837	85153009	6172	85150389
chrX:85320258-85323630	chrX	85320258	85323630	3372	85321016
chrX:85529213-85535230	chrX	85529213	85535230	6017	85532641
chrX:85583161-85589299	chrX	85583161	85589299	6138	85586711
chrX:85740889-85745082	chrX	85740889	85745082	4193	85742467
chrX:86002434-86008415	chrX	86002434	86008415	5981	86005837
chrX:86336355-86339187	chrX	86336355	86339187	2832	86339140
chrX:86855995-86858135	chrX	86855995	86858135	2140	86856370
chrX:86969631-86975651	chrX	86969631	86975651	6020	86973064
chrX:87112391-87115656	chrX	87112391	87115656	3265	87113071
chrX:87116306-87122337	chrX	87116306	87122337	6031	87119747
chrX:87128322-87133848	chrX	87128322	87133848	5526	87131960
chrX:87254325-87259773	chrX	87254325	87259773	5448	87257160
chrX:87278642-87278961	chrX	87278642	87278961	319	87278882
chrX:87778111-87784051	chrX	87778111	87784051	5940	87781978
chrX:87821407-87827419	chrX	87821407	87827419	6012	87824833
chrX:88009210-88010899	chrX	88009210	88010899	1689	88010499
chrX:88207885-88213919	chrX	88207885	88213919	6034	88211326
chrX:89292629-89298657	chrX	89292629	89298657	6028	89296070
chrX:89673816-89680324	chrX	89673816	89680324	6508	89677701
chrX:90649131-90650966	chrX	90649131	90650966	1835	90650914
chrX:90836230-90842367	chrX	90836230	90842367	6137	90839777
chrX:91191654-91192507	chrX	91191654	91192507	853	91191806
chrX:91321211-91324041	chrX	91321211	91324041	2830	91322142
chrX:91511426-91515304	chrX	91511426	91515304	3878	91514178
chrX:91587981-91591999	chrX	91587981	91591999	4018	91589395
chrX:91627096-91633253	chrX	91627096	91633253	6157	91630665
chrX:91752800-91758828	chrX	91752800	91758828	6028	91756236
chrX:92019768-92026192	chrX	92019768	92026192	6424	92023589
chrX:92215061-92221212	chrX	92215061	92221212	6151	92218621
chrX:92715936-92721671	chrX	92715936	92721671	5735	92719087
chrX:92897831-92899875	chrX	92897831	92899875	2044	92898160
chrX:93060238-93066331	chrX	93060238	93066331	6093	93063742
chrX:93132741-93136642	chrX	93132741	93136642	3901	93134094
chrX:93627330-93633481	chrX	93627330	93633481	6151	93630895
chrX:93939741-93945900	chrX	93939741	93945900	6159	93943310
chrX:94637512-94639391	chrX	94637512	94639391	1879	94637808
chrX:94791756-94793430	chrX	94791756	94793430	1674	94792405
chrX:94862375-94868400	chrX	94862375	94868400	6025	94865809
chrX:94942308-94946307	chrX	94942308	94946307	3999	94946183
chrX:95665877-95670504	chrX	95665877	95670504	4627	95669374
chrX:95744462-95746600	chrX	95744462	95746600	2138	95746152
chrX:95811354-95812590	chrX	95811354	95812590	1236	95811488
chrX:96010392-96011689	chrX	96010392	96011689	1297	96011576
chrX:96187036-96190667	chrX	96187036	96190667	3631	96188080
chrX:96214214-96220667	chrX	96214214	96220667	6453	96218099
chrX:96269391-96275726	chrX	96269391	96275726	6335	96272939
chrX:96486743-96492571	chrX	96486743	96492571	5828	96489978
chrX:96584627-96590094	chrX	96584627	96590094	5467	96587512
chrX:96597640-96603783	chrX	96597640	96603783	6143	96601196
chrX:97199927-97206335	chrX	97199927	97206335	6408	97203745
chrX:97409398-97414370	chrX	97409398	97414370	4972	97412979
chrX:97921050-97926456	chrX	97921050	97926456	5406	97924620
chrX:98147472-98149477	chrX	98147472	98149477	2005	98147984
chrX:98300352-98306364	chrX	98300352	98306364	6012	98303773
chrX:99234633-99240760	chrX	99234633	99240760	6127	99238176
chrX:99805556-99811344	chrX	99805556	99811344	5788	99808758
chrX:99882642-99886651	chrX	99882642	99886651	4009	99884076
chrX:100050784-100056927	chrX	100050784	100056927	6143	100054335
chrX:100134937-100140964	chrX	100134937	100140964	6027	100138378
chrX:100255486-100261633	chrX	100255486	100261633	6147	100259049
chrX:100550262-100555448	chrX	100550262	100555448	5186	100553703
chrX:101471544-101474982	chrX	101471544	101474982	3438	101474383
chrX:101524342-101530496	chrX	101524342	101530496	6154	101527905
chrX:101540951-101546366	chrX	101540951	101546366	5415	101543775
chrX:101566556-101570789	chrX	101566556	101570789	4233	101570399
chrX:101940682-101942521	chrX	101940682	101942521	1839	101940699
chrX:101950290-101956340	chrX	101950290	101956340	6050	101953770
chrX:101994202-101997402	chrX	101994202	101997402	3200	101994810
chrX:102033548-102037582	chrX	102033548	102037582	4034	102035002
chrX:102037636-102041363	chrX	102037636	102041363	3727	102038770
chrX:102264895-102269452	chrX	102264895	102269452	4557	102266862
chrX:102450495-102456631	chrX	102450495	102456631	6136	102454040
chrX:102522141-102525996	chrX	102522141	102525996	3855	102523516
chrX:102574300-102580448	chrX	102574300	102580448	6148	102577862
chrX:103131407-103137543	chrX	103131407	103137543	6136	103134955
chrX:103282498-103288669	chrX	103282498	103288669	6171	103286059
chrX:103813553-103817585	chrX	103813553	103817585	4032	103815011
chrX:103867706-103873398	chrX	103867706	103873398	5692	103870811
chrX:103989280-103991942	chrX	103989280	103991942	2662	103989544
chrX:104144697-104148460	chrX	104144697	104148460	3763	104145883
chrX:104602037-104608348	chrX	104602037	104608348	6311	104605893
chrX:105211676-105218111	chrX	105211676	105218111	6435	105215534
chrX:105796906-105802919	chrX	105796906	105802919	6013	105800347
chrX:105959690-105965737	chrX	105959690	105965737	6047	105963154
chrX:106084263-106086843	chrX	106084263	106086843	2580	106084280
chrX:106407044-106413162	chrX	106407044	106413162	6118	106410577
chrX:106469285-106475319	chrX	106469285	106475319	6034	106472727
chrX:106827827-106830948	chrX	106827827	106830948	3121	106828365
chrX:107155767-107161785	chrX	107155767	107161785	6018	107159204
chrX:107364336-107370349	chrX	107364336	107370349	6013	107367773
chrX:107422839-107427853	chrX	107422839	107427853	5014	107425270
chrX:108011421-108015737	chrX	108011421	108015737	4316	108014970
chrX:108277015-108283183	chrX	108277015	108283183	6168	108280568
chrX:108631488-108633139	chrX	108631488	108633139	1651	108632404
chrX:108903893-108909430	chrX	108903893	108909430	5537	108907215
chrX:109010403-109015566	chrX	109010403	109015566	5163	109013939
chrX:109054590-109058794	chrX	109054590	109058794	4204	109056202
chrX:109061366-109063931	chrX	109061366	109063931	2565	109062960
chrX:109113307-109119363	chrX	109113307	109119363	6056	109116745
chrX:109176163-109177547	chrX	109176163	109177547	1384	109176351
chrX:109191715-109198126	chrX	109191715	109198126	6411	109195599
chrX:109230906-109233228	chrX	109230906	109233228	2322	109232361
chrX:109520475-109525743	chrX	109520475	109525743	5268	109523172
chrX:109644666-109650692	chrX	109644666	109650692	6026	109648098
chrX:109833518-109834826	chrX	109833518	109834826	1308	109834454
chrX:110232917-110235974	chrX	110232917	110235974	3057	110233406
chrX:110342856-110345502	chrX	110342856	110345502	2646	110342916
chrX:110546821-110551806	chrX	110546821	110551806	4985	110549217
chrX:110605828-110611851	chrX	110605828	110611851	6023	110609269
chrX:110656903-110663049	chrX	110656903	110663049	6146	110660459
chrX:110909513-110912328	chrX	110909513	110912328	2815	110909748
chrX:110974244-110977116	chrX	110974244	110977116	2872	110974534
chrX:111753236-111756423	chrX	111753236	111756423	3187	111753848
chrX:111784452-111790569	chrX	111784452	111790569	6117	111787987
chrX:111962838-111968972	chrX	111962838	111968972	6134	111966403
chrX:112326145-112331419	chrX	112326145	112331419	5274	112329583
chrX:112461810-112467973	chrX	112461810	112467973	6163	112465394
chrX:112502039-112508065	chrX	112502039	112508065	6026	112505474
chrX:112592240-112596271	chrX	112592240	112596271	4031	112593694
chrX:112604901-112608385	chrX	112604901	112608385	3484	112605799
chrX:112718609-112724627	chrX	112718609	112724627	6018	112722048
chrX:113446054-113451461	chrX	113446054	113451461	5407	113448875
chrX:113479271-113485406	chrX	113479271	113485406	6135	113482819
chrX:113687125-113690039	chrX	113687125	113690039	2914	113690000
chrX:114183184-114189000	chrX	114183184	114189000	5816	114187046
chrX:114397279-114398361	chrX	114397279	114398361	1082	114397630
chrX:114520897-114524863	chrX	114520897	114524863	3966	114522293
chrX:114700576-114706720	chrX	114700576	114706720	6144	114704133
chrX:115118199-115121171	chrX	115118199	115121171	2972	115118592
chrX:116121201-116127338	chrX	116121201	116127338	6137	116124761
chrX:116159201-116165340	chrX	116159201	116165340	6139	116162767
chrX:116254210-116257519	chrX	116254210	116257519	3309	116254930
chrX:116310845-116313937	chrX	116310845	116313937	3092	116311351
chrX:116531016-116531168	chrX	116531016	116531168	152	116531075
chrX:116613722-116615533	chrX	116613722	116615533	1811	116614362
chrX:117153236-117156660	chrX	117153236	117156660	3424	117155258
chrX:117166103-117169988	chrX	117166103	117169988	3885	117167400
chrX:117260691-117266821	chrX	117260691	117266821	6130	117264234
chrX:117268066-117274493	chrX	117268066	117274493	6427	117271915
chrX:117307378-117309128	chrX	117307378	117309128	1750	117308605
chrX:117555691-117561795	chrX	117555691	117561795	6104	117559223
chrX:117779433-117781071	chrX	117779433	117781071	1638	117780373
chrX:117965459-117967185	chrX	117965459	117967185	1726	117965478
chrX:118031729-118037757	chrX	118031729	118037757	6028	118035166
chrX:118093887-118099119	chrX	118093887	118099119	5232	118096503
chrX:118241706-118247865	chrX	118241706	118247865	6159	118245288
chrX:119964405-119967359	chrX	119964405	119967359	2954	119964776
chrX:120183833-120189962	chrX	120183833	120189962	6129	120187377
chrX:120344235-120350408	chrX	120344235	120350408	6173	120347818
chrX:120650062-120652796	chrX	120650062	120652796	2734	120650196
chrX:120814676-120818311	chrX	120814676	120818311	3635	120815736
chrX:121265513-121267972	chrX	121265513	121267972	2459	121267087
chrX:121437644-121441338	chrX	121437644	121441338	3694	121441073
chrX:121877356-121883520	chrX	121877356	121883520	6164	121880929
chrX:122140000-122146189	chrX	122140000	122146189	6189	122143575
chrX:122161729-122163568	chrX	122161729	122163568	1839	122162126
chrX:122330935-122334199	chrX	122330935	122334199	3264	122331611
chrX:122548707-122551058	chrX	122548707	122551058	2351	122550492
chrX:122733359-122736207	chrX	122733359	122736207	2848	122733636
chrX:122820364-122824006	chrX	122820364	122824006	3642	122821413
chrX:123055880-123059133	chrX	123055880	123059133	3253	123056543
chrX:123576532-123579980	chrX	123576532	123579980	3448	123577366
chrX:123648005-123654416	chrX	123648005	123654416	6411	123651873
chrX:124582570-124588702	chrX	124582570	124588702	6132	124586111
chrX:125005583-125010532	chrX	125005583	125010532	4949	125009456
chrX:125113365-125116642	chrX	125113365	125116642	3277	125114814
chrX:125838860-125845012	chrX	125838860	125845012	6152	125842424
chrX:126383150-126389276	chrX	126383150	126389276	6126	126386708
chrX:126460660-126465290	chrX	126460660	126465290	4630	126462697
chrX:127103286-127108042	chrX	127103286	127108042	4756	127105461
chrX:127201872-127204265	chrX	127201872	127204265	2393	127202113
chrX:127214730-127219892	chrX	127214730	127219892	5162	127217313
chrX:127305530-127311888	chrX	127305530	127311888	6358	127309365
chrX:127362223-127368248	chrX	127362223	127368248	6025	127365662
chrX:127610848-127613491	chrX	127610848	127613491	2643	127610910
chrX:127788799-127794900	chrX	127788799	127794900	6101	127792335
chrX:127800865-127803832	chrX	127800865	127803832	2967	127801245
chrX:128059793-128064575	chrX	128059793	128064575	4782	128061972
chrX:128148480-128153807	chrX	128148480	128153807	5327	128151208
chrX:128732737-128738890	chrX	128732737	128738890	6153	128736306
chrX:128782654-128788670	chrX	128782654	128788670	6016	128786087
chrX:129044337-129049647	chrX	129044337	129049647	5310	129047807
chrX:129240861-129246997	chrX	129240861	129246997	6136	129244411
chrX:129290194-129294090	chrX	129290194	129294090	3896	129291510
chrX:129337055-129343063	chrX	129337055	129343063	6008	129340482
chrX:129352207-129357964	chrX	129352207	129357964	5757	129355376
chrX:129388197-129392947	chrX	129388197	129392947	4750	129390391
chrX:129405405-129408371	chrX	129405405	129408371	2966	129405788
chrX:130517377-130523407	chrX	130517377	130523407	6030	130520815
chrX:130813446-130819874	chrX	130813446	130819874	6428	130817342
chrX:130958931-130964957	chrX	130958931	130964957	6026	130962366
chrX:131427970-131434414	chrX	131427970	131434414	6444	131431830
chrX:131461598-131466115	chrX	131461598	131466115	4517	131465071
chrX:131524490-131530619	chrX	131524490	131530619	6129	131528040
chrX:131552691-131556913	chrX	131552691	131556913	4222	131556254
chrX:131578680-131584735	chrX	131578680	131584735	6055	131582150
chrX:131663952-131669984	chrX	131663952	131669984	6032	131667393
chrX:131963413-131966819	chrX	131963413	131966819	3406	131964021
chrX:131989487-131995650	chrX	131989487	131995650	6163	131993063
chrX:132132810-132138750	chrX	132132810	132138750	5940	132136168
chrX:132323746-132327491	chrX	132323746	132327491	3745	132324924
chrX:132867642-132871943	chrX	132867642	132871943	4301	132869340
chrX:133009673-133015829	chrX	133009673	133015829	6156	133013243
chrX:133111380-133116532	chrX	133111380	133116532	5152	133113940
chrX:133621186-133627320	chrX	133621186	133627320	6134	133624735
chrX:134081578-134085604	chrX	134081578	134085604	4026	134083029
chrX:134117179-134123326	chrX	134117179	134123326	6147	134120736
chrX:135387181-135388530	chrX	135387181	135388530	1349	135388224
chrX:135755620-135758831	chrX	135755620	135758831	3211	135756234
chrX:137005440-137008616	chrX	137005440	137008616	3176	137006074
chrX:137122418-137128550	chrX	137122418	137128550	6132	137125984
chrX:137129951-137135620	chrX	137129951	137135620	5669	137133052
chrX:137509717-137512457	chrX	137509717	137512457	2740	137509867
chrX:137672117-137678261	chrX	137672117	137678261	6144	137675670
chrX:137959684-137965821	chrX	137959684	137965821	6137	137963241
chrX:137970981-137977112	chrX	137970981	137977112	6131	137974540
chrX:138073442-138079552	chrX	138073442	138079552	6110	138076968
chrX:138105302-138111440	chrX	138105302	138111440	6138	138108864
chrX:138230739-138236890	chrX	138230739	138236890	6151	138234293
chrX:138455844-138462440	chrX	138455844	138462440	6596	138459404
chrX:138778307-138784350	chrX	138778307	138784350	6043	138781732
chrX:138807337-138811606	chrX	138807337	138811606	4269	138809019
chrX:138894229-138895043	chrX	138894229	138895043	814	138894736
chrX:139065106-139067787	chrX	139065106	139067787	2681	139066700
chrX:139259549-139265701	chrX	139259549	139265701	6152	139263094
chrX:139435696-139441840	chrX	139435696	139441840	6144	139439249
chrX:139523554-139529699	chrX	139523554	139529699	6145	139527110
chrX:139593350-139595737	chrX	139593350	139595737	2387	139593460
chrX:139958613-139965093	chrX	139958613	139965093	6480	139962496
chrX:140002874-140004212	chrX	140002874	140004212	1338	140004020
chrX:141018975-141022509	chrX	141018975	141022509	3534	141019925
chrX:141044310-141050237	chrX	141044310	141050237	5927	141047668
chrX:141448494-141454070	chrX	141448494	141454070	5576	141451480
chrX:142338123-142344150	chrX	142338123	142344150	6027	142341562
chrX:142404335-142407520	chrX	142404335	142407520	3185	142404851
chrX:142477849-142483853	chrX	142477849	142483853	6004	142481281
chrX:143561447-143566241	chrX	143561447	143566241	4794	143564502
chrX:143726772-143729175	chrX	143726772	143729175	2403	143728744
chrX:144048960-144053164	chrX	144048960	144053164	4204	144051271
chrX:144323859-144326759	chrX	144323859	144326759	2900	144324170
chrX:146118862-146123734	chrX	146118862	146123734	4872	146122442
chrX:146620764-146622156	chrX	146620764	146622156	1392	146620884
chrX:146902128-146904773	chrX	146902128	146904773	2645	146902170
chrX:147200309-147206474	chrX	147200309	147206474	6165	147203862
chrX:147222583-147224188	chrX	147222583	147224188	1605	147223412
chrX:147352341-147355769	chrX	147352341	147355769	3428	147353184
chrX:147404988-147408832	chrX	147404988	147408832	3844	147406956
chrX:147653734-147659767	chrX	147653734	147659767	6033	147657174
chrX:147819071-147824814	chrX	147819071	147824814	5743	147822975
chrX:147967847-147973580	chrX	147967847	147973580	5733	147970996
chrX:148167137-148170018	chrX	148167137	148170018	2881	148169249
chrX:149192866-149197060	chrX	149192866	149197060	4194	149194471
chrX:149334009-149340027	chrX	149334009	149340027	6018	149337439
chrX:149435837-149441830	chrX	149435837	149441830	5993	149439247
chrX:150133099-150134814	chrX	150133099	150134814	1715	150133934
chrX:151199826-151205995	chrX	151199826	151205995	6169	151203410
chrX:151252428-151257516	chrX	151252428	151257516	5088	151256289
chrX:151330320-151336351	chrX	151330320	151336351	6031	151333759
chrX:151545775-151549800	chrX	151545775	151549800	4025	151549683
chrX:151668421-151668911	chrX	151668421	151668911	490	151668782
chrX:152006771-152013066	chrX	152006771	152013066	6295	152010324
chrX:152325322-152330861	chrX	152325322	152330861	5539	152328273
chrX:152544525-152550550	chrX	152544525	152550550	6025	152547959
chrX:152581916-152588056	chrX	152581916	152588056	6140	152585460
chrX:153015563-153018740	chrX	153015563	153018740	3177	153016169
chrX:154868445-154872709	chrX	154868445	154872709	4264	154870120
chrX:154939035-154945181	chrX	154939035	154945181	6146	154942591
chrX:155197626-155203769	chrX	155197626	155203769	6143	155201184
chrX:155319265-155325749	chrX	155319265	155325749	6484	155323104
chrX:155353407-155359891	chrX	155353407	155359891	6484	155357281
chrX:155421974-155428112	chrX	155421974	155428112	6138	155425541
chrX:155430461-155433680	chrX	155430461	155433680	3219	155431095
chrX:155567853-155573980	chrX	155567853	155573980	6127	155571408
chrX:155648747-155650323	chrX	155648747	155650323	1576	155649193
chrX:155808794-155815006	chrX	155808794	155815006	6212	155812368
chrX_KI270881v1_alt:30387-36524	chrX_KI270881v1_alt	30387	36524	6137	33950
chrX_KI270881v1_alt:121091-124205	chrX_KI270881v1_alt	121091	124205	3114	121614
chrY:3335191-3341703	chrY	3335191	3341703	6512	3339080
chrY:3443550-3449565	chrY	3443550	3449565	6015	3446991
chrY:4230072-4231911	chrY	4230072	4231911	1839	4231859
chrY:4418647-4424785	chrY	4418647	4424785	6138	4422192
chrY:4655407-4656261	chrY	4655407	4656261	854	4655559
chrY:4752675-4756553	chrY	4752675	4756553	3878	4755426
chrY:4829219-4833240	chrY	4829219	4833240	4021	4830635
chrY:4866357-4872524	chrY	4866357	4872524	6167	4869926
chrY:4973238-4979397	chrY	4973238	4979397	6159	4976806
chrY:5244328-5250758	chrY	5244328	5250758	6430	5248151
chrY:5832629-5838360	chrY	5832629	5838360	5731	5835782
chrY:6014826-6016870	chrY	6014826	6016870	2044	6015155
chrY:6324303-6326214	chrY	6324303	6326214	1911	6325170
chrY:6334087-6337008	chrY	6334087	6337008	2921	6334434
chrY:6626784-6632798	chrY	6626784	6632798	6014	6630215
chrY:6852433-6858448	chrY	6852433	6858448	6015	6855856
chrY:7032799-7035957	chrY	7032799	7035957	3158	7033407
chrY:7134598-7138576	chrY	7134598	7138576	3978	7138168
chrY:8267365-8270227	chrY	8267365	8270227	2862	8267670
chrY:8956030-8958347	chrY	8956030	8958347	2317	8956434
chrY:9573864-9576781	chrY	9573864	9576781	2917	9574188
chrY:9592063-9596948	chrY	9592063	9596948	4885	9594342
chrY:9634917-9636597	chrY	9634917	9636597	1680	9634934
chrY:9659714-9661553	chrY	9659714	9661553	1839	9660583
chrY:9731131-9734089	chrY	9731131	9734089	2958	9731506
chrY:9879855-9884774	chrY	9879855	9884774	4919	9883378
chrY:9941130-9947151	chrY	9941130	9947151	6021	9944561
chrY:11358810-11364949	chrY	11358810	11364949	6139	11362363
chrY:11405796-11408043	chrY	11405796	11408043	2247	11407740
chrY:11423886-11426993	chrY	11423886	11426993	3107	11424407
chrY:11934589-11935477	chrY	11934589	11935477	888	11935419
chrY:12041486-12045518	chrY	12041486	12045518	4032	12042931
chrY:12134981-12141002	chrY	12134981	12141002	6021	12138421
chrY:12180824-12186973	chrY	12180824	12186973	6149	12184402
chrY:13004242-13010401	chrY	13004242	13010401	6159	13007801
chrY:13034317-13039186	chrY	13034317	13039186	4869	13036623
chrY:13100773-13103713	chrY	13100773	13103713	2940	13101124
chrY:13188152-13189678	chrY	13188152	13189678	1526	13189605
chrY:13524018-13530054	chrY	13524018	13530054	6036	13527452
chrY:13682846-13686591	chrY	13682846	13686591	3745	13684026
chrY:13691338-13697314	chrY	13691338	13697314	5976	13694767
chrY:13721945-13728094	chrY	13721945	13728094	6149	13725506
chrY:13909274-13915419	chrY	13909274	13915419	6145	13912826
chrY:14012531-14018535	chrY	14012531	14018535	6004	14015963
chrY:14206201-14212375	chrY	14206201	14212375	6174	14209782
chrY:14282268-14288293	chrY	14282268	14288293	6025	14285716
chrY:14460769-14461052	chrY	14460769	14461052	283	14460939
chrY:14771849-14775162	chrY	14771849	14775162	3313	14772486
chrY:14863210-14867059	chrY	14863210	14867059	3849	14864658
chrY:14922999-14925040	chrY	14922999	14925040	2041	14924757
chrY:14949152-14952104	chrY	14949152	14952104	2952	14951914
chrY:14952755-14958959	chrY	14952755	14958959	6204	14956319
chrY:15043523-15044122	chrY	15043523	15044122	599	15043637
chrY:15115873-15119801	chrY	15115873	15119801	3928	15117218
chrY:15134150-15137929	chrY	15134150	15137929	3779	15135882
chrY:15369171-15374563	chrY	15369171	15374563	5392	15372110
chrY:15406533-15412273	chrY	15406533	15412273	5740	15409681
chrY:15426061-15432072	chrY	15426061	15432072	6011	15429482
chrY:15610903-15617033	chrY	15610903	15617033	6130	15614456
chrY:15619643-15620567	chrY	15619643	15620567	924	15620046
chrY:15712992-15719152	chrY	15712992	15719152	6160	15716571
chrY:15885446-15891462	chrY	15885446	15891462	6016	15888874
chrY:16026049-16032062	chrY	16026049	16032062	6013	16029483
chrY:16361340-16367477	chrY	16361340	16367477	6137	16364894
chrY:16427017-16433089	chrY	16427017	16433089	6072	16430507
chrY:16467865-16468729	chrY	16467865	16468729	864	16468429
chrY:16683202-16689380	chrY	16683202	16689380	6178	16686757
chrY:16762056-16768224	chrY	16762056	16768224	6168	16765619
chrY:16912864-16918205	chrY	16912864	16918205	5341	16915614
chrY:16930863-16932172	chrY	16930863	16932172	1309	16931920
chrY:16949305-16953669	chrY	16949305	16953669	4364	16953108
chrY:16985042-16991073	chrY	16985042	16991073	6031	16988485
chrY:17212763-17218857	chrY	17212763	17218857	6094	17216305
chrY:17311632-17317724	chrY	17311632	17317724	6092	17315199
chrY:17447547-17450822	chrY	17447547	17450822	3275	17449288
chrY:17708355-17714504	chrY	17708355	17714504	6149	17711917
chrY:17827804-17831286	chrY	17827804	17831286	3482	17828796
chrY:17894555-17900788	chrY	17894555	17900788	6233	17898208
chrY:17944185-17950213	chrY	17944185	17950213	6028	17947676
chrY:18237301-18241695	chrY	18237301	18241695	4394	18240737
chrY:18315379-18316237	chrY	18315379	18316237	858	18315521
chrY:18893898-18899933	chrY	18893898	18899933	6035	18897329
chrY:19034631-19038436	chrY	19034631	19038436	3805	19038062
chrY:19172494-19178650	chrY	19172494	19178650	6156	19176073
chrY:19668341-19672200	chrY	19668341	19672200	3859	19669637
chrY:19780411-19783692	chrY	19780411	19783692	3281	19781373
chrY:19801627-19807597	chrY	19801627	19807597	5970	19805024
chrY:19850099-19856121	chrY	19850099	19856121	6022	19853538
chrY:19893684-19898765	chrY	19893684	19898765	5081	19896314
chrY:20033059-20037076	chrY	20033059	20037076	4017	20034511
chrY:20037601-20040893	chrY	20037601	20040893	3292	20038363
chrY:20367992-20374018	chrY	20367992	20374018	6026	20371428
chrY:20477159-20483202	chrY	20477159	20483202	6043	20480629
chrY:20528201-20533594	chrY	20528201	20533594	5393	20531761
chrY:20674521-20680572	chrY	20674521	20680572	6051	20678036
chrY:20888448-20890827	chrY	20888448	20890827	2379	20888554
chrY:20963691-20967115	chrY	20963691	20967115	3424	20965598
chrY:21063741-21069758	chrY	21063741	21069758	6017	21067175
chrY:21354417-21360536	chrY	21354417	21360536	6119	21357963
chrY:22040932-22047073	chrY	22040932	22047073	6141	22044485
chrY:22089269-22091888	chrY	22089269	22091888	2619	22089623
chrY:22599127-22602188	chrY	22599127	22602188	3061	22599604
chrY:22854945-22860960	chrY	22854945	22860960	6015	22858374
chrY:22871659-22876417	chrY	22871659	22876417	4758	22873981
chrY:22919803-22925928	chrY	22919803	22925928	6125	22923346
chrY:23144667-23150705	chrY	23144667	23150705	6038	23148113
chrY:23650222-23656363	chrY	23650222	23656363	6141	23653775
chrY:23695686-23701569	chrY	23695686	23701569	5883	23699304
chrY:23704611-23710597	chrY	23704611	23710597	5986	23708039
chrY:23756281-23762472	chrY	23756281	23762472	6191	23759833
chrY:23801816-23805268	chrY	23801816	23805268	3452	23802767
chrY:23889481-23895590	chrY	23889481	23895590	6109	23893013
chrY:23963620-23966387	chrY	23963620	23966387	2767	23963888
chrY:23982756-23982994	chrY	23982756	23982994	238	23982855
chrY:23997555-24001032	chrY	23997555	24001032	3477	23998553
chrY:24058682-24063648	chrY	24058682	24063648	4966	24062204
chrY:24063647-24069853	chrY	24063647	24069853	6206	24067273
chrY:24222596-24228033	chrY	24222596	24228033	5437	24225442
chrY:24488693-24494708	chrY	24488693	24494708	6015	24492122
chrY:24505408-24510166	chrY	24505408	24510166	4758	24507730
chrY:24553556-24559681	chrY	24553556	24559681	6125	24557099
chrY:24776006-24782046	chrY	24776006	24782046	6040	24779451
chrY:25185568-25189135	chrY	25185568	25189135	3567	25186526
chrY:25258379-25263115	chrY	25258379	25263115	4736	25260495
chrY:25369702-25375721	chrY	25369702	25375721	6019	25373138
chrY:25554405-25559643	chrY	25554405	25559643	5238	25557896
chrY:25710291-25713238	chrY	25710291	25713238	2947	25710662
chrY:25937661-25939643	chrY	25937661	25939643	1982	25937867
chrY:26073524-26076585	chrY	26073524	26076585	3061	26074001
chrY:26286024-26290975	chrY	26286024	26290975	4951	26289590
chrY:26339733-26344868	chrY	26339733	26344868	5135	26343101
chrY:26601787-26607911	chrY	26601787	26607911	6124	26605339
chr1:4244384-4247142	chr1	4244384	4247142	2758	4246973
chr1:4576846-4580808	chr1	4576846	4580808	3962	4579439
chr1:4860762-4864082	chr1	4860762	4864082	3320	4863351
chr1:7411757-7417922	chr1	7411757	7417922	6165	7414346
chr1:7602176-7605817	chr1	7602176	7605817	3641	7602243
chr1:11083623-11086544	chr1	11083623	11086544	2921	11086209
chr1:12812997-12816083	chr1	12812997	12816083	3086	12815591
chr1:12867878-12871181	chr1	12867878	12871181	3303	12870446
chr1:13038115-13041430	chr1	13038115	13041430	3315	13040698
chr1:13291504-13294083	chr1	13291504	13294083	2579	13292989
chr1:14287380-14291820	chr1	14287380	14291820	4440	14288267
chr1:14355444-14361840	chr1	14355444	14361840	6396	14358011
chr1:14382318-14388341	chr1	14382318	14388341	6023	14384904
chr1:19991693-19993348	chr1	19991693	19993348	1655	19992109
chr1:24269391-24275205	chr1	24269391	24275205	5814	24271359
chr1:29400059-29404325	chr1	29400059	29404325	4266	29402636
chr1:30453585-30459718	chr1	30453585	30459718	6133	30456171
chr1:30581287-30585742	chr1	30581287	30585742	4455	30583842
chr1:33206963-33210936	chr1	33206963	33210936	3973	33209511
chr1:33290091-33292710	chr1	33290091	33292710	2619	33292657
chr1:34566055-34572105	chr1	34566055	34572105	6050	34568664
chr1:35054885-35057837	chr1	35054885	35057837	2952	35056718
chr1:38629156-38635345	chr1	38629156	38635345	6189	38631736
chr1:41548887-41552216	chr1	41548887	41552216	3329	41551466
chr1:42252016-42252790	chr1	42252016	42252790	774	42252211
chr1:43114527-43120516	chr1	43114527	43120516	5989	43117100
chr1:45961780-45965617	chr1	45961780	45965617	3837	45964304
chr1:46793607-46796778	chr1	46793607	46796778	3171	46796187
chr1:46825138-46831312	chr1	46825138	46831312	6174	46827736
chr1:46919692-46925853	chr1	46919692	46925853	6161	46922255
chr1:47052917-47057316	chr1	47052917	47057316	4399	47055507
chr1:47085695-47088578	chr1	47085695	47088578	2883	47088283
chr1:48132877-48137162	chr1	48132877	48137162	4285	48135451
chr1:48273348-48277107	chr1	48273348	48277107	3759	48275921
chr1:48363803-48369929	chr1	48363803	48369929	6126	48366385
chr1:49116225-49122348	chr1	49116225	49122348	6123	49118785
chr1:49561313-49567447	chr1	49561313	49567447	6134	49563897
chr1:49750183-49754296	chr1	49750183	49754296	4113	49751668
chr1:49831998-49837363	chr1	49831998	49837363	5365	49834171
chr1:49875162-49881175	chr1	49875162	49881175	6013	49877747
chr1:50240502-50243385	chr1	50240502	50243385	2883	50243082
chr1:50863603-50864433	chr1	50863603	50864433	830	50863791
chr1:50886382-50892493	chr1	50886382	50892493	6111	50888952
chr1:50904886-50911009	chr1	50904886	50911009	6123	50907468
chr1:51476715-51479583	chr1	51476715	51479583	2868	51477042
chr1:51701645-51704485	chr1	51701645	51704485	2840	51704224
chr1:52171000-52177141	chr1	52171000	52177141	6141	52173590
chr1:54444363-54449404	chr1	54444363	54449404	5041	54445853
chr1:55494080-55497554	chr1	55494080	55497554	3474	55496657
chr1:55561831-55567969	chr1	55561831	55567969	6138	55564410
chr1:58126455-58132485	chr1	58126455	58132485	6030	58129045
chr1:58269013-58275032	chr1	58269013	58275032	6019	58271612
chr1:58373171-58379206	chr1	58373171	58379206	6035	58375770
chr1:59647747-59653779	chr1	59647747	59653779	6032	59650338
chr1:60208082-60208957	chr1	60208082	60208957	875	60208833
chr1:60216551-60218677	chr1	60216551	60218677	2126	60218075
chr1:60323870-60328359	chr1	60323870	60328359	4489	60325941
chr1:60772540-60778675	chr1	60772540	60778675	6135	60775119
chr1:61573381-61578809	chr1	61573381	61578809	5428	61575965
chr1:62699405-62705398	chr1	62699405	62705398	5993	62701986
chr1:63502515-63506343	chr1	63502515	63506343	3828	63505099
chr1:65122165-65125707	chr1	65122165	65125707	3542	65124762
chr1:65450279-65456309	chr1	65450279	65456309	6030	65452867
chr1:65544806-65550970	chr1	65544806	65550970	6164	65547395
chr1:65550971-65555181	chr1	65550971	65555181	4210	65551303
chr1:65558564-65564576	chr1	65558564	65564576	6012	65561140
chr1:65682423-65683619	chr1	65682423	65683619	1196	65683543
chr1:65860034-65865838	chr1	65860034	65865838	5804	65862637
chr1:65883121-65884407	chr1	65883121	65884407	1286	65884245
chr1:66103940-66107327	chr1	66103940	66107327	3387	66106526
chr1:66184843-66190986	chr1	66184843	66190986	6143	66187421
chr1:66199807-66204996	chr1	66199807	66204996	5189	66201434
chr1:67078891-67084915	chr1	67078891	67084915	6024	67081483
chr1:67176638-67182776	chr1	67176638	67182776	6138	67179205
chr1:67243313-67247306	chr1	67243313	67247306	3993	67245898
chr1:68681498-68687636	chr1	68681498	68687636	6138	68684084
chr1:68736693-68740136	chr1	68736693	68740136	3443	68736696
chr1:68854729-68857565	chr1	68854729	68857565	2836	68857284
chr1:68875777-68881805	chr1	68875777	68881805	6028	68878370
chr1:69096528-69102668	chr1	69096528	69102668	6140	69099115
chr1:69114477-69120511	chr1	69114477	69120511	6034	69117062
chr1:69389449-69395594	chr1	69389449	69395594	6145	69392032
chr1:69557699-69559776	chr1	69557699	69559776	2077	69557883
chr1:69882613-69888643	chr1	69882613	69888643	6030	69885204
chr1:69905264-69911348	chr1	69905264	69911348	6084	69907849
chr1:69922813-69928952	chr1	69922813	69928952	6139	69925388
chr1:69995406-69998072	chr1	69995406	69998072	2666	69997989
chr1:70595120-70601278	chr1	70595120	70601278	6158	70597707
chr1:70797456-70799363	chr1	70797456	70799363	1907	70798532
chr1:70813927-70816352	chr1	70813927	70816352	2425	70815626
chr1:70926179-70927328	chr1	70926179	70927328	1149	70927269
chr1:71811917-71815668	chr1	71811917	71815668	3751	71814499
chr1:73081634-73085734	chr1	73081634	73085734	4100	73084202
chr1:73486301-73492292	chr1	73486301	73492292	5991	73488882
chr1:73809099-73810764	chr1	73809099	73810764	1665	73809756
chr1:74029044-74029989	chr1	74029044	74029989	945	74029786
chr1:74347007-74353101	chr1	74347007	74353101	6094	74349559
chr1:74448281-74449467	chr1	74448281	74449467	1186	74449051
chr1:74898866-74901066	chr1	74898866	74901066	2200	74900276
chr1:74915691-74921024	chr1	74915691	74921024	5333	74918281
chr1:75014595-75016165	chr1	75014595	75016165	1570	75015302
chr1:75106865-75112887	chr1	75106865	75112887	6022	75109448
chr1:75633164-75634379	chr1	75633164	75634379	1215	75634309
chr1:75820327-75820782	chr1	75820327	75820782	455	75820407
chr1:75823452-75827028	chr1	75823452	75827028	3576	75826052
chr1:75856287-75862418	chr1	75856287	75862418	6131	75858853
chr1:76242432-76246591	chr1	76242432	76246591	4159	76245021
chr1:76482725-76488038	chr1	76482725	76488038	5313	76485310
chr1:76735650-76738636	chr1	76735650	76738636	2986	76737198
chr1:76911101-76913715	chr1	76911101	76913715	2614	76911531
chr1:76999486-77005515	chr1	76999486	77005515	6029	77002078
chr1:78185965-78190225	chr1	78185965	78190225	4260	78188552
chr1:78394080-78399570	chr1	78394080	78399570	5490	78394831
chr1:78809080-78809858	chr1	78809080	78809858	778	78809778
chr1:78845456-78851474	chr1	78845456	78851474	6018	78848034
chr1:79511261-79517280	chr1	79511261	79517280	6019	79513846
chr1:79938402-79944419	chr1	79938402	79944419	6017	79940979
chr1:80132548-80138577	chr1	80132548	80138577	6029	80135135
chr1:80394348-80400494	chr1	80394348	80400494	6146	80396936
chr1:80939203-80945257	chr1	80939203	80945257	6054	80941825
chr1:82054323-82056640	chr1	82054323	82056640	2317	82054868
chr1:83350413-83356465	chr1	83350413	83356465	6052	83353022
chr1:83684517-83689559	chr1	83684517	83689559	5042	83687104
chr1:84052389-84058406	chr1	84052389	84058406	6017	84054968
chr1:84228930-84234940	chr1	84228930	84234940	6010	84231509
chr1:85185406-85186419	chr1	85185406	85186419	1013	85186384
chr1:85771778-85775513	chr1	85771778	85775513	3735	85774458
chr1:85824940-85830944	chr1	85824940	85830944	6004	85827514
chr1:86131362-86135240	chr1	86131362	86135240	3878	86133936
chr1:86162360-86168489	chr1	86162360	86168489	6129	86164939
chr1:86610687-86614560	chr1	86610687	86614560	3873	86611046
chr1:86625551-86630498	chr1	86625551	86630498	4947	86626925
chr1:86630495-86634080	chr1	86630495	86634080	3585	86630549
chr1:86679080-86685111	chr1	86679080	86685111	6031	86681672
chr1:89227062-89230922	chr1	89227062	89230922	3860	89227387
chr1:89412579-89418615	chr1	89412579	89418615	6036	89415171
chr1:89747026-89753053	chr1	89747026	89753053	6027	89749618
chr1:90057280-90063312	chr1	90057280	90063312	6032	90059875
chr1:90214697-90218764	chr1	90214697	90218764	4067	90217313
chr1:91182694-91186499	chr1	91182694	91186499	3805	91185259
chr1:91246587-91250652	chr1	91246587	91250652	4065	91249157
chr1:91422369-91428894	chr1	91422369	91428894	6525	91424965
chr1:92232116-92237662	chr1	92232116	92237662	5546	92234699
chr1:92629666-92635797	chr1	92629666	92635797	6131	92632269
chr1:93387997-93390896	chr1	93387997	93390896	2899	93390602
chr1:93401957-93408098	chr1	93401957	93408098	6141	93404542
chr1:93790652-93796681	chr1	93790652	93796681	6029	93793242
chr1:93910736-93916776	chr1	93910736	93916776	6040	93913311
chr1:94287505-94291250	chr1	94287505	94291250	3745	94290079
chr1:94364261-94370410	chr1	94364261	94370410	6149	94366858
chr1:94506993-94512223	chr1	94506993	94512223	5230	94509576
chr1:95158524-95164627	chr1	95158524	95164627	6103	95161091
chr1:95210689-95216990	chr1	95210689	95216990	6301	95213274
chr1:95292237-95298258	chr1	95292237	95298258	6021	95294824
chr1:95968956-95972768	chr1	95968956	95972768	3812	95971543
chr1:96051579-96057733	chr1	96051579	96057733	6154	96054167
chr1:96240775-96243665	chr1	96240775	96243665	2890	96243359
chr1:96375820-96382261	chr1	96375820	96382261	6441	96379837
chr1:96433439-96437500	chr1	96433439	96437500	4061	96436047
chr1:96611743-96615947	chr1	96611743	96615947	4204	96614359
chr1:96853195-96859362	chr1	96853195	96859362	6167	96855798
chr1:97397945-97400882	chr1	97397945	97400882	2937	97400537
chr1:98212050-98215060	chr1	98212050	98215060	3010	98214641
chr1:98619261-98624772	chr1	98619261	98624772	5511	98621814
chr1:98875638-98881734	chr1	98875638	98881734	6096	98878183
chr1:99112174-99114999	chr1	99112174	99114999	2825	99114749
chr1:99156161-99159109	chr1	99156161	99159109	2948	99158743
chr1:99338040-99341165	chr1	99338040	99341165	3125	99340544
chr1:99341165-99341678	chr1	99341165	99341678	513	99341224
chr1:99399824-99405973	chr1	99399824	99405973	6149	99402411
chr1:99795980-99798746	chr1	99795980	99798746	2766	99797187
chr1:100258332-100261123	chr1	100258332	100261123	2791	100260919
chr1:100598238-100604384	chr1	100598238	100604384	6146	100600825
chr1:100632238-100638390	chr1	100632238	100638390	6152	100634827
chr1:100662981-100669120	chr1	100662981	100669120	6139	100665565
chr1:100676926-100682490	chr1	100676926	100682490	5564	100679515
chr1:100839707-100843448	chr1	100839707	100843448	3741	100842211
chr1:100944683-100950115	chr1	100944683	100950115	5432	100946874
chr1:102504175-102507320	chr1	102504175	102507320	3145	102506766
chr1:102804388-102807898	chr1	102804388	102807898	3510	102806969
chr1:102928102-102934113	chr1	102928102	102934113	6011	102930680
chr1:103045620-103051750	chr1	103045620	103051750	6130	103048191
chr1:103163409-103166933	chr1	103163409	103166933	3524	103165646
chr1:103882921-103886110	chr1	103882921	103886110	3189	103885531
chr1:104006145-104011736	chr1	104006145	104011736	5591	104008774
chr1:104218010-104223212	chr1	104218010	104223212	5202	104219652
chr1:104658853-104664872	chr1	104658853	104664872	6019	104661444
chr1:104770247-104776278	chr1	104770247	104776278	6031	104772838
chr1:104843833-104849864	chr1	104843833	104849864	6031	104846425
chr1:104935148-104941180	chr1	104935148	104941180	6032	104937733
chr1:105218347-105221849	chr1	105218347	105221849	3502	105220926
chr1:105261102-105265313	chr1	105261102	105265313	4211	105263706
chr1:105305270-105308978	chr1	105305270	105308978	3708	105307837
chr1:105878843-105885155	chr1	105878843	105885155	6312	105881422
chr1:105943314-105947379	chr1	105943314	105947379	4065	105945893
chr1:106311196-106314128	chr1	106311196	106314128	2932	106313777
chr1:106930022-106934121	chr1	106930022	106934121	4099	106932585
chr1:107716429-107718041	chr1	107716429	107718041	1612	107716826
chr1:108144445-108147540	chr1	108144445	108147540	3095	108147002
chr1:108161796-108167809	chr1	108161796	108167809	6013	108164380
chr1:108203428-108209902	chr1	108203428	108209902	6474	108206005
chr1:108350929-108353282	chr1	108350929	108353282	2353	108351332
chr1:108358320-108364417	chr1	108358320	108364417	6097	108360907
chr1:108404841-108406657	chr1	108404841	108406657	1816	108406173
chr1:108513780-108517444	chr1	108513780	108517444	3664	108516369
chr1:109742780-109748941	chr1	109742780	109748941	6161	109745366
chr1:111073531-111079655	chr1	111073531	111079655	6124	111076112
chr1:112154799-112160810	chr1	112154799	112160810	6011	112157386
chr1:112199142-112205303	chr1	112199142	112205303	6161	112201735
chr1:113359472-113360632	chr1	113359472	113360632	1160	113359673
chr1:113411875-113414694	chr1	113411875	113414694	2819	113414465
chr1:113473262-113479382	chr1	113473262	113479382	6120	113475815
chr1:113569875-113572932	chr1	113569875	113572932	3057	113572481
chr1:113633560-113639380	chr1	113633560	113639380	5820	113635814
chr1:114182629-114188155	chr1	114182629	114188155	5526	114185217
chr1:114785115-114789013	chr1	114785115	114789013	3898	114786913
chr1:114963374-114966674	chr1	114963374	114966674	3300	114965931
chr1:115014051-115020189	chr1	115014051	115020189	6138	115016640
chr1:115383344-115389475	chr1	115383344	115389475	6131	115385935
chr1:115633480-115639939	chr1	115633480	115639939	6459	115636057
chr1:117352562-117358724	chr1	117352562	117358724	6162	117355153
chr1:118511786-118517922	chr1	118511786	118517922	6136	118514368
chr1:118568232-118574250	chr1	118568232	118574250	6018	118570814
chr1:118704426-118707268	chr1	118704426	118707268	2842	118707008
chr1:118777414-118780673	chr1	118777414	118780673	3259	118780006
chr1:119152510-119157417	chr1	119152510	119157417	4907	119153866
chr1:119399357-119403472	chr1	119399357	119403472	4115	119401916
chr1:119693242-119697521	chr1	119693242	119697521	4279	119693997
chr1:120218986-120225130	chr1	120218986	120225130	6144	120221583
chr1:121309425-121314863	chr1	121309425	121314863	5438	121312012
chr1:121532230-121538261	chr1	121532230	121538261	6031	121534820
chr1:121581186-121587604	chr1	121581186	121587604	6418	121583749
chr1:121598206-121604319	chr1	121598206	121604319	6113	121600782
chr1:124961843-124967867	chr1	124961843	124967867	6024	124964427
chr1:143558090-143564124	chr1	143558090	143564124	6034	143560686
chr1:143577264-143583430	chr1	143577264	143583430	6166	143579849
chr1:145553326-145557357	chr1	145553326	145557357	4031	145555904
chr1:146717192-146723218	chr1	146717192	146723218	6026	146719778
chr1:147124825-147127850	chr1	147124825	147127850	3025	147127412
chr1:147191657-147195280	chr1	147191657	147195280	3623	147193097
chr1:147228009-147231695	chr1	147228009	147231695	3686	147230597
chr1:147321798-147327814	chr1	147321798	147327814	6016	147324376
chr1:147704992-147709408	chr1	147704992	147709408	4416	147707594
chr1:148830426-148836568	chr1	148830426	148836568	6142	148833022
chr1:149035016-149038869	chr1	149035016	149038869	3853	149037586
chr1:149036870-149041138	chr1	149036870	149041138	4268	149037586
chr1:149952053-149958158	chr1	149952053	149958158	6105	149954635
chr1:152260032-152262808	chr1	152260032	152262808	2776	152261834
chr1:152400203-152403570	chr1	152400203	152403570	3367	152402782
chr1:152431211-152436703	chr1	152431211	152436703	5492	152433802
chr1:152547782-152553918	chr1	152547782	152553918	6136	152550380
chr1:153004638-153008220	chr1	153004638	153008220	3582	153007218
chr1:153142363-153143477	chr1	153142363	153143477	1114	153143050
chr1:153183386-153189111	chr1	153183386	153189111	5725	153185293
chr1:153314261-153320572	chr1	153314261	153320572	6311	153316845
chr1:157241791-157244701	chr1	157241791	157244701	2910	157244347
chr1:157340304-157345344	chr1	157340304	157345344	5040	157342879
chr1:157609126-157610318	chr1	157609126	157610318	1192	157609631
chr1:158215799-158221947	chr1	158215799	158221947	6148	158218392
chr1:158314659-158320685	chr1	158314659	158320685	6026	158317250
chr1:158427020-158431063	chr1	158427020	158431063	4043	158429596
chr1:159409725-159411807	chr1	159409725	159411807	2082	159410286
chr1:159568953-159575104	chr1	159568953	159575104	6151	159571540
chr1:159759623-159761476	chr1	159759623	159761476	1853	159760793
chr1:160384670-160388821	chr1	160384670	160388821	4151	160387189
chr1:160475303-160481451	chr1	160475303	160481451	6148	160477894
chr1:160526324-160530345	chr1	160526324	160530345	4021	160526552
chr1:160593308-160594690	chr1	160593308	160594690	1382	160593714
chr1:160936959-160942037	chr1	160936959	160942037	5078	160938433
chr1:162806969-162811379	chr1	162806969	162811379	4410	162809554
chr1:163639993-163646040	chr1	163639993	163646040	6047	163642602
chr1:163750240-163756258	chr1	163750240	163756258	6018	163752817
chr1:163848424-163854546	chr1	163848424	163854546	6122	163851011
chr1:165015377-165018348	chr1	165015377	165018348	2971	165017958
chr1:165103239-165108433	chr1	165103239	165108433	5194	165105806
chr1:165778069-165784153	chr1	165778069	165784153	6084	165780627
chr1:165970864-165974367	chr1	165970864	165974367	3503	165973456
chr1:166211236-166214846	chr1	166211236	166214846	3610	166213811
chr1:166239974-166243065	chr1	166239974	166243065	3091	166242559
chr1:166243053-166249084	chr1	166243053	166249084	6031	166245645
chr1:166310878-166317027	chr1	166310878	166317027	6149	166313471
chr1:166404090-166406497	chr1	166404090	166406497	2407	166406224
chr1:166411299-166417438	chr1	166411299	166417438	6139	166413886
chr1:166423469-166429912	chr1	166423469	166429912	6443	166426043
chr1:166499950-166501338	chr1	166499950	166501338	1388	166500050
chr1:166546116-166548992	chr1	166546116	166548992	2876	166548713
chr1:166706771-166708563	chr1	166706771	166708563	1792	166707985
chr1:166778570-166782549	chr1	166778570	166782549	3979	166781195
chr1:166799455-166802916	chr1	166799455	166802916	3461	166801633
chr1:168248315-168249249	chr1	168248315	168249249	934	168248676
chr1:168348862-168354879	chr1	168348862	168354879	6017	168351454
chr1:168538181-168539751	chr1	168538181	168539751	1570	168539327
chr1:168659584-168662292	chr1	168659584	168662292	2708	168662154
chr1:168953693-168957353	chr1	168953693	168957353	3660	168956278
chr1:168992643-168999035	chr1	168992643	168999035	6392	168995133
chr1:169251561-169257591	chr1	169251561	169257591	6030	169254151
chr1:169275508-169279839	chr1	169275508	169279839	4331	169276275
chr1:169279837-169284820	chr1	169279837	169284820	4983	169282036
chr1:170089171-170095201	chr1	170089171	170095201	6030	170091763
chr1:170107477-170112341	chr1	170107477	170112341	4864	170110068
chr1:170423234-170424125	chr1	170423234	170424125	891	170423798
chr1:170451716-170455797	chr1	170451716	170455797	4081	170454316
chr1:170608238-170612183	chr1	170608238	170612183	3945	170610796
chr1:170759334-170760913	chr1	170759334	170760913	1579	170759434
chr1:171550468-171556557	chr1	171550468	171556557	6089	171553049
chr1:171688833-171693138	chr1	171688833	171693138	4305	171691423
chr1:172193221-172195131	chr1	172193221	172195131	1910	172193448
chr1:172591274-172597414	chr1	172591274	172597414	6140	172593863
chr1:172982027-172987306	chr1	172982027	172987306	5279	172983865
chr1:173069106-173073637	chr1	173069106	173073637	4531	173071688
chr1:173129295-173131951	chr1	173129295	173131951	2656	173131865
chr1:173650108-173656242	chr1	173650108	173656242	6134	173652684
chr1:174125494-174131899	chr1	174125494	174131899	6405	174128055
chr1:174233266-174239293	chr1	174233266	174239293	6027	174235856
chr1:174377791-174383815	chr1	174377791	174383815	6024	174380376
chr1:174541788-174545718	chr1	174541788	174545718	3930	174542181
chr1:174590323-174596379	chr1	174590323	174596379	6056	174592941
chr1:174610057-174616228	chr1	174610057	174616228	6171	174612644
chr1:174629928-174633018	chr1	174629928	174633018	3090	174630480
chr1:174645250-174652319	chr1	174645250	174652319	7069	174650422
chr1:174843226-174849243	chr1	174843226	174849243	6017	174845814
chr1:176002354-176008367	chr1	176002354	176008367	6013	176004940
chr1:176256085-176262110	chr1	176256085	176262110	6025	176258676
chr1:176308395-176314388	chr1	176308395	176314388	5993	176310967
chr1:176413286-176414213	chr1	176413286	176414213	927	176413503
chr1:177201689-177202695	chr1	177201689	177202695	1006	177201788
chr1:177378904-177385263	chr1	177378904	177385263	6359	177381483
chr1:177400917-177406941	chr1	177400917	177406941	6024	177403505
chr1:177671810-177677946	chr1	177671810	177677946	6136	177674406
chr1:177719329-177721651	chr1	177719329	177721651	2322	177719512
chr1:178244558-178250699	chr1	178244558	178250699	6141	178247154
chr1:178314791-178320818	chr1	178314791	178320818	6027	178317380
chr1:178987591-178993573	chr1	178987591	178993573	5982	178990187
chr1:179460043-179466249	chr1	179460043	179466249	6206	179462634
chr1:179535223-179541461	chr1	179535223	179541461	6238	179537780
chr1:179565572-179570183	chr1	179565572	179570183	4611	179568141
chr1:179684052-179690195	chr1	179684052	179690195	6143	179686630
chr1:180682974-180686602	chr1	180682974	180686602	3628	180685574
chr1:180866811-180872843	chr1	180866811	180872843	6032	180869403
chr1:181266604-181270848	chr1	181266604	181270848	4244	181268458
chr1:181886065-181887742	chr1	181886065	181887742	1677	181887695
chr1:181956117-181962358	chr1	181956117	181962358	6241	181958685
chr1:183747630-183748394	chr1	183747630	183748394	764	183747922
chr1:184231780-184235388	chr1	184231780	184235388	3608	184231839
chr1:184337351-184340880	chr1	184337351	184340880	3529	184339935
chr1:185251798-185257805	chr1	185251798	185257805	6007	185254367
chr1:185378615-185384739	chr1	185378615	185384739	6124	185381190
chr1:185778346-185784501	chr1	185778346	185784501	6155	185780936
chr1:185887306-185893334	chr1	185887306	185893334	6028	185889898
chr1:186157489-186163560	chr1	186157489	186163560	6071	186160009
chr1:186256600-186262729	chr1	186256600	186262729	6129	186259185
chr1:186506411-186512874	chr1	186506411	186512874	6463	186508982
chr1:186545298-186551440	chr1	186545298	186551440	6142	186547890
chr1:186723851-186727843	chr1	186723851	186727843	3992	186726431
chr1:187343764-187349794	chr1	187343764	187349794	6030	187346356
chr1:187540634-187543887	chr1	187540634	187543887	3253	187543202
chr1:187756540-187759519	chr1	187756540	187759519	2979	187759112
chr1:187803947-187808499	chr1	187803947	187808499	4552	187806527
chr1:188031133-188033957	chr1	188031133	188033957	2824	188033726
chr1:188752216-188758260	chr1	188752216	188758260	6044	188754828
chr1:189162282-189166460	chr1	189162282	189166460	4178	189164867
chr1:189297472-189299821	chr1	189297472	189299821	2349	189298208
chr1:189325284-189331428	chr1	189325284	189331428	6144	189327855
chr1:189410638-189416659	chr1	189410638	189416659	6021	189413224
chr1:189468736-189474768	chr1	189468736	189474768	6032	189471324
chr1:190730308-190734390	chr1	190730308	190734390	4082	190732899
chr1:191057291-191062321	chr1	191057291	191062321	5030	191059879
chr1:191373465-191378940	chr1	191373465	191378940	5475	191375374
chr1:191442810-191448889	chr1	191442810	191448889	6079	191445362
chr1:192092565-192095300	chr1	192092565	192095300	2735	192095152
chr1:192244904-192246218	chr1	192244904	192246218	1314	192245483
chr1:192481174-192484130	chr1	192481174	192484130	2956	192483776
chr1:192662965-192669094	chr1	192662965	192669094	6129	192665548
chr1:193428530-193430132	chr1	193428530	193430132	1602	193429081
chr1:193508734-193512956	chr1	193508734	193512956	4222	193511299
chr1:193641892-193645436	chr1	193641892	193645436	3544	193642006
chr1:193717837-193723892	chr1	193717837	193723892	6055	193720454
chr1:193877021-193878633	chr1	193877021	193878633	1612	193878366
chr1:194015375-194019830	chr1	194015375	194019830	4455	194017961
chr1:194312851-194314941	chr1	194312851	194314941	2090	194313914
chr1:195646995-195648139	chr1	195646995	195648139	1144	195647277
chr1:195925003-195929320	chr1	195925003	195929320	4317	195927582
chr1:196219370-196225402	chr1	196219370	196225402	6032	196221962
chr1:196349706-196353060	chr1	196349706	196353060	3354	196352293
chr1:196780803-196786955	chr1	196780803	196786955	6152	196783391
chr1:196814065-196817013	chr1	196814065	196817013	2948	196816657
chr1:196879799-196881673	chr1	196879799	196881673	1874	196880775
chr1:196935962-196942099	chr1	196935962	196942099	6137	196938550
chr1:196986363-196992657	chr1	196986363	196992657	6294	196988958
chr1:197240222-197245063	chr1	197240222	197245063	4841	197242761
chr1:197879603-197884983	chr1	197879603	197884983	5380	197881223
chr1:198248892-198252430	chr1	198248892	198252430	3538	198251464
chr1:198309446-198315462	chr1	198309446	198315462	6016	198312026
chr1:198473763-198477649	chr1	198473763	198477649	3886	198476356
chr1:199880950-199887084	chr1	199880950	199887084	6134	199883535
chr1:200796673-200800983	chr1	200796673	200800983	4310	200799256
chr1:201234105-201240262	chr1	201234105	201240262	6157	201236695
chr1:205400697-205406860	chr1	205400697	205406860	6163	205403289
chr1:206327806-206333246	chr1	206327806	206333246	5440	206330394
chr1:209913771-209919823	chr1	209913771	209919823	6052	209916384
chr1:209973212-209979350	chr1	209973212	209979350	6138	209975792
chr1:210441853-210444675	chr1	210441853	210444675	2822	210444434
chr1:210953899-210960045	chr1	210953899	210960045	6146	210956490
chr1:210982292-210988431	chr1	210982292	210988431	6139	210984872
chr1:211402290-211408411	chr1	211402290	211408411	6121	211404879
chr1:212849390-212851447	chr1	212849390	212851447	2057	212850831
chr1:213112563-213116991	chr1	213112563	213116991	4428	213115141
chr1:213357935-213361681	chr1	213357935	213361681	3746	213358222
chr1:213514234-213518051	chr1	213514234	213518051	3817	213516815
chr1:213625430-213628471	chr1	213625430	213628471	3041	213628011
chr1:213706545-213712968	chr1	213706545	213712968	6423	213709138
chr1:214721693-214728105	chr1	214721693	214728105	6412	214724281
chr1:215161421-215164673	chr1	215161421	215164673	3252	215164007
chr1:215427153-215433610	chr1	215427153	215433610	6457	215429741
chr1:215697829-215704269	chr1	215697829	215704269	6440	215700395
chr1:217690492-217696523	chr1	217690492	217696523	6031	217693079
chr1:218009227-218015252	chr1	218009227	218015252	6025	218011814
chr1:218647497-218650955	chr1	218647497	218650955	3458	218650063
chr1:219102684-219105803	chr1	219102684	219105803	3119	219105275
chr1:219727273-219729949	chr1	219727273	219729949	2676	219729853
chr1:220605520-220611692	chr1	220605520	220611692	6172	220608142
chr1:220858787-220864396	chr1	220858787	220864396	5609	220860700
chr1:220897479-220900923	chr1	220897479	220900923	3444	220900060
chr1:221257453-221263615	chr1	221257453	221263615	6162	221260038
chr1:221383064-221389208	chr1	221383064	221389208	6144	221385645
chr1:222351561-222354404	chr1	222351561	222354404	2843	222352624
chr1:222869784-222874941	chr1	222869784	222874941	5157	222872374
chr1:223366542-223372687	chr1	223366542	223372687	6145	223369127
chr1:223395534-223401557	chr1	223395534	223401557	6023	223398123
chr1:223864931-223867915	chr1	223864931	223867915	2984	223867434
chr1:224940523-224946618	chr1	224940523	224946618	6095	224943092
chr1:224974805-224976368	chr1	224974805	224976368	1563	224975314
chr1:225008724-225011758	chr1	225008724	225011758	3034	225010683
chr1:225055535-225061656	chr1	225055535	225061656	6121	225058118
chr1:225101894-225107374	chr1	225101894	225107374	5480	225104473
chr1:225126290-225128261	chr1	225126290	225128261	1971	225126296
chr1:225211917-225218017	chr1	225211917	225218017	6100	225214495
chr1:225243722-225245499	chr1	225243722	225245499	1777	225244440
chr1:225310461-225316810	chr1	225310461	225316810	6349	225313030
chr1:226499242-226504867	chr1	226499242	226504867	5625	226501848
chr1:226996293-226997973	chr1	226996293	226997973	1680	226997045
chr1:227207364-227210093	chr1	227207364	227210093	2729	227209945
chr1:227826730-227828432	chr1	227826730	227828432	1702	227827269
chr1:228520690-228526835	chr1	228520690	228526835	6145	228523280
chr1:230470631-230477066	chr1	230470631	230477066	6435	230473232
chr1:230653985-230658812	chr1	230653985	230658812	4827	230655686
chr1:231646101-231652225	chr1	231646101	231652225	6124	231648645
chr1:233764165-233770296	chr1	233764165	233770296	6131	233766757
chr1:233921680-233927007	chr1	233921680	233927007	5327	233924232
chr1:234049638-234055784	chr1	234049638	234055784	6146	234052226
chr1:235381813-235387760	chr1	235381813	235387760	5947	235384404
chr1:236186341-236192792	chr1	236186341	236192792	6451	236188908
chr1:237019467-237025494	chr1	237019467	237025494	6027	237022056
chr1:238037114-238043265	chr1	238037114	238043265	6151	238039701
chr1:238851858-238854128	chr1	238851858	238854128	2270	238852770
chr1:239623498-239629523	chr1	239623498	239629523	6025	239626089
chr1:239637768-239643908	chr1	239637768	239643908	6140	239640353
chr1:242045561-242051585	chr1	242045561	242051585	6024	242048148
chr1:242152360-242158772	chr1	242152360	242158772	6412	242154933
chr1:243659867-243660328	chr1	243659867	243660328	461	243660068
chr1:244539128-244540006	chr1	244539128	244540006	878	244539561
chr1:244562733-244565711	chr1	244562733	244565711	2978	244565336
chr1:245593171-245598092	chr1	245593171	245598092	4921	245595749
chr1:246239110-246242505	chr1	246239110	246242505	3395	246241681
chr1:246408995-246411180	chr1	246408995	246411180	2185	246410758
chr1:247507522-247513984	chr1	247507522	247513984	6462	247510090
chr1:247567160-247573636	chr1	247567160	247573636	6476	247569794
chr1:247593100-247595278	chr1	247593100	247595278	2178	247594989
chr1:247630176-247635344	chr1	247630176	247635344	5168	247632295
chr1:247888322-247894338	chr1	247888322	247894338	6016	247890908
chr1:247954964-247961087	chr1	247954964	247961087	6123	247957531
chr1:248055788-248056691	chr1	248055788	248056691	903	248055858
chr1:248074873-248077601	chr1	248074873	248077601	2728	248077430
chr1:248105963-248108818	chr1	248105963	248108818	2855	248108145
chr1:248117815-248121510	chr1	248117815	248121510	3695	248120403
chr1:248166559-248172589	chr1	248166559	248172589	6030	248169150
chr1:248295858-248298902	chr1	248295858	248298902	3044	248298439
chr1:248514120-248519266	chr1	248514120	248519266	5146	248516690
chr1:248922357-248923476	chr1	248922357	248923476	1119	248923045
chr10:118941-122575	chr10	118941	122575	3634	121497
chr10:149872-150547	chr10	149872	150547	675	150200
chr10:1221416-1227555	chr10	1221416	1227555	6139	1224011
chr10:1767078-1769402	chr10	1767078	1769402	2324	1768028
chr10:4793594-4796289	chr10	4793594	4796289	2695	4796166
chr10:5174970-5181139	chr10	5174970	5181139	6169	5177567
chr10:6369617-6375667	chr10	6369617	6375667	6050	6372227
chr10:6804143-6810301	chr10	6804143	6810301	6158	6806729
chr10:7058042-7063471	chr10	7058042	7063471	5429	7060621
chr10:9725462-9726482	chr10	9725462	9726482	1020	9725756
chr10:10069374-10075458	chr10	10069374	10075458	6084	10071964
chr10:10556035-10558861	chr10	10556035	10558861	2826	10558623
chr10:10691006-10696998	chr10	10691006	10696998	5992	10693599
chr10:11126899-11130258	chr10	11126899	11130258	3359	11129466
chr10:11731436-11737465	chr10	11731436	11737465	6029	11734027
chr10:14743064-14747844	chr10	14743064	14747844	4780	14744849
chr10:15664518-15670040	chr10	15664518	15670040	5522	15667106
chr10:15915731-15921753	chr10	15915731	15921753	6022	15918323
chr10:16127191-16130047	chr10	16127191	16130047	2856	16129779
chr10:16171578-16177724	chr10	16171578	16177724	6146	16174155
chr10:17717877-17722977	chr10	17717877	17722977	5100	17719399
chr10:17944650-17946363	chr10	17944650	17946363	1713	17946051
chr10:18030651-18036675	chr10	18030651	18036675	6024	18033238
chr10:19088601-19094618	chr10	19088601	19094618	6017	19091177
chr10:19160177-19160976	chr10	19160177	19160976	799	19160550
chr10:19440346-19446343	chr10	19440346	19446343	5997	19442907
chr10:19581231-19587252	chr10	19581231	19587252	6021	19583812
chr10:19676676-19681849	chr10	19676676	19681849	5173	19679246
chr10:20335243-20339997	chr10	20335243	20339997	4754	20336429
chr10:20459681-20465829	chr10	20459681	20465829	6148	20462264
chr10:20495630-20500943	chr10	20495630	20500943	5313	20498216
chr10:20525714-20531846	chr10	20525714	20531846	6132	20528301
chr10:20652283-20655385	chr10	20652283	20655385	3102	20654856
chr10:20751667-20757692	chr10	20751667	20757692	6025	20754253
chr10:21105937-21108903	chr10	21105937	21108903	2966	21107756
chr10:22074347-22080760	chr10	22074347	22080760	6413	22076911
chr10:22119451-22123889	chr10	22119451	22123889	4438	22122015
chr10:22123889-22129939	chr10	22123889	22129939	6050	22126499
chr10:22403137-22409152	chr10	22403137	22409152	6015	22405725
chr10:22508088-22514502	chr10	22508088	22514502	6414	22510711
chr10:23506499-23512073	chr10	23506499	23512073	5574	23508520
chr10:23586886-23589722	chr10	23586886	23589722	2836	23589451
chr10:23589779-23595933	chr10	23589779	23595933	6154	23592372
chr10:23666416-23672562	chr10	23666416	23672562	6146	23669005
chr10:23844739-23848454	chr10	23844739	23848454	3715	23847323
chr10:23851013-23857162	chr10	23851013	23857162	6149	23853602
chr10:23892943-23893663	chr10	23892943	23893663	720	23893079
chr10:24062137-24068291	chr10	24062137	24068291	6154	24064729
chr10:25247314-25253340	chr10	25247314	25253340	6026	25249900
chr10:25368696-25371378	chr10	25368696	25371378	2682	25369756
chr10:25470956-25473759	chr10	25470956	25473759	2803	25473543
chr10:25515369-25521391	chr10	25515369	25521391	6022	25517960
chr10:25990517-25996217	chr10	25990517	25996217	5700	25993096
chr10:26097389-26103512	chr10	26097389	26103512	6123	26099999
chr10:27870362-27875552	chr10	27870362	27875552	5190	27872944
chr10:28747381-28750911	chr10	28747381	28750911	3530	28749495
chr10:31106385-31112007	chr10	31106385	31112007	5622	31108973
chr10:31409365-31411084	chr10	31409365	31411084	1719	31410592
chr10:31443412-31449437	chr10	31443412	31449437	6025	31446004
chr10:31562791-31566621	chr10	31562791	31566621	3830	31565373
chr10:31637646-31642186	chr10	31637646	31642186	4540	31640397
chr10:31713705-31719815	chr10	31713705	31719815	6110	31716277
chr10:32482498-32488633	chr10	32482498	32488633	6135	32485086
chr10:32494399-32499103	chr10	32494399	32499103	4704	32496979
chr10:32592555-32598618	chr10	32592555	32598618	6063	32595137
chr10:32610428-32614541	chr10	32610428	32614541	4113	32613011
chr10:32636228-32639629	chr10	32636228	32639629	3401	32638818
chr10:32699054-32705157	chr10	32699054	32705157	6103	32701605
chr10:32868573-32873572	chr10	32868573	32873572	4999	32871188
chr10:33510845-33516876	chr10	33510845	33516876	6031	33513437
chr10:33848502-33853750	chr10	33848502	33853750	5248	33850423
chr10:35170264-35170805	chr10	35170264	35170805	541	35170488
chr10:36008114-36013643	chr10	36008114	36013643	5529	36010701
chr10:36892954-36899074	chr10	36892954	36899074	6120	36895546
chr10:36907462-36911779	chr10	36907462	36911779	4317	36910050
chr10:37038753-37044909	chr10	37038753	37044909	6156	37041341
chr10:37044908-37050652	chr10	37044908	37050652	5744	37047116
chr10:37271534-37273981	chr10	37271534	37273981	2447	37273599
chr10:37628119-37631961	chr10	37628119	37631961	3842	37630712
chr10:38372661-38377060	chr10	38372661	38377060	4399	38375237
chr10:38704518-38706484	chr10	38704518	38706484	1966	38705975
chr10:39367132-39373225	chr10	39367132	39373225	6093	39369709
chr10:39446490-39451895	chr10	39446490	39451895	5405	39449080
chr10:39466259-39470575	chr10	39466259	39470575	4316	39468850
chr10:39606089-39607431	chr10	39606089	39607431	1342	39607274
chr10:41797910-41803897	chr10	41797910	41803897	5987	41800469
chr10:42140003-42146144	chr10	42140003	42146144	6141	42142589
chr10:42257782-42263922	chr10	42257782	42263922	6140	42260366
chr10:42526228-42532221	chr10	42526228	42532221	5993	42528798
chr10:42533747-42540162	chr10	42533747	42540162	6415	42536319
chr10:43914804-43920900	chr10	43914804	43920900	6096	43917353
chr10:44077093-44079818	chr10	44077093	44079818	2725	44077347
chr10:44106734-44112897	chr10	44106734	44112897	6163	44109323
chr10:44147270-44152246	chr10	44147270	44152246	4976	44148993
chr10:44246175-44249439	chr10	44246175	44249439	3264	44248726
chr10:44448237-44454659	chr10	44448237	44454659	6422	44450818
chr10:44482818-44488227	chr10	44482818	44488227	5409	44485404
chr10:45009173-45015196	chr10	45009173	45015196	6023	45011764
chr10:45296890-45301997	chr10	45296890	45301997	5107	45298149
chr10:45326732-45329609	chr10	45326732	45329609	2877	45329223
chr10:47428760-47434270	chr10	47428760	47434270	5510	47430418
chr10:49125050-49127715	chr10	49125050	49127715	2665	49127450
chr10:49419602-49425774	chr10	49419602	49425774	6172	49422210
chr10:50178552-50181701	chr10	50178552	50181701	3149	50181134
chr10:50782474-50788587	chr10	50782474	50788587	6113	50785039
chr10:50910272-50913205	chr10	50910272	50913205	2933	50912862
chr10:51275964-51281393	chr10	51275964	51281393	5429	51278542
chr10:51504252-51506025	chr10	51504252	51506025	1773	51505559
chr10:51941454-51947615	chr10	51941454	51947615	6161	51944042
chr10:52360195-52366339	chr10	52360195	52366339	6144	52362786
chr10:52370408-52375682	chr10	52370408	52375682	5274	52371816
chr10:52730355-52736527	chr10	52730355	52736527	6172	52732967
chr10:52841656-52846402	chr10	52841656	52846402	4746	52843497
chr10:53494006-53500023	chr10	53494006	53500023	6017	53496590
chr10:53703855-53706983	chr10	53703855	53706983	3128	53706408
chr10:53792349-53797780	chr10	53792349	53797780	5431	53794934
chr10:55683076-55689092	chr10	55683076	55689092	6016	55685663
chr10:56442079-56448236	chr10	56442079	56448236	6157	56444667
chr10:56639108-56639868	chr10	56639108	56639868	760	56639148
chr10:56708740-56710102	chr10	56708740	56710102	1362	56709218
chr10:57443480-57447277	chr10	57443480	57447277	3797	57446061
chr10:57486871-57488258	chr10	57486871	57488258	1387	57486979
chr10:57546282-57552369	chr10	57546282	57552369	6087	57548862
chr10:57748252-57751304	chr10	57748252	57751304	3052	57750831
chr10:57933196-57934687	chr10	57933196	57934687	1491	57934334
chr10:58031284-58036866	chr10	58031284	58036866	5582	58033930
chr10:58417779-58423844	chr10	58417779	58423844	6065	58420362
chr10:58681864-58687984	chr10	58681864	58687984	6120	58684463
chr10:59037844-59043990	chr10	59037844	59043990	6146	59040436
chr10:59185289-59188913	chr10	59185289	59188913	3624	59187553
chr10:59198053-59201598	chr10	59198053	59201598	3545	59200645
chr10:59408327-59414456	chr10	59408327	59414456	6129	59410917
chr10:59421996-59427579	chr10	59421996	59427579	5583	59424609
chr10:62602750-62608755	chr10	62602750	62608755	6005	62605347
chr10:62672214-62676251	chr10	62672214	62676251	4037	62674798
chr10:63944638-63950772	chr10	63944638	63950772	6134	63947234
chr10:64015339-64021547	chr10	64015339	64021547	6208	64017965
chr10:64563976-64567516	chr10	64563976	64567516	3540	64564041
chr10:64581768-64584477	chr10	64581768	64584477	2709	64584347
chr10:65587111-65593241	chr10	65587111	65593241	6130	65589693
chr10:66331566-66336379	chr10	66331566	66336379	4813	66332815
chr10:67496945-67503427	chr10	67496945	67503427	6482	67499520
chr10:67509192-67512068	chr10	67509192	67512068	2876	67511783
chr10:67553761-67557109	chr10	67553761	67557109	3348	67556342
chr10:67579064-67585194	chr10	67579064	67585194	6130	67581647
chr10:67716329-67720672	chr10	67716329	67720672	4343	67718891
chr10:69509361-69511776	chr10	69509361	69511776	2415	69511164
chr10:70639480-70645618	chr10	70639480	70645618	6138	70642063
chr10:74568780-74571878	chr10	74568780	74571878	3098	74571376
chr10:74603260-74609701	chr10	74603260	74609701	6441	74605830
chr10:75515700-75521837	chr10	75515700	75521837	6137	75518290
chr10:75558530-75564686	chr10	75558530	75564686	6156	75561122
chr10:78676493-78682651	chr10	78676493	78682651	6158	78679083
chr10:79616540-79620483	chr10	79616540	79620483	3943	79616888
chr10:80095913-80097782	chr10	80095913	80097782	1869	80097450
chr10:80635794-80641508	chr10	80635794	80641508	5714	80638374
chr10:80722509-80728544	chr10	80722509	80728544	6035	80725100
chr10:80835775-80842208	chr10	80835775	80842208	6433	80838340
chr10:80865225-80867836	chr10	80865225	80867836	2611	80867779
chr10:80875008-80877753	chr10	80875008	80877753	2745	80877691
chr10:81768381-81773241	chr10	81768381	81773241	4860	81769802
chr10:82016934-82020089	chr10	82016934	82020089	3155	82019525
chr10:82044578-82047247	chr10	82044578	82047247	2669	82047157
chr10:82344062-82350086	chr10	82344062	82350086	6024	82346653
chr10:83337369-83343495	chr10	83337369	83343495	6126	83339961
chr10:83359822-83362377	chr10	83359822	83362377	2555	83361740
chr10:83741800-83747326	chr10	83741800	83747326	5526	83743807
chr10:83781056-83787087	chr10	83781056	83787087	6031	83783648
chr10:84485743-84491876	chr10	84485743	84491876	6133	84488328
chr10:84645390-84651553	chr10	84645390	84651553	6163	84648235
chr10:84773060-84779262	chr10	84773060	84779262	6202	84775837
chr10:85074191-85075366	chr10	85074191	85075366	1175	85074601
chr10:85274403-85280847	chr10	85274403	85280847	6444	85276979
chr10:88350239-88356365	chr10	88350239	88356365	6126	88352788
chr10:88628462-88634738	chr10	88628462	88634738	6276	88631174
chr10:90113089-90119061	chr10	90113089	90119061	5972	90115662
chr10:90153450-90159478	chr10	90153450	90159478	6028	90156038
chr10:90365824-90369622	chr10	90365824	90369622	3798	90368388
chr10:90422067-90424764	chr10	90422067	90424764	2697	90424680
chr10:91324304-91328005	chr10	91324304	91328005	3701	91324440
chr10:91370271-91371013	chr10	91370271	91371013	742	91370620
chr10:91426850-91431931	chr10	91426850	91431931	5081	91429466
chr10:91438091-91441886	chr10	91438091	91441886	3795	91440665
chr10:91731936-91735389	chr10	91731936	91735389	3453	91734366
chr10:94159622-94165478	chr10	94159622	94165478	5856	94162244
chr10:94634346-94640786	chr10	94634346	94640786	6440	94636942
chr10:94659928-94664895	chr10	94659928	94664895	4967	94660152
chr10:94713181-94717530	chr10	94713181	94717530	4349	94715770
chr10:94789096-94794487	chr10	94789096	94794487	5391	94790955
chr10:94795013-94801150	chr10	94795013	94801150	6137	94797576
chr10:94810179-94814251	chr10	94810179	94814251	4072	94810473
chr10:94824660-94830681	chr10	94824660	94830681	6021	94827250
chr10:94895425-94899058	chr10	94895425	94899058	3633	94895501
chr10:94954906-94960759	chr10	94954906	94960759	5853	94957494
chr10:94965988-94969898	chr10	94965988	94969898	3910	94966281
chr10:95018185-95023634	chr10	95018185	95023634	5449	95020045
chr10:95058650-95064584	chr10	95058650	95064584	5934	95061229
chr10:95105272-95111424	chr10	95105272	95111424	6152	95107855
chr10:95161558-95163393	chr10	95161558	95163393	1835	95162900
chr10:95851429-95856188	chr10	95851429	95856188	4759	95854020
chr10:95928410-95934850	chr10	95928410	95934850	6440	95930973
chr10:96180347-96186348	chr10	96180347	96186348	6001	96182910
chr10:98177040-98181123	chr10	98177040	98181123	4083	98179651
chr10:98227581-98230738	chr10	98227581	98230738	3157	98230169
chr10:98722852-98724792	chr10	98722852	98724792	1940	98723552
chr10:98782941-98788971	chr10	98782941	98788971	6030	98785531
chr10:98929995-98933721	chr10	98929995	98933721	3726	98932557
chr10:99640567-99646687	chr10	99640567	99646687	6120	99643154
chr10:104528334-104533647	chr10	104528334	104533647	5313	104530929
chr10:104719978-104726123	chr10	104719978	104726123	6145	104722566
chr10:104972711-104975072	chr10	104972711	104975072	2361	104973283
chr10:105318612-105323856	chr10	105318612	105323856	5244	105321201
chr10:105377346-105383377	chr10	105377346	105383377	6031	105379938
chr10:105474833-105481175	chr10	105474833	105481175	6342	105477592
chr10:105775520-105781551	chr10	105775520	105781551	6031	105778112
chr10:106844583-106850610	chr10	106844583	106850610	6027	106847172
chr10:108310130-108316139	chr10	108310130	108316139	6009	108312722
chr10:108793640-108796816	chr10	108793640	108796816	3176	108796218
chr10:109092701-109095718	chr10	109092701	109095718	3017	109093066
chr10:109536621-109543034	chr10	109536621	109543034	6413	109539183
chr10:109681560-109687714	chr10	109681560	109687714	6154	109684152
chr10:109795499-109801544	chr10	109795499	109801544	6045	109798117
chr10:109812437-109818457	chr10	109812437	109818457	6020	109815017
chr10:115150726-115154586	chr10	115150726	115154586	3860	115153305
chr10:115200226-115203069	chr10	115200226	115203069	2843	115202820
chr10:115253598-115259751	chr10	115253598	115259751	6153	115256225
chr10:115315990-115321303	chr10	115315990	115321303	5313	115318476
chr10:115362336-115368543	chr10	115362336	115368543	6207	115365108
chr10:115485743-115492200	chr10	115485743	115492200	6457	115488309
chr10:115530627-115536762	chr10	115530627	115536762	6135	115533190
chr10:115581746-115587785	chr10	115581746	115587785	6039	115584337
chr10:115753182-115758855	chr10	115753182	115758855	5673	115755757
chr10:116933170-116939611	chr10	116933170	116939611	6441	116935753
chr10:117079038-117085063	chr10	117079038	117085063	6025	117081623
chr10:117832895-117838887	chr10	117832895	117838887	5992	117835474
chr10:118646330-118652742	chr10	118646330	118652742	6412	118648876
chr10:119985109-119988055	chr10	119985109	119988055	2946	119987690
chr10:120149585-120152911	chr10	120149585	120152911	3326	120152174
chr10:120234299-120240325	chr10	120234299	120240325	6026	120236889
chr10:122806671-122809669	chr10	122806671	122809669	2998	122809263
chr10:122917844-122919572	chr10	122917844	122919572	1728	122918748
chr10:125178986-125185121	chr10	125178986	125185121	6135	125181540
chr10:125613284-125618613	chr10	125613284	125618613	5329	125615871
chr10:126343045-126347574	chr10	126343045	126347574	4529	126345611
chr10:126761056-126767491	chr10	126761056	126767491	6435	126763613
chr10:128223575-128229710	chr10	128223575	128229710	6135	128226157
chr10:129732560-129738580	chr10	129732560	129738580	6020	129735149
chr10:130316193-130319757	chr10	130316193	130319757	3564	130316959
chr10:131504576-131510718	chr10	131504576	131510718	6142	131507154
chr10_GL383546v1_alt:121658-126765	chr10_GL383546v1_alt	121658	126765	5107	122917
chr10_GL383546v1_alt:151503-154380	chr10_GL383546v1_alt	151503	154380	2877	153994
chr10_KI270824v1_alt:36764-42905	chr10_KI270824v1_alt	36764	42905	6141	39350
chr10_KI270824v1_alt:140339-146479	chr10_KI270824v1_alt	140339	146479	6140	142923
chr11:2492351-2496154	chr11	2492351	2496154	3803	2494927
chr11:2634174-2640355	chr11	2634174	2640355	6181	2636773
chr11:3265155-3270908	chr11	3265155	3270908	5753	3267008
chr11:3310983-3316728	chr11	3310983	3316728	5745	3312828
chr11:3492956-3499051	chr11	3492956	3499051	6095	3495541
chr11:4010717-4013690	chr11	4010717	4013690	2973	4013311
chr11:4170252-4176276	chr11	4170252	4176276	6024	4172834
chr11:4298273-4303151	chr11	4298273	4303151	4878	4300851
chr11:4349463-4354340	chr11	4349463	4354340	4877	4352042
chr11:4400824-4406940	chr11	4400824	4406940	6116	4403397
chr11:4933574-4936461	chr11	4933574	4936461	2887	4936165
chr11:5111063-5114929	chr11	5111063	5114929	3866	5113467
chr11:5179834-5182478	chr11	5179834	5182478	2644	5182413
chr11:5216007-5222133	chr11	5216007	5222133	6126	5218572
chr11:6948755-6954881	chr11	6948755	6954881	6126	6951321
chr11:7325111-7326556	chr11	7325111	7326556	1445	7326201
chr11:7658148-7664171	chr11	7658148	7664171	6023	7660735
chr11:7811185-7813731	chr11	7811185	7813731	2546	7811735
chr11:7920264-7923840	chr11	7920264	7923840	3576	7922848
chr11:8444870-8446496	chr11	8444870	8446496	1626	8445966
chr11:9540333-9546363	chr11	9540333	9546363	6030	9542925
chr11:10226332-10232454	chr11	10226332	10232454	6122	10228905
chr11:10420213-10426536	chr11	10420213	10426536	6323	10422699
chr11:10946356-10952722	chr11	10946356	10952722	6366	10948856
chr11:11194477-11198786	chr11	11194477	11198786	4309	11197065
chr11:11711306-11717431	chr11	11711306	11717431	6125	11713881
chr11:12334453-12339973	chr11	12334453	12339973	5520	12337041
chr11:13394545-13400693	chr11	13394545	13400693	6148	13397129
chr11:13528717-13535122	chr11	13528717	13535122	6405	13531265
chr11:13554957-13560975	chr11	13554957	13560975	6018	13557548
chr11:13623018-13629231	chr11	13623018	13629231	6213	13625618
chr11:13793800-13799273	chr11	13793800	13799273	5473	13796414
chr11:13820011-13824766	chr11	13820011	13824766	4755	13822596
chr11:13986371-13990373	chr11	13986371	13990373	4002	13989136
chr11:14084155-14090373	chr11	14084155	14090373	6218	14086734
chr11:14168499-14173964	chr11	14168499	14173964	5465	14171082
chr11:14594760-14600876	chr11	14594760	14600876	6116	14597332
chr11:14628166-14634160	chr11	14628166	14634160	5994	14630753
chr11:16637913-16644048	chr11	16637913	16644048	6135	16640498
chr11:17028490-17034655	chr11	17028490	17034655	6165	17031090
chr11:17339355-17343300	chr11	17339355	17343300	3945	17341904
chr11:18122203-18126496	chr11	18122203	18126496	4293	18124776
chr11:18891921-18897998	chr11	18891921	18897998	6077	18894184
chr11:18988741-18994012	chr11	18988741	18994012	5271	18991301
chr11:19062775-19067108	chr11	19062775	19067108	4333	19065360
chr11:19581371-19587519	chr11	19581371	19587519	6148	19583965
chr11:19618906-19624893	chr11	19618906	19624893	5987	19621343
chr11:20070958-20074940	chr11	20070958	20074940	3982	20073523
chr11:20470251-20473627	chr11	20470251	20473627	3376	20472806
chr11:20689285-20694271	chr11	20689285	20694271	4986	20691872
chr11:21199647-21205716	chr11	21199647	21205716	6069	21202214
chr11:21669048-21675069	chr11	21669048	21675069	6021	21671635
chr11:21692556-21696072	chr11	21692556	21696072	3516	21695116
chr11:21790885-21794031	chr11	21790885	21794031	3146	21793448
chr11:21995845-22001092	chr11	21995845	22001092	5247	21998436
chr11:22016002-22022021	chr11	22016002	22022021	6019	22018585
chr11:22523178-22529212	chr11	22523178	22529212	6034	22525783
chr11:22646925-22652945	chr11	22646925	22652945	6020	22649505
chr11:22968219-22974693	chr11	22968219	22974693	6474	22970808
chr11:23007075-23008718	chr11	23007075	23008718	1643	23007980
chr11:23028117-23034138	chr11	23028117	23034138	6021	23030705
chr11:23298136-23304191	chr11	23298136	23304191	6055	23300754
chr11:23410333-23412005	chr11	23410333	23412005	1672	23410441
chr11:23633190-23633699	chr11	23633190	23633699	509	23633299
chr11:24168769-24170491	chr11	24168769	24170491	1722	24168918
chr11:24279070-24282281	chr11	24279070	24282281	3211	24281657
chr11:24450123-24451535	chr11	24450123	24451535	1412	24450959
chr11:24849134-24855083	chr11	24849134	24855083	5949	24851705
chr11:24957754-24963917	chr11	24957754	24963917	6163	24960338
chr11:24972586-24974474	chr11	24972586	24974474	1888	24973013
chr11:25022755-25024214	chr11	25022755	25024214	1459	25023236
chr11:25141388-25146840	chr11	25141388	25146840	5452	25144003
chr11:25275325-25281473	chr11	25275325	25281473	6148	25277919
chr11:25496126-25502139	chr11	25496126	25502139	6013	25498704
chr11:25643792-25649786	chr11	25643792	25649786	5994	25646360
chr11:25719115-25724896	chr11	25719115	25724896	5781	25721328
chr11:26289819-26292961	chr11	26289819	26292961	3142	26289998
chr11:26604148-26606569	chr11	26604148	26606569	2421	26605514
chr11:27267887-27273632	chr11	27267887	27273632	5745	27270471
chr11:28181235-28184592	chr11	28181235	28184592	3357	28183846
chr11:28205108-28208730	chr11	28205108	28208730	3622	28207697
chr11:28216563-28222701	chr11	28216563	28222701	6138	28219147
chr11:28233803-28236557	chr11	28233803	28236557	2754	28236395
chr11:28372620-28378682	chr11	28372620	28378682	6062	28375254
chr11:28787392-28793742	chr11	28787392	28793742	6350	28789916
chr11:28881809-28883218	chr11	28881809	28883218	1409	28881988
chr11:29045754-29050740	chr11	29045754	29050740	4986	29048356
chr11:29355430-29358286	chr11	29355430	29358286	2856	29358023
chr11:29368813-29372489	chr11	29368813	29372489	3676	29371388
chr11:29765668-29771818	chr11	29765668	29771818	6150	29768259
chr11:30051207-30057234	chr11	30051207	30057234	6027	30053793
chr11:30062542-30067760	chr11	30062542	30067760	5218	30064224
chr11:30263143-30269287	chr11	30263143	30269287	6144	30265730
chr11:31315654-31321680	chr11	31315654	31321680	6026	31318245
chr11:31329394-31335540	chr11	31329394	31335540	6146	31331967
chr11:31693166-31696634	chr11	31693166	31696634	3468	31695755
chr11:32661712-32667810	chr11	32661712	32667810	6098	32664268
chr11:32741669-32748080	chr11	32741669	32748080	6411	32744496
chr11:32941250-32947256	chr11	32941250	32947256	6006	32943823
chr11:33624757-33630805	chr11	33624757	33630805	6048	33627345
chr11:34686968-34690828	chr11	34686968	34690828	3860	34689559
chr11:34760210-34764985	chr11	34760210	34764985	4775	34761422
chr11:35754504-35760643	chr11	35754504	35760643	6139	35757091
chr11:35773472-35779564	chr11	35773472	35779564	6092	35776057
chr11:36551606-36557636	chr11	36551606	36557636	6030	36554197
chr11:37017860-37021592	chr11	37017860	37021592	3732	37020452
chr11:37029979-37032533	chr11	37029979	37032533	2554	37032504
chr11:37240712-37246716	chr11	37240712	37246716	6004	37243284
chr11:37432371-37435741	chr11	37432371	37435741	3370	37432430
chr11:38164008-38167446	chr11	38164008	38167446	3438	38166587
chr11:38488726-38492035	chr11	38488726	38492035	3309	38491324
chr11:38726137-38732552	chr11	38726137	38732552	6415	38728712
chr11:38917754-38921771	chr11	38917754	38921771	4017	38917936
chr11:38941428-38944184	chr11	38941428	38944184	2756	38944011
chr11:39391931-39396983	chr11	39391931	39396983	5052	39394506
chr11:39633332-39634716	chr11	39633332	39634716	1384	39633977
chr11:40585472-40591501	chr11	40585472	40591501	6029	40588064
chr11:41723125-41727081	chr11	41723125	41727081	3956	41724384
chr11:42429263-42435286	chr11	42429263	42435286	6023	42431851
chr11:42915838-42917446	chr11	42915838	42917446	1608	42916882
chr11:42999366-43005518	chr11	42999366	43005518	6152	43001952
chr11:43095011-43101151	chr11	43095011	43101151	6140	43097593
chr11:43201230-43207380	chr11	43201230	43207380	6150	43203818
chr11:43346101-43352118	chr11	43346101	43352118	6017	43348677
chr11:43653400-43659541	chr11	43653400	43659541	6141	43655993
chr11:43713126-43715744	chr11	43713126	43715744	2618	43715713
chr11:44390874-44395203	chr11	44390874	44395203	4329	44393446
chr11:45011815-45017945	chr11	45011815	45017945	6130	45014391
chr11:45122414-45128497	chr11	45122414	45128497	6083	45124927
chr11:46992245-46996293	chr11	46992245	46996293	4048	46994864
chr11:47112840-47116675	chr11	47112840	47116675	3835	47115418
chr11:48185761-48191894	chr11	48185761	48191894	6133	48188338
chr11:48230670-48236801	chr11	48230670	48236801	6131	48233259
chr11:48283743-48290252	chr11	48283743	48290252	6509	48288760
chr11:48301726-48302690	chr11	48301726	48302690	964	48301851
chr11:48386972-48390575	chr11	48386972	48390575	3603	48389566
chr11:48410063-48416227	chr11	48410063	48416227	6164	48412642
chr11:48425563-48427446	chr11	48425563	48427446	1883	48426856
chr11:48448049-48454082	chr11	48448049	48454082	6033	48450399
chr11:48514172-48517995	chr11	48514172	48517995	3823	48516760
chr11:48527917-48534075	chr11	48527917	48534075	6158	48530505
chr11:48541984-48548048	chr11	48541984	48548048	6064	48544493
chr11:48549487-48555535	chr11	48549487	48555535	6048	48551943
chr11:48555543-48559496	chr11	48555543	48559496	3953	48556155
chr11:48644493-48647825	chr11	48644493	48647825	3332	48646785
chr11:48652778-48658518	chr11	48652778	48658518	5740	48655361
chr11:48677882-48679941	chr11	48677882	48679941	2059	48679528
chr11:48699836-48702505	chr11	48699836	48702505	2669	48702418
chr11:48744637-48750715	chr11	48744637	48750715	6078	48747283
chr11:48799944-48804599	chr11	48799944	48804599	4655	48801035
chr11:48847666-48853724	chr11	48847666	48853724	6058	48850284
chr11:49040206-49046329	chr11	49040206	49046329	6123	49042787
chr11:49158504-49159910	chr11	49158504	49159910	1406	49159717
chr11:49309750-49311725	chr11	49309750	49311725	1975	49310333
chr11:49711879-49715000	chr11	49711879	49715000	3121	49714469
chr11:49775119-49781151	chr11	49775119	49781151	6032	49777710
chr11:49793154-49797728	chr11	49793154	49797728	4574	49795746
chr11:49927053-49930600	chr11	49927053	49930600	3547	49929631
chr11:49945538-49947816	chr11	49945538	49947816	2278	49946667
chr11:50193742-50199904	chr11	50193742	50199904	6162	50196336
chr11:50253167-50257893	chr11	50253167	50257893	4726	50255753
chr11:50324109-50330243	chr11	50324109	50330243	6134	50326692
chr11:50471795-50474496	chr11	50471795	50474496	2701	50472995
chr11:50703281-50709435	chr11	50703281	50709435	6154	50705877
chr11:50743743-50747290	chr11	50743743	50747290	3547	50745572
chr11:50813349-50819364	chr11	50813349	50819364	6015	50815939
chr11:54561218-54564818	chr11	54561218	54564818	3600	54563811
chr11:54581308-54587469	chr11	54581308	54587469	6161	54583903
chr11:54595297-54598440	chr11	54595297	54598440	3143	54597885
chr11:54694308-54697831	chr11	54694308	54697831	3523	54696896
chr11:54742394-54745385	chr11	54742394	54745385	2991	54744967
chr11:54845113-54849946	chr11	54845113	54849946	4833	54847694
chr11:54893406-54894203	chr11	54893406	54894203	797	54893843
chr11:54954813-54955495	chr11	54954813	54955495	682	54955459
chr11:54987589-54989655	chr11	54987589	54989655	2066	54989241
chr11:55017523-55018998	chr11	55017523	55018998	1475	55017655
chr11:55167539-55173664	chr11	55167539	55173664	6125	55170115
chr11:55234324-55238974	chr11	55234324	55238974	4650	55235415
chr11:55335438-55339025	chr11	55335438	55339025	3587	55336051
chr11:55393264-55399409	chr11	55393264	55399409	6145	55395855
chr11:55406186-55411244	chr11	55406186	55411244	5058	55408808
chr11:55515230-55521224	chr11	55515230	55521224	5994	55517797
chr11:55531391-55534270	chr11	55531391	55534270	2879	55533348
chr11:55595564-55598253	chr11	55595564	55598253	2689	55598145
chr11:55619133-55623160	chr11	55619133	55623160	4027	55621722
chr11:55758922-55763674	chr11	55758922	55763674	4752	55761515
chr11:56005483-56008307	chr11	56005483	56008307	2824	56008076
chr11:56074963-56079584	chr11	56074963	56079584	4621	56077557
chr11:56217067-56219015	chr11	56217067	56219015	1948	56218361
chr11:56549045-56555051	chr11	56549045	56555051	6006	56551631
chr11:56586668-56592678	chr11	56586668	56592678	6010	56589255
chr11:56655022-56658816	chr11	56655022	56658816	3794	56657598
chr11:56724754-56728054	chr11	56724754	56728054	3300	56727338
chr11:56939062-56942383	chr11	56939062	56942383	3321	56941650
chr11:57947551-57953991	chr11	57947551	57953991	6440	57950124
chr11:57994162-58000187	chr11	57994162	58000187	6025	57996752
chr11:58277335-58283746	chr11	58277335	58283746	6411	58279913
chr11:58304142-58309665	chr11	58304142	58309665	5523	58306719
chr11:58696285-58700694	chr11	58696285	58700694	4409	58698883
chr11:58822124-58823703	chr11	58822124	58823703	1579	58823008
chr11:58871283-58877422	chr11	58871283	58877422	6139	58873874
chr11:59315471-59321591	chr11	59315471	59321591	6120	59318055
chr11:59344177-59348245	chr11	59344177	59348245	4068	59346760
chr11:59381654-59387795	chr11	59381654	59387795	6141	59384233
chr11:59887090-59892483	chr11	59887090	59892483	5393	59888885
chr11:60005643-60010904	chr11	60005643	60010904	5261	60008211
chr11:60248789-60251357	chr11	60248789	60251357	2568	60251304
chr11:62239711-62240482	chr11	62239711	62240482	771	62239934
chr11:62302559-62307120	chr11	62302559	62307120	4561	62303240
chr11:63036317-63042433	chr11	63036317	63042433	6116	63038905
chr11:63072952-63079111	chr11	63072952	63079111	6159	63075544
chr11:63105933-63108829	chr11	63105933	63108829	2896	63108519
chr11:63108845-63112501	chr11	63108845	63112501	3656	63111437
chr11:63185545-63191694	chr11	63185545	63191694	6149	63188133
chr11:63230650-63236805	chr11	63230650	63236805	6155	63233222
chr11:63328096-63332797	chr11	63328096	63332797	4701	63330673
chr11:63339047-63340849	chr11	63339047	63340849	1802	63340738
chr11:63344422-63350438	chr11	63344422	63350438	6016	63346997
chr11:63364502-63366011	chr11	63364502	63366011	1509	63364650
chr11:63384889-63386434	chr11	63384889	63386434	1545	63386388
chr11:63449782-63452634	chr11	63449782	63452634	2852	63452373
chr11:67864707-67867963	chr11	67864707	67867963	3256	67867290
chr11:68671509-68672283	chr11	68671509	68672283	774	68671992
chr11:74289447-74295003	chr11	74289447	74295003	5556	74292033
chr11:74526252-74529425	chr11	74526252	74529425	3173	74528845
chr11:74758803-74762555	chr11	74758803	74762555	3752	74759898
chr11:74877463-74883532	chr11	74877463	74883532	6069	74880053
chr11:75682156-75688638	chr11	75682156	75688638	6482	75684729
chr11:75974665-75980018	chr11	75974665	75980018	5353	75976455
chr11:76091834-76094762	chr11	76091834	76094762	2928	76094446
chr11:76826412-76829142	chr11	76826412	76829142	2730	76828987
chr11:76927459-76931953	chr11	76927459	76931953	4494	76930057
chr11:77218393-77224331	chr11	77218393	77224331	5938	77220793
chr11:78597436-78603627	chr11	78597436	78603627	6191	78600025
chr11:78677772-78683802	chr11	78677772	78683802	6030	78680364
chr11:79960962-79961613	chr11	79960962	79961613	651	79961417
chr11:81534298-81540421	chr11	81534298	81540421	6123	81536874
chr11:82516775-82520605	chr11	82516775	82520605	3830	82519357
chr11:83413022-83417156	chr11	83413022	83417156	4134	83415577
chr11:83512502-83518664	chr11	83512502	83518664	6162	83515115
chr11:84200512-84201760	chr11	84200512	84201760	1248	84201534
chr11:84362508-84365815	chr11	84362508	84365815	3307	84365100
chr11:84726115-84729578	chr11	84726115	84729578	3463	84728678
chr11:84732654-84735803	chr11	84732654	84735803	3149	84735226
chr11:84876229-84877726	chr11	84876229	84877726	1497	84876272
chr11:85003726-85006891	chr11	85003726	85006891	3165	85006315
chr11:85349422-85352596	chr11	85349422	85352596	3174	85351997
chr11:85414862-85421408	chr11	85414862	85421408	6546	85417532
chr11:85465312-85468818	chr11	85465312	85468818	3506	85467898
chr11:85503961-85508239	chr11	85503961	85508239	4278	85505807
chr11:85542991-85549441	chr11	85542991	85549441	6450	85545576
chr11:86824478-86830636	chr11	86824478	86830636	6158	86827081
chr11:86962525-86968225	chr11	86962525	86968225	5700	86964669
chr11:87163039-87165679	chr11	87163039	87165679	2640	87165628
chr11:87166100-87170994	chr11	87166100	87170994	4894	87167897
chr11:87241858-87248000	chr11	87241858	87248000	6142	87244439
chr11:87340031-87346061	chr11	87340031	87346061	6030	87342621
chr11:87502212-87508384	chr11	87502212	87508384	6172	87504873
chr11:87618151-87624199	chr11	87618151	87624199	6048	87620738
chr11:87652558-87658716	chr11	87652558	87658716	6158	87655150
chr11:87698098-87704215	chr11	87698098	87704215	6117	87700683
chr11:87758408-87764544	chr11	87758408	87764544	6136	87760983
chr11:87797763-87801645	chr11	87797763	87801645	3882	87797778
chr11:87946393-87952021	chr11	87946393	87952021	5628	87948977
chr11:88218193-88224363	chr11	88218193	88224363	6170	88220783
chr11:88393104-88397023	chr11	88393104	88397023	3919	88395694
chr11:88457851-88463984	chr11	88457851	88463984	6133	88460437
chr11:89313260-89319255	chr11	89313260	89319255	5995	89315842
chr11:90043781-90049896	chr11	90043781	90049896	6115	90046367
chr11:90089696-90095729	chr11	90089696	90095729	6033	90092290
chr11:90265269-90271690	chr11	90265269	90271690	6421	90267657
chr11:90296684-90303090	chr11	90296684	90303090	6406	90299257
chr11:90306290-90308036	chr11	90306290	90308036	1746	90307984
chr11:90374413-90377450	chr11	90374413	90377450	3037	90377042
chr11:90400067-90406098	chr11	90400067	90406098	6031	90402659
chr11:90577471-90583607	chr11	90577471	90583607	6136	90580051
chr11:90685702-90691834	chr11	90685702	90691834	6132	90688284
chr11:90967023-90972302	chr11	90967023	90972302	5279	90968863
chr11:91015681-91018567	chr11	91015681	91018567	2886	91018258
chr11:91033580-91035485	chr11	91033580	91035485	1905	91033912
chr11:91250935-91254038	chr11	91250935	91254038	3103	91253547
chr11:91316307-91322421	chr11	91316307	91322421	6114	91318877
chr11:92009510-92015672	chr11	92009510	92015672	6162	92012103
chr11:92425389-92430515	chr11	92425389	92430515	5126	92427956
chr11:93172447-93178524	chr11	93172447	93178524	6077	93175035
chr11:93439098-93445217	chr11	93439098	93445217	6119	93441638
chr11:94094016-94100160	chr11	94094016	94100160	6144	94096606
chr11:94156729-94162863	chr11	94156729	94162863	6134	94159340
chr11:94232524-94238528	chr11	94232524	94238528	6004	94235109
chr11:94238528-94241278	chr11	94238528	94241278	2750	94240741
chr11:95469589-95472579	chr11	95469589	95472579	2990	95472172
chr11:95626326-95632351	chr11	95626326	95632351	6025	95628914
chr11:96344921-96347590	chr11	96344921	96347590	2669	96347508
chr11:96405620-96411665	chr11	96405620	96411665	6045	96408213
chr11:96771827-96777820	chr11	96771827	96777820	5993	96774382
chr11:96787501-96793683	chr11	96787501	96793683	6182	96790089
chr11:97040160-97046278	chr11	97040160	97046278	6118	97042718
chr11:97192642-97198855	chr11	97192642	97198855	6213	97195314
chr11:97779488-97784006	chr11	97779488	97784006	4518	97782044
chr11:98116801-98120638	chr11	98116801	98120638	3837	98119454
chr11:98324881-98330921	chr11	98324881	98330921	6040	98327487
chr11:98342126-98345623	chr11	98342126	98345623	3497	98344716
chr11:98646992-98648592	chr11	98646992	98648592	1600	98647665
chr11:99031765-99036130	chr11	99031765	99036130	4365	99034357
chr11:99577835-99583973	chr11	99577835	99583973	6138	99580418
chr11:99904140-99907266	chr11	99904140	99907266	3126	99906732
chr11:99962168-99965822	chr11	99962168	99965822	3654	99964747
chr11:100034967-100041123	chr11	100034967	100041123	6156	100037556
chr11:100154009-100157114	chr11	100154009	100157114	3105	100156590
chr11:100475720-100481744	chr11	100475720	100481744	6024	100478305
chr11:100895842-100902045	chr11	100895842	100902045	6203	100898429
chr11:101366350-101370235	chr11	101366350	101370235	3885	101366395
chr11:101375369-101377701	chr11	101375369	101377701	2332	101376637
chr11:101395542-101397562	chr11	101395542	101397562	2020	101397081
chr11:101462008-101467169	chr11	101462008	101467169	5161	101463397
chr11:101678417-101684557	chr11	101678417	101684557	6140	101681002
chr11:101836317-101837162	chr11	101836317	101837162	845	101836951
chr11:101874461-101877880	chr11	101874461	101877880	3419	101877136
chr11:102031424-102035970	chr11	102031424	102035970	4546	102034006
chr11:102296696-102300501	chr11	102296696	102300501	3805	102299216
chr11:102369166-102375192	chr11	102369166	102375192	6026	102371755
chr11:102502443-102505773	chr11	102502443	102505773	3330	102504554
chr11:102741437-102747464	chr11	102741437	102747464	6027	102744026
chr11:102813892-102817684	chr11	102813892	102817684	3792	102816450
chr11:102978031-102979255	chr11	102978031	102979255	1224	102978887
chr11:103136231-103142353	chr11	103136231	103142353	6122	103138801
chr11:103386499-103392632	chr11	103386499	103392632	6133	103389090
chr11:103814811-103820944	chr11	103814811	103820944	6133	103817399
chr11:104920211-104924004	chr11	104920211	104924004	3793	104922771
chr11:105956113-105958724	chr11	105956113	105958724	2611	105958702
chr11:106122272-106122752	chr11	106122272	106122752	480	106122711
chr11:106334452-106339655	chr11	106334452	106339655	5203	106337045
chr11:106864225-106865429	chr11	106864225	106865429	1204	106865005
chr11:107460543-107466920	chr11	107460543	107466920	6377	107463106
chr11:108273630-108277842	chr11	108273630	108277842	4212	108273960
chr11:109078082-109084221	chr11	109078082	109084221	6139	109080664
chr11:109177494-109183526	chr11	109177494	109183526	6032	109180086
chr11:109188643-109193462	chr11	109188643	109193462	4819	109189970
chr11:109215692-109221456	chr11	109215692	109221456	5764	109218301
chr11:109878368-109882003	chr11	109878368	109882003	3635	109880963
chr11:110382810-110388912	chr11	110382810	110388912	6102	110385374
chr11:110550590-110553974	chr11	110550590	110553974	3384	110552427
chr11:110555869-110557960	chr11	110555869	110557960	2091	110557423
chr11:112326552-112331151	chr11	112326552	112331151	4599	112328202
chr11:112428849-112431822	chr11	112428849	112431822	2973	112431445
chr11:112678555-112684569	chr11	112678555	112684569	6014	112681144
chr11:114633465-114639620	chr11	114633465	114639620	6155	114636053
chr11:114839820-114842962	chr11	114839820	114842962	3142	114842407
chr11:115876568-115880770	chr11	115876568	115880770	4202	115879163
chr11:117398985-117402210	chr11	117398985	117402210	3225	117401564
chr11:121172190-121178325	chr11	121172190	121178325	6135	121174779
chr11:121781423-121785258	chr11	121781423	121785258	3835	121784011
chr11:123824160-123828005	chr11	123824160	123828005	3845	123826763
chr11:123980221-123985348	chr11	123980221	123985348	5127	123981719
chr11:124127040-124130756	chr11	124127040	124130756	3716	124129567
chr11:124962648-124968793	chr11	124962648	124968793	6145	124965229
chr11:125711505-125717650	chr11	125711505	125717650	6145	125714090
chr11:127755570-127758600	chr11	127755570	127758600	3030	127757252
chr11:127776695-127782718	chr11	127776695	127782718	6023	127779285
chr11:127868667-127872497	chr11	127868667	127872497	3830	127871268
chr11:129338915-129344902	chr11	129338915	129344902	5987	129341507
chr11:129508912-129512028	chr11	129508912	129512028	3116	129511498
chr11:130538452-130540508	chr11	130538452	130540508	2056	130540091
chr11:132756780-132763277	chr11	132756780	132763277	6497	132759388
chr11:133879120-133885713	chr11	133879120	133885713	6593	133881695
chr11:134492284-134497661	chr11	134492284	134497661	5377	134494859
chr11:134720169-134723779	chr11	134720169	134723779	3610	134722737
chr11_GL383547v1_alt:110652-116800	chr11_GL383547v1_alt	110652	116800	6148	113246
chr11_JH159136v1_alt:27816-29764	chr11_JH159136v1_alt	27816	29764	1948	29110
chr11_JH159137v1_alt:42596-45896	chr11_JH159137v1_alt	42596	45896	3300	45180
chr11_KI270829v1_alt:32053-34599	chr11_KI270829v1_alt	32053	34599	2546	32603
chr11_KI270829v1_alt:151765-155341	chr11_KI270829v1_alt	151765	155341	3576	154349
chr12:370612-376718	chr12	370612	376718	6106	373180
chr12:1733610-1736914	chr12	1733610	1736914	3304	1736182
chr12:2130303-2136321	chr12	2130303	2136321	6018	2132893
chr12:2746188-2749137	chr12	2746188	2749137	2949	2748764
chr12:3392214-3398233	chr12	3392214	3398233	6019	3394799
chr12:3499195-3505228	chr12	3499195	3505228	6033	3501788
chr12:5116426-5122428	chr12	5116426	5122428	6002	5119002
chr12:5284940-5290958	chr12	5284940	5290958	6018	5287532
chr12:7504961-7508351	chr12	7504961	7508351	3390	7507553
chr12:7515840-7516242	chr12	7515840	7516242	402	7516094
chr12:8148951-8153611	chr12	8148951	8153611	4660	8151343
chr12:8301068-8307182	chr12	8301068	8307182	6114	8303653
chr12:8963349-8965007	chr12	8963349	8965007	1658	8963623
chr12:9355758-9359700	chr12	9355758	9359700	3942	9357647
chr12:9521530-9527573	chr12	9521530	9527573	6043	9524139
chr12:9627298-9633386	chr12	9627298	9633386	6088	9629856
chr12:9682370-9685144	chr12	9682370	9685144	2774	9684967
chr12:9845174-9850042	chr12	9845174	9850042	4868	9846098
chr12:10344458-10349853	chr12	10344458	10349853	5395	10347028
chr12:10472621-10475736	chr12	10472621	10475736	3115	10475248
chr12:10516550-10518615	chr12	10516550	10518615	2065	10517199
chr12:10743292-10748362	chr12	10743292	10748362	5070	10745852
chr12:10924524-10925058	chr12	10924524	10925058	534	10924589
chr12:11147790-11149354	chr12	11147790	11149354	1564	11148874
chr12:11530095-11532144	chr12	11530095	11532144	2049	11531179
chr12:12418687-12422275	chr12	12418687	12422275	3588	12421639
chr12:13392354-13397632	chr12	13392354	13397632	5278	13394195
chr12:13398684-13400411	chr12	13398684	13400411	1727	13400267
chr12:14861686-14865409	chr12	14861686	14865409	3723	14863937
chr12:15943740-15949837	chr12	15943740	15949837	6097	15946316
chr12:16377145-16383292	chr12	16377145	16383292	6147	16379735
chr12:16653298-16656201	chr12	16653298	16656201	2903	16655877
chr12:16707191-16709042	chr12	16707191	16709042	1851	16708250
chr12:16769032-16772844	chr12	16769032	16772844	3812	16771620
chr12:17474678-17476011	chr12	17474678	17476011	1333	17475643
chr12:17559108-17564909	chr12	17559108	17564909	5801	17561688
chr12:17622572-17628696	chr12	17622572	17628696	6124	17625112
chr12:17699378-17705544	chr12	17699378	17705544	6166	17701966
chr12:17768360-17774389	chr12	17768360	17774389	6029	17770955
chr12:17814543-17817708	chr12	17814543	17817708	3165	17817118
chr12:18450424-18453432	chr12	18450424	18453432	3008	18452159
chr12:18890260-18896672	chr12	18890260	18896672	6412	18892810
chr12:19728689-19734844	chr12	19728689	19734844	6155	19731272
chr12:20058780-20061758	chr12	20058780	20061758	2978	20061387
chr12:20975603-20981864	chr12	20975603	20981864	6261	20978320
chr12:21083799-21088613	chr12	21083799	21088613	4814	21085045
chr12:21131834-21137985	chr12	21131834	21137985	6151	21134421
chr12:21209060-21215087	chr12	21209060	21215087	6027	21211649
chr12:21253854-21255125	chr12	21253854	21255125	1271	21254826
chr12:21622800-21627711	chr12	21622800	21627711	4911	21624152
chr12:23070636-23076652	chr12	23070636	23076652	6016	23073221
chr12:23515653-23521207	chr12	23515653	23521207	5554	23518242
chr12:24619827-24623505	chr12	24619827	24623505	3678	24622413
chr12:25604350-25610476	chr12	25604350	25610476	6126	25606920
chr12:26310352-26316762	chr12	26310352	26316762	6410	26312905
chr12:27073975-27074450	chr12	27073975	27074450	475	27074086
chr12:27136818-27139505	chr12	27136818	27139505	2687	27139396
chr12:27845578-27848497	chr12	27845578	27848497	2919	27848166
chr12:28002994-28008079	chr12	28002994	28008079	5085	28005608
chr12:28499364-28502166	chr12	28499364	28502166	2802	28501794
chr12:28519571-28523948	chr12	28519571	28523948	4377	28522160
chr12:28673012-28677575	chr12	28673012	28677575	4563	28675581
chr12:29406310-29412472	chr12	29406310	29412472	6162	29408896
chr12:29584444-29587324	chr12	29584444	29587324	2880	29587023
chr12:30036093-30040207	chr12	30036093	30040207	4114	30038678
chr12:30432502-30436412	chr12	30432502	30436412	3910	30435092
chr12:30520163-30524078	chr12	30520163	30524078	3915	30522747
chr12:30889643-30895170	chr12	30889643	30895170	5527	30891621
chr12:32424069-32429745	chr12	32424069	32429745	5676	32426652
chr12:33102281-33108456	chr12	33102281	33108456	6175	33104872
chr12:33141767-33147912	chr12	33141767	33147912	6145	33144353
chr12:33194164-33199084	chr12	33194164	33199084	4920	33196470
chr12:33796849-33800648	chr12	33796849	33800648	3799	33799413
chr12:33914958-33921059	chr12	33914958	33921059	6101	33917502
chr12:33975392-33976822	chr12	33975392	33976822	1430	33975878
chr12:34066822-34072846	chr12	34066822	34072846	6024	34069410
chr12:34464049-34470194	chr12	34464049	34470194	6145	34466638
chr12:34667083-34673103	chr12	34667083	34673103	6020	34669662
chr12:37317876-37323907	chr12	37317876	37323907	6031	37320470
chr12:37660774-37666748	chr12	37660774	37666748	5974	37663174
chr12:38071658-38073316	chr12	38071658	38073316	1658	38071935
chr12:38963466-38969603	chr12	38963466	38969603	6137	38966052
chr12:39192274-39197558	chr12	39192274	39197558	5284	39194864
chr12:39469654-39475805	chr12	39469654	39475805	6151	39472241
chr12:39563625-39569776	chr12	39563625	39569776	6151	39566217
chr12:39664078-39670184	chr12	39664078	39670184	6106	39666654
chr12:39726166-39731784	chr12	39726166	39731784	5618	39728734
chr12:39898919-39899947	chr12	39898919	39899947	1028	39899069
chr12:40813207-40817475	chr12	40813207	40817475	4268	40816238
chr12:41040490-41042598	chr12	41040490	41042598	2108	41041503
chr12:41081468-41087471	chr12	41081468	41087471	6003	41084042
chr12:41158205-41161068	chr12	41158205	41161068	2863	41160790
chr12:41178946-41182273	chr12	41178946	41182273	3327	41181528
chr12:41637415-41643440	chr12	41637415	41643440	6025	41640005
chr12:41666304-41672330	chr12	41666304	41672330	6026	41668893
chr12:41973167-41979337	chr12	41973167	41979337	6170	41975755
chr12:42043485-42049636	chr12	42043485	42049636	6151	42046079
chr12:42248910-42254574	chr12	42248910	42254574	5664	42251495
chr12:42653612-42659518	chr12	42653612	42659518	5906	42655958
chr12:42719822-42725750	chr12	42719822	42725750	5928	42722413
chr12:42895841-42899038	chr12	42895841	42899038	3197	42898432
chr12:43583654-43585246	chr12	43583654	43585246	1592	43584547
chr12:44108220-44114234	chr12	44108220	44114234	6014	44110794
chr12:44681417-44687432	chr12	44681417	44687432	6015	44684008
chr12:45317132-45321085	chr12	45317132	45321085	3953	45319705
chr12:46189948-46196086	chr12	46189948	46196086	6138	46192519
chr12:46307044-46313162	chr12	46307044	46313162	6118	46309633
chr12:46345817-46348841	chr12	46345817	46348841	3024	46348392
chr12:46420944-46427078	chr12	46420944	46427078	6134	46423522
chr12:46539930-46546054	chr12	46539930	46546054	6124	46542529
chr12:46582778-46586459	chr12	46582778	46586459	3681	46582883
chr12:46586466-46591710	chr12	46586466	46591710	5244	46588264
chr12:46973775-46977596	chr12	46973775	46977596	3821	46976387
chr12:47453994-47457914	chr12	47453994	47457914	3920	47454387
chr12:47520571-47524377	chr12	47520571	47524377	3806	47523134
chr12:48272386-48274443	chr12	48272386	48274443	2057	48272696
chr12:48320193-48326175	chr12	48320193	48326175	5982	48322635
chr12:48381246-48383802	chr12	48381246	48383802	2556	48381698
chr12:48403176-48407211	chr12	48403176	48407211	4035	48405758
chr12:51559590-51562615	chr12	51559590	51562615	3025	51562177
chr12:51562631-51568657	chr12	51562631	51568657	6026	51565221
chr12:54766962-54770215	chr12	54766962	54770215	3253	54769550
chr12:54808193-54812531	chr12	54808193	54812531	4338	54809534
chr12:54812572-54816615	chr12	54812572	54816615	4043	54815160
chr12:54882885-54889034	chr12	54882885	54889034	6149	54885467
chr12:55081365-55087407	chr12	55081365	55087407	6042	55083954
chr12:55096256-55102283	chr12	55096256	55102283	6027	55098847
chr12:55151455-55157596	chr12	55151455	55157596	6141	55154032
chr12:55161585-55167616	chr12	55161585	55167616	6031	55164188
chr12:55504697-55510839	chr12	55504697	55510839	6142	55507282
chr12:58017144-58023285	chr12	58017144	58023285	6141	58019718
chr12:58053653-58059697	chr12	58053653	58059697	6044	58056259
chr12:58109257-58115306	chr12	58109257	58115306	6049	58111870
chr12:58226938-58233087	chr12	58226938	58233087	6149	58229528
chr12:58471406-58477554	chr12	58471406	58477554	6148	58473994
chr12:58704334-58708153	chr12	58704334	58708153	3819	58706916
chr12:58836438-58841821	chr12	58836438	58841821	5383	58837969
chr12:58992494-58995461	chr12	58992494	58995461	2967	58995082
chr12:59222012-59224979	chr12	59222012	59224979	2967	59224600
chr12:59346272-59349702	chr12	59346272	59349702	3430	59348966
chr12:59466087-59467123	chr12	59466087	59467123	1036	59466815
chr12:59498163-59499005	chr12	59498163	59499005	842	59498321
chr12:59764332-59767116	chr12	59764332	59767116	2784	59766919
chr12:60761472-60766895	chr12	60761472	60766895	5423	60764048
chr12:60774617-60776425	chr12	60774617	60776425	1808	60775144
chr12:60791925-60796205	chr12	60791925	60796205	4280	60794515
chr12:60808593-60813110	chr12	60808593	60813110	4517	60811164
chr12:60972071-60976278	chr12	60972071	60976278	4207	60974637
chr12:61003286-61005505	chr12	61003286	61005505	2219	61003674
chr12:61134123-61136703	chr12	61134123	61136703	2580	61135380
chr12:61203884-61209204	chr12	61203884	61209204	5320	61206469
chr12:61220890-61224536	chr12	61220890	61224536	3646	61223473
chr12:61414978-61421115	chr12	61414978	61421115	6137	61417557
chr12:61472099-61474076	chr12	61472099	61474076	1977	61473933
chr12:62199192-62202346	chr12	62199192	62202346	3154	62201827
chr12:62337463-62343846	chr12	62337463	62343846	6383	62339973
chr12:62364557-62367212	chr12	62364557	62367212	2655	62367122
chr12:63030325-63033626	chr12	63030325	63033626	3301	63032870
chr12:63188193-63189625	chr12	63188193	63189625	1432	63189187
chr12:63488101-63490764	chr12	63488101	63490764	2663	63490718
chr12:64287349-64293377	chr12	64287349	64293377	6028	64289938
chr12:64848274-64851291	chr12	64848274	64851291	3017	64850862
chr12:64962055-64964841	chr12	64962055	64964841	2786	64963315
chr12:65030472-65036581	chr12	65030472	65036581	6109	65033037
chr12:65345580-65348911	chr12	65345580	65348911	3331	65348173
chr12:65397610-65404059	chr12	65397610	65404059	6449	65400190
chr12:65549420-65555107	chr12	65549420	65555107	5687	65552002
chr12:66094432-66097366	chr12	66094432	66097366	2934	66097018
chr12:67226093-67231627	chr12	67226093	67231627	5534	67228679
chr12:67549715-67556185	chr12	67549715	67556185	6470	67552299
chr12:67843805-67849821	chr12	67843805	67849821	6016	67846394
chr12:67863917-67870339	chr12	67863917	67870339	6422	67866450
chr12:67971026-67977377	chr12	67971026	67977377	6351	67973602
chr12:68045355-68048068	chr12	68045355	68048068	2713	68047906
chr12:69773410-69779441	chr12	69773410	69779441	6031	69776001
chr12:69803496-69806577	chr12	69803496	69806577	3081	69806085
chr12:69860742-69863460	chr12	69860742	69863460	2718	69863338
chr12:70299225-70305316	chr12	70299225	70305316	6091	70301808
chr12:70472019-70474363	chr12	70472019	70474363	2344	70473081
chr12:70502147-70504201	chr12	70502147	70504201	2054	70504067
chr12:72150397-72156542	chr12	72150397	72156542	6145	72152984
chr12:72514640-72520656	chr12	72514640	72520656	6016	72517232
chr12:72634504-72640519	chr12	72634504	72640519	6015	72637091
chr12:72795378-72797930	chr12	72795378	72797930	2552	72797877
chr12:72807579-72813698	chr12	72807579	72813698	6119	72810158
chr12:72851360-72857571	chr12	72851360	72857571	6211	72854014
chr12:73147617-73153645	chr12	73147617	73153645	6028	73150210
chr12:73193623-73199787	chr12	73193623	73199787	6164	73196222
chr12:73283667-73289668	chr12	73283667	73289668	6001	73286243
chr12:73409723-73412593	chr12	73409723	73412593	2870	73412298
chr12:73462009-73464569	chr12	73462009	73464569	2560	73464080
chr12:73498040-73504208	chr12	73498040	73504208	6168	73500621
chr12:73969882-73970615	chr12	73969882	73970615	733	73970127
chr12:74351428-74355148	chr12	74351428	74355148	3720	74353977
chr12:74503521-74509541	chr12	74503521	74509541	6020	74506109
chr12:75001356-75004126	chr12	75001356	75004126	2770	75003940
chr12:75517430-75523582	chr12	75517430	75523582	6152	75520021
chr12:77173381-77179424	chr12	77173381	77179424	6043	77175977
chr12:77260479-77264547	chr12	77260479	77264547	4068	77261584
chr12:77424985-77428164	chr12	77424985	77428164	3179	77426932
chr12:77803095-77809633	chr12	77803095	77809633	6538	77805754
chr12:78263306-78263999	chr12	78263306	78263999	693	78263444
chr12:79039621-79045645	chr12	79039621	79045645	6024	79042213
chr12:79493548-79496866	chr12	79493548	79496866	3318	79495927
chr12:79506418-79508140	chr12	79506418	79508140	1722	79507685
chr12:80074669-80080828	chr12	80074669	80080828	6159	80077263
chr12:80080827-80084722	chr12	80080827	80084722	3895	80080882
chr12:80123035-80129186	chr12	80123035	80129186	6151	80125626
chr12:80144055-80150076	chr12	80144055	80150076	6021	80146646
chr12:80244169-80250184	chr12	80244169	80250184	6015	80246751
chr12:80448375-80454445	chr12	80448375	80454445	6070	80450966
chr12:80520363-80524293	chr12	80520363	80524293	3930	80522951
chr12:81477467-81480844	chr12	81477467	81480844	3377	81477997
chr12:82303737-82304950	chr12	82303737	82304950	1213	82304162
chr12:82310490-82314388	chr12	82310490	82314388	3898	82313069
chr12:82629128-82635626	chr12	82629128	82635626	6498	82631746
chr12:83226839-83233276	chr12	83226839	83233276	6437	83229416
chr12:83236928-83239921	chr12	83236928	83239921	2993	83239473
chr12:83429469-83433220	chr12	83429469	83433220	3751	83429603
chr12:83544385-83549113	chr12	83544385	83549113	4728	83546954
chr12:83549114-83553154	chr12	83549114	83553154	4040	83551698
chr12:83787344-83790049	chr12	83787344	83790049	2705	83789926
chr12:83829048-83831992	chr12	83829048	83831992	2944	83831621
chr12:84005904-84011930	chr12	84005904	84011930	6026	84008489
chr12:85312419-85318459	chr12	85312419	85318459	6040	85315020
chr12:86034583-86037927	chr12	86034583	86037927	3344	86036881
chr12:86686177-86690758	chr12	86686177	86690758	4581	86686922
chr12:87590572-87592599	chr12	87590572	87592599	2027	87590875
chr12:87696263-87700626	chr12	87696263	87700626	4363	87698857
chr12:87969763-87975178	chr12	87969763	87975178	5415	87972352
chr12:88461090-88465032	chr12	88461090	88465032	3942	88463726
chr12:88708857-88714885	chr12	88708857	88714885	6028	88711445
chr12:89806579-89812601	chr12	89806579	89812601	6022	89809169
chr12:90219849-90222799	chr12	90219849	90222799	2950	90222412
chr12:90508925-90510767	chr12	90508925	90510767	1842	90510450
chr12:90749469-90755760	chr12	90749469	90755760	6291	90752065
chr12:91708276-91712098	chr12	91708276	91712098	3822	91710861
chr12:92678206-92684347	chr12	92678206	92684347	6141	92680790
chr12:94129905-94132762	chr12	94129905	94132762	2857	94132524
chr12:94483557-94484596	chr12	94483557	94484596	1039	94484298
chr12:95923545-95929565	chr12	95923545	95929565	6020	95926129
chr12:96599015-96605111	chr12	96599015	96605111	6096	96601543
chr12:96723682-96729837	chr12	96723682	96729837	6155	96726264
chr12:97349408-97355558	chr12	97349408	97355558	6150	97351997
chr12:97603217-97609364	chr12	97603217	97609364	6147	97605810
chr12:97651133-97657167	chr12	97651133	97657167	6034	97653720
chr12:97691324-97697438	chr12	97691324	97697438	6114	97693898
chr12:97704727-97709190	chr12	97704727	97709190	4463	97707338
chr12:97892319-97898766	chr12	97892319	97898766	6447	97894879
chr12:99315677-99321808	chr12	99315677	99321808	6131	99318253
chr12:100636820-100642977	chr12	100636820	100642977	6157	100639411
chr12:101123822-101126010	chr12	101123822	101126010	2188	101125975
chr12:101261083-101265200	chr12	101261083	101265200	4117	101263689
chr12:101508926-101511808	chr12	101508926	101511808	2882	101511517
chr12:102137524-102143613	chr12	102137524	102143613	6089	102140071
chr12:102252579-102254777	chr12	102252579	102254777	2198	102253727
chr12:102285757-102288184	chr12	102285757	102288184	2427	102285787
chr12:102307781-102313768	chr12	102307781	102313768	5987	102310351
chr12:102444968-102447718	chr12	102444968	102447718	2750	102446310
chr12:102488493-102494084	chr12	102488493	102494084	5591	102491079
chr12:102605348-102608493	chr12	102605348	102608493	3145	102606888
chr12:102827177-102833208	chr12	102827177	102833208	6031	102829769
chr12:103463596-103466261	chr12	103463596	103466261	2665	103466185
chr12:103608441-103613835	chr12	103608441	103613835	5394	103610275
chr12:104388564-104394705	chr12	104388564	104394705	6141	104391152
chr12:104571755-104572833	chr12	104571755	104572833	1078	104572302
chr12:104806066-104808902	chr12	104806066	104808902	2836	104808655
chr12:104878332-104884474	chr12	104878332	104884474	6142	104880903
chr12:104915349-104916394	chr12	104915349	104916394	1045	104916358
chr12:105178988-105182034	chr12	105178988	105182034	3046	105181548
chr12:105513864-105520009	chr12	105513864	105520009	6145	105516439
chr12:106206808-106210536	chr12	106206808	106210536	3728	106209364
chr12:106465469-106471598	chr12	106465469	106471598	6129	106468040
chr12:106471865-106477891	chr12	106471865	106477891	6026	106474453
chr12:106545917-106552049	chr12	106545917	106552049	6132	106548502
chr12:111829162-111835315	chr12	111829162	111835315	6153	111831751
chr12:112954595-112959481	chr12	112954595	112959481	4886	112955924
chr12:118657889-118664030	chr12	118657889	118664030	6141	118660474
chr12:118668582-118674733	chr12	118668582	118674733	6151	118671160
chr12:118793104-118799193	chr12	118793104	118799193	6089	118795706
chr12:118966033-118969220	chr12	118966033	118969220	3187	118968611
chr12:119532438-119536455	chr12	119532438	119536455	4017	119535005
chr12:126299023-126305038	chr12	126299023	126305038	6015	126301602
chr12:126320655-126326787	chr12	126320655	126326787	6132	126323255
chr12:127094605-127100631	chr12	127094605	127100631	6026	127097192
chr12:128481981-128482737	chr12	128481981	128482737	756	128482563
chr12:128491850-128497975	chr12	128491850	128497975	6125	128494435
chr12:129037558-129043695	chr12	129037558	129043695	6137	129040145
chr12:129055881-129062051	chr12	129055881	129062051	6170	129058474
chr12:129345711-129346548	chr12	129345711	129346548	837	129346026
chr12:129416057-129417225	chr12	129416057	129417225	1168	129417136
chr12:131502695-131505484	chr12	131502695	131505484	2789	131505277
chr12:133197036-133200549	chr12	133197036	133200549	3513	133199624
chr12_GL383550v2_alt:37892-42212	chr12_GL383550v2_alt	37892	42212	4320	40478
chr12_GL383551v1_alt:71817-77832	chr12_GL383551v1_alt	71817	77832	6015	74396
chr12_GL383551v1_alt:91196-97228	chr12_GL383551v1_alt	91196	97228	6032	93788
chr12_GL383551v1_alt:99501-105632	chr12_GL383551v1_alt	99501	105632	6131	102100
chr12_GL383552v1_alt:70279-73246	chr12_GL383552v1_alt	70279	73246	2967	72867
chr12_GL383553v2_alt:103157-106240	chr12_GL383553v2_alt	103157	106240	3083	105748
chr12_GL383553v2_alt:106236-109326	chr12_GL383553v2_alt	106236	109326	3090	108834
chr12_GL383553v2_alt:109322-112407	chr12_GL383553v2_alt	109322	112407	3085	111915
chr12_GL383553v2_alt:112403-118427	chr12_GL383553v2_alt	112403	118427	6024	114995
chr12_GL877876v1_alt:123230-123764	chr12_GL877876v1_alt	123230	123764	534	123295
chr12_GL877876v1_alt:378444-380008	chr12_GL877876v1_alt	378444	380008	1564	379528
chr12_KI270904v1_alt:123230-123764	chr12_KI270904v1_alt	123230	123764	534	123295
chr12_KI270904v1_alt:342752-344317	chr12_KI270904v1_alt	342752	344317	1565	343837
chr13:18517817-18519561	chr13	18517817	18519561	1744	18518436
chr13:19103712-19109724	chr13	19103712	19109724	6012	19106297
chr13:19212824-19216873	chr13	19212824	19216873	4049	19213313
chr13:19576106-19577585	chr13	19576106	19577585	1479	19577290
chr13:19611546-19617890	chr13	19611546	19617890	6344	19614331
chr13:21407291-21411317	chr13	21407291	21411317	4026	21409196
chr13:21855728-21861909	chr13	21855728	21861909	6181	21858312
chr13:22475533-22476722	chr13	22475533	22476722	1189	22476223
chr13:23257431-23261262	chr13	23257431	23261262	3831	23259131
chr13:23403236-23404246	chr13	23403236	23404246	1010	23403350
chr13:24548423-24554557	chr13	24548423	24554557	6134	24551009
chr13:24806647-24812668	chr13	24806647	24812668	6021	24809233
chr13:25007262-25010556	chr13	25007262	25010556	3294	25009864
chr13:25893048-25899177	chr13	25893048	25899177	6129	25895621
chr13:26630160-26633196	chr13	26630160	26633196	3036	26632760
chr13:28903260-28906790	chr13	28903260	28906790	3530	28905842
chr13:28993901-28999438	chr13	28993901	28999438	5537	28996486
chr13:29641706-29647706	chr13	29641706	29647706	6000	29644298
chr13:29823715-29829837	chr13	29823715	29829837	6122	29826285
chr13:31578663-31584627	chr13	31578663	31584627	5964	31581253
chr13:32602094-32608174	chr13	32602094	32608174	6080	32604661
chr13:33501337-33503800	chr13	33501337	33503800	2463	33502970
chr13:34049629-34054238	chr13	34049629	34054238	4609	34052174
chr13:34480262-34486294	chr13	34480262	34486294	6032	34482854
chr13:34983035-34988638	chr13	34983035	34988638	5603	34985627
chr13:35316113-35322582	chr13	35316113	35322582	6469	35318689
chr13:35414233-35418312	chr13	35414233	35418312	4079	35416825
chr13:35422150-35428282	chr13	35422150	35428282	6132	35424737
chr13:36008229-36014237	chr13	36008229	36014237	6008	36010814
chr13:36468309-36474434	chr13	36468309	36474434	6125	36470890
chr13:36486213-36490026	chr13	36486213	36490026	3813	36488788
chr13:37149952-37155982	chr13	37149952	37155982	6030	37152544
chr13:37822274-37828299	chr13	37822274	37828299	6025	37824860
chr13:38834022-38837764	chr13	38834022	38837764	3742	38836532
chr13:39000817-39006875	chr13	39000817	39006875	6058	39003435
chr13:39113999-39120470	chr13	39113999	39120470	6471	39116571
chr13:39848275-39854404	chr13	39848275	39854404	6129	39850857
chr13:40007782-40010152	chr13	40007782	40010152	2370	40009324
chr13:40706744-40710827	chr13	40706744	40710827	4083	40709320
chr13:40864571-40870598	chr13	40864571	40870598	6027	40867163
chr13:41042308-41048414	chr13	41042308	41048414	6106	41044882
chr13:41534751-41540868	chr13	41534751	41540868	6117	41537337
chr13:41617490-41620643	chr13	41617490	41620643	3153	41620058
chr13:41746981-41748637	chr13	41746981	41748637	1656	41748186
chr13:42140900-42143928	chr13	42140900	42143928	3028	42143487
chr13:42505520-42507647	chr13	42505520	42507647	2127	42506994
chr13:42554800-42556236	chr13	42554800	42556236	1436	42555514
chr13:42770915-42777405	chr13	42770915	42777405	6490	42773557
chr13:43710923-43714805	chr13	43710923	43714805	3882	43713501
chr13:43971705-43976214	chr13	43971705	43976214	4509	43972774
chr13:44773665-44776635	chr13	44773665	44776635	2970	44774092
chr13:45635171-45641632	chr13	45635171	45641632	6461	45637759
chr13:45664064-45670213	chr13	45664064	45670213	6149	45666649
chr13:46214628-46220929	chr13	46214628	46220929	6301	46217197
chr13:47221597-47225589	chr13	47221597	47225589	3992	47224189
chr13:47366215-47369053	chr13	47366215	47369053	2838	47368781
chr13:47729415-47733281	chr13	47729415	47733281	3866	47732009
chr13:48336104-48339809	chr13	48336104	48339809	3705	48336273
chr13:48669294-48672606	chr13	48669294	48672606	3312	48671865
chr13:49013626-49019628	chr13	49013626	49019628	6002	49016191
chr13:49153269-49158535	chr13	49153269	49158535	5266	49155106
chr13:49175584-49176345	chr13	49175584	49176345	761	49176278
chr13:50180295-50186330	chr13	50180295	50186330	6035	50182888
chr13:50294300-50298161	chr13	50294300	50298161	3861	50296912
chr13:50471027-50472273	chr13	50471027	50472273	1246	50472232
chr13:50503044-50509173	chr13	50503044	50509173	6129	50505626
chr13:50554376-50555413	chr13	50554376	50555413	1037	50554615
chr13:50831821-50832889	chr13	50831821	50832889	1068	50832072
chr13:51072831-51077119	chr13	51072831	51077119	4288	51075417
chr13:51482263-51486400	chr13	51482263	51486400	4137	51484831
chr13:51509717-51515838	chr13	51509717	51515838	6121	51512292
chr13:51649752-51654549	chr13	51649752	51654549	4797	51651002
chr13:51690196-51696329	chr13	51690196	51696329	6133	51692782
chr13:52269640-52275659	chr13	52269640	52275659	6019	52272228
chr13:52548432-52552151	chr13	52548432	52552151	3719	52548599
chr13:52588917-52591457	chr13	52588917	52591457	2540	52590299
chr13:52715355-52721744	chr13	52715355	52721744	6389	52717930
chr13:53093687-53098324	chr13	53093687	53098324	4637	53096277
chr13:53392056-53393392	chr13	53392056	53393392	1336	53393054
chr13:53596753-53599082	chr13	53596753	53599082	2329	53598043
chr13:54037720-54038963	chr13	54037720	54038963	1243	54038615
chr13:54281375-54287758	chr13	54281375	54287758	6383	54283912
chr13:54714070-54717934	chr13	54714070	54717934	3864	54716645
chr13:55131906-55134879	chr13	55131906	55134879	2973	55134491
chr13:55272543-55278710	chr13	55272543	55278710	6167	55275152
chr13:58182143-58185746	chr13	58182143	58185746	3603	58184729
chr13:58672617-58678643	chr13	58672617	58678643	6026	58675209
chr13:58784866-58791312	chr13	58784866	58791312	6446	58787449
chr13:58981833-58985059	chr13	58981833	58985059	3226	58984422
chr13:59026572-59031172	chr13	59026572	59031172	4600	59029216
chr13:60245895-60252051	chr13	60245895	60252051	6156	60248486
chr13:60657569-60662170	chr13	60657569	60662170	4601	60658386
chr13:60799874-60805993	chr13	60799874	60805993	6119	60802468
chr13:60827201-60833346	chr13	60827201	60833346	6145	60829788
chr13:61624346-61626109	chr13	61624346	61626109	1763	61625565
chr13:63652631-63655885	chr13	63652631	63655885	3254	63655022
chr13:63776436-63782896	chr13	63776436	63782896	6460	63779017
chr13:64114895-64119233	chr13	64114895	64119233	4338	64117474
chr13:64977178-64983485	chr13	64977178	64983485	6307	64979567
chr13:65103913-65109618	chr13	65103913	65109618	5705	65106499
chr13:65219736-65220783	chr13	65219736	65220783	1047	65220359
chr13:65670905-65675955	chr13	65670905	65675955	5050	65672396
chr13:66253762-66259788	chr13	66253762	66259788	6026	66256352
chr13:67680247-67685563	chr13	67680247	67685563	5316	67682837
chr13:68464715-68467701	chr13	68464715	68467701	2986	68467312
chr13:69477866-69483990	chr13	69477866	69483990	6124	69480442
chr13:70288936-70289737	chr13	70288936	70289737	801	70289714
chr13:70325985-70329827	chr13	70325985	70329827	3842	70328545
chr13:71384560-71390704	chr13	71384560	71390704	6144	71387151
chr13:72225768-72228560	chr13	72225768	72228560	2792	72228361
chr13:72265482-72271624	chr13	72265482	72271624	6142	72268067
chr13:72357234-72358662	chr13	72357234	72358662	1428	72358345
chr13:72828275-72832072	chr13	72828275	72832072	3797	72830859
chr13:73452983-73456942	chr13	73452983	73456942	3959	73455570
chr13:73628101-73630754	chr13	73628101	73630754	2653	73630678
chr13:74235944-74241970	chr13	74235944	74241970	6026	74238528
chr13:74488071-74490724	chr13	74488071	74490724	2653	74490675
chr13:74698273-74700878	chr13	74698273	74700878	2605	74700859
chr13:75241169-75247314	chr13	75241169	75247314	6145	75243739
chr13:75708798-75711505	chr13	75708798	75711505	2707	75711387
chr13:75727624-75733777	chr13	75727624	75733777	6153	75730216
chr13:76239701-76242883	chr13	76239701	76242883	3182	76242284
chr13:76545039-76548233	chr13	76545039	76548233	3194	76547659
chr13:76612823-76618851	chr13	76612823	76618851	6028	76615415
chr13:77437833-77443395	chr13	77437833	77443395	5562	77440420
chr13:78513206-78519393	chr13	78513206	78519393	6187	78515795
chr13:78854914-78861052	chr13	78854914	78861052	6138	78857498
chr13:78947834-78951227	chr13	78947834	78951227	3393	78950408
chr13:79012990-79014511	chr13	79012990	79014511	1521	79013672
chr13:79091176-79091957	chr13	79091176	79091957	781	79091653
chr13:79575901-79580196	chr13	79575901	79580196	4295	79578429
chr13:80699214-80704328	chr13	80699214	80704328	5114	80701805
chr13:80982129-80986539	chr13	80982129	80986539	4410	80984717
chr13:81064093-81070238	chr13	81064093	81070238	6145	81066680
chr13:81459610-81465135	chr13	81459610	81465135	5525	81462165
chr13:81627106-81630475	chr13	81627106	81630475	3369	81629666
chr13:81729300-81732993	chr13	81729300	81732993	3693	81731885
chr13:83362369-83365405	chr13	83362369	83365405	3036	83364968
chr13:84474469-84476293	chr13	84474469	84476293	1824	84476257
chr13:85569455-85570969	chr13	85569455	85570969	1514	85569622
chr13:85911792-85917919	chr13	85911792	85917919	6127	85914372
chr13:86645606-86651394	chr13	86645606	86651394	5788	86648195
chr13:86956893-86957324	chr13	86956893	86957324	431	86957218
chr13:87362734-87368857	chr13	87362734	87368857	6123	87365322
chr13:88006495-88008313	chr13	88006495	88008313	1818	88007046
chr13:88191918-88194706	chr13	88191918	88194706	2788	88194493
chr13:88830397-88832740	chr13	88830397	88832740	2343	88831303
chr13:91433201-91438993	chr13	91433201	91438993	5792	91435775
chr13:91603950-91607097	chr13	91603950	91607097	3147	91606543
chr13:91970638-91974128	chr13	91970638	91974128	3490	91971054
chr13:92685561-92691592	chr13	92685561	92691592	6031	92688153
chr13:92890452-92890965	chr13	92890452	92890965	513	92890620
chr13:93490518-93496537	chr13	93490518	93496537	6019	93493110
chr13:93541030-93543650	chr13	93541030	93543650	2620	93543612
chr13:94276468-94280255	chr13	94276468	94280255	3787	94279024
chr13:95734818-95740837	chr13	95734818	95740837	6019	95737409
chr13:96326180-96332208	chr13	96326180	96332208	6028	96328769
chr13:97049182-97055010	chr13	97049182	97055010	5828	97051746
chr13:97155395-97160108	chr13	97155395	97160108	4713	97157983
chr13:97667408-97673440	chr13	97667408	97673440	6032	97670000
chr13:99166607-99169992	chr13	99166607	99169992	3385	99169259
chr13:99786206-99790624	chr13	99786206	99790624	4418	99788789
chr13:100964206-100970337	chr13	100964206	100970337	6131	100966784
chr13:101040939-101044700	chr13	101040939	101044700	3761	101043530
chr13:101310910-101312792	chr13	101310910	101312792	1882	101311948
chr13:101539051-101545199	chr13	101539051	101545199	6148	101541642
chr13:101598431-101601889	chr13	101598431	101601889	3458	101601026
chr13:103746256-103748634	chr13	103746256	103748634	2378	103747711
chr13:103824930-103830476	chr13	103824930	103830476	5546	103826862
chr13:104329890-104333126	chr13	104329890	104333126	3236	104332468
chr13:104340349-104346508	chr13	104340349	104346508	6159	104342941
chr13:104957205-104960972	chr13	104957205	104960972	3767	104959792
chr13:105884455-105890515	chr13	105884455	105890515	6060	105886997
chr13:106778245-106784404	chr13	106778245	106784404	6159	106780834
chr13:106929331-106935363	chr13	106929331	106935363	6032	106931924
chr13:107038447-107041924	chr13	107038447	107041924	3477	107040644
chr13:107920656-107926706	chr13	107920656	107926706	6050	107923261
chr13:108510472-108516495	chr13	108510472	108516495	6023	108513063
chr13:108735115-108741282	chr13	108735115	108741282	6167	108737724
chr13:109012962-109018952	chr13	109012962	109018952	5990	109015550
chr13:109441492-109445948	chr13	109441492	109445948	4456	109444071
chr13:109502308-109508446	chr13	109502308	109508446	6138	109504865
chr13:109823070-109827351	chr13	109823070	109827351	4281	109825660
chr13:110039510-110039796	chr13	110039510	110039796	286	110039699
chr14:18283818-18289864	chr14	18283818	18289864	6046	18286424
chr14:19502935-19505768	chr14	19502935	19505768	2833	19505528
chr14:19620687-19623520	chr14	19620687	19623520	2833	19623280
chr14:19814700-19821399	chr14	19814700	19821399	6699	19817279
chr14:20037141-20041946	chr14	20037141	20041946	4805	20039734
chr14:20127877-20131331	chr14	20127877	20131331	3454	20130474
chr14:20230574-20236301	chr14	20230574	20236301	5727	20232866
chr14:21756441-21759880	chr14	21756441	21759880	3439	21758367
chr14:22256365-22260828	chr14	22256365	22260828	4463	22258948
chr14:22615641-22621763	chr14	22615641	22621763	6122	22618219
chr14:23756719-23762356	chr14	23756719	23762356	5637	23759293
chr14:23918702-23919473	chr14	23918702	23919473	771	23918943
chr14:24447584-24450328	chr14	24447584	24450328	2744	24450138
chr14:24486133-24488900	chr14	24486133	24488900	2767	24488754
chr14:24519330-24521244	chr14	24519330	24521244	1914	24520078
chr14:24617440-24620205	chr14	24617440	24620205	2765	24619990
chr14:24762235-24764569	chr14	24762235	24764569	2334	24764198
chr14:25204224-25206864	chr14	25204224	25206864	2640	25206816
chr14:25337349-25342050	chr14	25337349	25342050	4701	25339916
chr14:25580747-25586334	chr14	25580747	25586334	5587	25582656
chr14:25590521-25594231	chr14	25590521	25594231	3710	25593108
chr14:25771319-25777467	chr14	25771319	25777467	6148	25773906
chr14:25778863-25784872	chr14	25778863	25784872	6009	25781452
chr14:25851934-25858000	chr14	25851934	25858000	6066	25854503
chr14:25960270-25963848	chr14	25960270	25963848	3578	25962850
chr14:26629268-26635299	chr14	26629268	26635299	6031	26631859
chr14:26639822-26646256	chr14	26639822	26646256	6434	26642400
chr14:26673315-26679374	chr14	26673315	26679374	6059	26675906
chr14:27357544-27363655	chr14	27357544	27363655	6111	27360130
chr14:27820132-27821327	chr14	27820132	27821327	1195	27820217
chr14:27966017-27968637	chr14	27966017	27968637	2620	27968620
chr14:28312502-28318523	chr14	28312502	28318523	6021	28315101
chr14:28505750-28508469	chr14	28505750	28508469	2719	28507718
chr14:28636418-28641795	chr14	28636418	28641795	5377	28638254
chr14:29001833-29003248	chr14	29001833	29003248	1415	29002240
chr14:29022832-29029502	chr14	29022832	29029502	6670	29025965
chr14:29133542-29135329	chr14	29133542	29135329	1787	29135063
chr14:29478140-29481510	chr14	29478140	29481510	3370	29480732
chr14:29955378-29961497	chr14	29955378	29961497	6119	29957962
chr14:30404508-30410867	chr14	30404508	30410867	6359	30407064
chr14:30684809-30690837	chr14	30684809	30690837	6028	30687401
chr14:31615303-31621745	chr14	31615303	31621745	6442	31617864
chr14:31634089-31640236	chr14	31634089	31640236	6147	31636678
chr14:31662315-31666228	chr14	31662315	31666228	3913	31664824
chr14:31754697-31757540	chr14	31754697	31757540	2843	31757289
chr14:31793856-31798132	chr14	31793856	31798132	4276	31796321
chr14:31813552-31816949	chr14	31813552	31816949	3397	31816122
chr14:32234597-32240754	chr14	32234597	32240754	6157	32237186
chr14:32851160-32857308	chr14	32851160	32857308	6148	32853748
chr14:33662991-33664038	chr14	33662991	33664038	1047	33663632
chr14:34294476-34296232	chr14	34294476	34296232	1756	34296099
chr14:34738349-34740285	chr14	34738349	34740285	1936	34739793
chr14:35174751-35180242	chr14	35174751	35180242	5491	35177331
chr14:35585578-35587264	chr14	35585578	35587264	1686	35587050
chr14:35837886-35841311	chr14	35837886	35841311	3425	35840457
chr14:36119216-36122174	chr14	36119216	36122174	2958	36121772
chr14:36142656-36148690	chr14	36142656	36148690	6034	36145248
chr14:36156444-36162691	chr14	36156444	36162691	6247	36158841
chr14:36693920-36700082	chr14	36693920	36700082	6162	36696496
chr14:36892550-36898683	chr14	36892550	36898683	6133	36895128
chr14:37350918-37356933	chr14	37350918	37356933	6015	37353494
chr14:37357839-37361610	chr14	37357839	37361610	3771	37360407
chr14:37754730-37757270	chr14	37754730	37757270	2540	37756937
chr14:37766796-37772831	chr14	37766796	37772831	6035	37769390
chr14:37780642-37786767	chr14	37780642	37786767	6125	37783217
chr14:37950310-37956459	chr14	37950310	37956459	6149	37952900
chr14:38263372-38269414	chr14	38263372	38269414	6042	38265523
chr14:38500899-38502373	chr14	38500899	38502373	1474	38500912
chr14:38975192-38981648	chr14	38975192	38981648	6456	38977777
chr14:39327562-39332634	chr14	39327562	39332634	5072	39330057
chr14:39353576-39359700	chr14	39353576	39359700	6124	39356141
chr14:39521539-39527458	chr14	39521539	39527458	5919	39524144
chr14:39584278-39590291	chr14	39584278	39590291	6013	39586851
chr14:39594141-39595265	chr14	39594141	39595265	1124	39594366
chr14:39633541-39639676	chr14	39633541	39639676	6135	39636118
chr14:39697592-39703740	chr14	39697592	39703740	6148	39700176
chr14:39820033-39826163	chr14	39820033	39826163	6130	39822616
chr14:39921510-39925131	chr14	39921510	39925131	3621	39924098
chr14:40080493-40081758	chr14	40080493	40081758	1265	40080520
chr14:40141407-40143301	chr14	40141407	40143301	1894	40142153
chr14:40377048-40380230	chr14	40377048	40380230	3182	40379142
chr14:40608123-40611203	chr14	40608123	40611203	3080	40609253
chr14:40948916-40954934	chr14	40948916	40954934	6018	40951497
chr14:41209338-41215358	chr14	41209338	41215358	6020	41211926
chr14:41324374-41330497	chr14	41324374	41330497	6123	41326951
chr14:41335035-41337868	chr14	41335035	41337868	2833	41337613
chr14:41751766-41757899	chr14	41751766	41757899	6133	41754352
chr14:41906322-41908987	chr14	41906322	41908987	2665	41908909
chr14:41963463-41968941	chr14	41963463	41968941	5478	41965406
chr14:42166027-42170980	chr14	42166027	42170980	4953	42168630
chr14:42204907-42207675	chr14	42204907	42207675	2768	42207490
chr14:42255263-42256006	chr14	42255263	42256006	743	42255665
chr14:42967511-42973555	chr14	42967511	42973555	6044	42970100
chr14:43091318-43092621	chr14	43091318	43092621	1303	43091689
chr14:43342737-43343746	chr14	43342737	43343746	1009	43343047
chr14:44471197-44476690	chr14	44471197	44476690	5493	44473764
chr14:44510599-44514006	chr14	44510599	44514006	3407	44512773
chr14:44551550-44557802	chr14	44551550	44557802	6252	44554139
chr14:44641758-44645313	chr14	44641758	44645313	3555	44644350
chr14:44705080-44711104	chr14	44705080	44711104	6024	44707671
chr14:45320242-45326375	chr14	45320242	45326375	6133	45322829
chr14:45349187-45351992	chr14	45349187	45351992	2805	45351776
chr14:45430445-45433939	chr14	45430445	45433939	3494	45432532
chr14:45477110-45483169	chr14	45477110	45483169	6059	45479728
chr14:45483171-45486745	chr14	45483171	45486745	3574	45483230
chr14:45545716-45551885	chr14	45545716	45551885	6169	45548317
chr14:45749987-45754331	chr14	45749987	45754331	4344	45752612
chr14:45883227-45889258	chr14	45883227	45889258	6031	45885818
chr14:46095420-46101548	chr14	46095420	46101548	6128	46097976
chr14:46161140-46167282	chr14	46161140	46167282	6142	46163727
chr14:46178988-46181120	chr14	46178988	46181120	2132	46180089
chr14:46529095-46531951	chr14	46529095	46531951	2856	46531661
chr14:48279899-48285853	chr14	48279899	48285853	5954	48282296
chr14:48366263-48372404	chr14	48366263	48372404	6141	48368842
chr14:48409481-48412368	chr14	48409481	48412368	2887	48412057
chr14:48570230-48576385	chr14	48570230	48576385	6155	48572817
chr14:49125870-49132253	chr14	49125870	49132253	6383	49128445
chr14:49143957-49150141	chr14	49143957	49150141	6184	49146567
chr14:49348585-49354271	chr14	49348585	49354271	5686	49351164
chr14:51213627-51216574	chr14	51213627	51216574	2947	51216198
chr14:51413173-51419310	chr14	51413173	51419310	6137	51415741
chr14:51794601-51800632	chr14	51794601	51800632	6031	51797193
chr14:52590834-52596957	chr14	52590834	52596957	6123	52593418
chr14:53266406-53271579	chr14	53266406	53271579	5173	53268997
chr14:53298399-53303491	chr14	53298399	53303491	5092	53300976
chr14:53909093-53910336	chr14	53909093	53910336	1243	53909114
chr14:54027690-54033829	chr14	54027690	54033829	6139	54030274
chr14:54402376-54404576	chr14	54402376	54404576	2200	54404124
chr14:55495234-55496728	chr14	55495234	55496728	1494	55496175
chr14:55988182-55993244	chr14	55988182	55993244	5062	55990774
chr14:56014010-56020042	chr14	56014010	56020042	6032	56016602
chr14:56359625-56364831	chr14	56359625	56364831	5206	56362177
chr14:56441818-56447831	chr14	56441818	56447831	6013	56444411
chr14:57338082-57344117	chr14	57338082	57344117	6035	57340676
chr14:57513490-57519696	chr14	57513490	57519696	6206	57516147
chr14:57538828-57542096	chr14	57538828	57542096	3268	57541385
chr14:57643619-57647418	chr14	57643619	57647418	3799	57646211
chr14:57667337-57670727	chr14	57667337	57670727	3390	57669918
chr14:59232626-59235835	chr14	59232626	59235835	3209	59235231
chr14:59400837-59403749	chr14	59400837	59403749	2912	59402314
chr14:59946504-59952523	chr14	59946504	59952523	6019	59949097
chr14:59952650-59959073	chr14	59952650	59959073	6423	59955231
chr14:60036770-60042877	chr14	60036770	60042877	6107	60039351
chr14:60405183-60408577	chr14	60405183	60408577	3394	60407029
chr14:60421180-60425193	chr14	60421180	60425193	4013	60423766
chr14:60472399-60475349	chr14	60472399	60475349	2950	60474989
chr14:60523259-60529424	chr14	60523259	60529424	6165	60525839
chr14:60831208-60834923	chr14	60831208	60834923	3715	60833763
chr14:60908324-60914469	chr14	60908324	60914469	6145	60910912
chr14:60936233-60940365	chr14	60936233	60940365	4132	60938820
chr14:61009388-61015470	chr14	61009388	61015470	6082	61011971
chr14:61055085-61061148	chr14	61055085	61061148	6063	61057708
chr14:61092271-61098394	chr14	61092271	61098394	6123	61094852
chr14:62045454-62051619	chr14	62045454	62051619	6165	62048064
chr14:62199101-62205252	chr14	62199101	62205252	6151	62201711
chr14:62325798-62327563	chr14	62325798	62327563	1765	62326707
chr14:63106378-63109410	chr14	63106378	63109410	3032	63108939
chr14:63116706-63122735	chr14	63116706	63122735	6029	63119298
chr14:63139012-63145117	chr14	63139012	63145117	6105	63141572
chr14:65522585-65528687	chr14	65522585	65528687	6102	65525151
chr14:65854867-65860286	chr14	65854867	65860286	5419	65857451
chr14:66026445-66032615	chr14	66026445	66032615	6170	66029024
chr14:66183736-66189867	chr14	66183736	66189867	6131	66186320
chr14:66524505-66530921	chr14	66524505	66530921	6416	66527063
chr14:66558739-66561435	chr14	66558739	66561435	2696	66561329
chr14:66582407-66586754	chr14	66582407	66586754	4347	66584976
chr14:66834413-66835428	chr14	66834413	66835428	1015	66834843
chr14:67062673-67068092	chr14	67062673	67068092	5419	67064521
chr14:67273117-67276112	chr14	67273117	67276112	2995	67275709
chr14:68090674-68093781	chr14	68090674	68093781	3107	68093288
chr14:68428765-68434891	chr14	68428765	68434891	6126	68431339
chr14:69415930-69422143	chr14	69415930	69422143	6213	69418565
chr14:70193994-70198299	chr14	70193994	70198299	4305	70196575
chr14:70241140-70243955	chr14	70241140	70243955	2815	70243710
chr14:70307313-70311196	chr14	70307313	70311196	3883	70307649
chr14:70429146-70431964	chr14	70429146	70431964	2818	70431730
chr14:70936130-70942258	chr14	70936130	70942258	6128	70938717
chr14:71677985-71678870	chr14	71677985	71678870	885	71678727
chr14:71842964-71848996	chr14	71842964	71848996	6032	71845555
chr14:71872645-71876473	chr14	71872645	71876473	3828	71875232
chr14:71976262-71982313	chr14	71976262	71982313	6051	71978851
chr14:72395537-72399800	chr14	72395537	72399800	4263	72398139
chr14:72409566-72415687	chr14	72409566	72415687	6121	72412155
chr14:74726605-74730113	chr14	74726605	74730113	3508	74729190
chr14:75920272-75924289	chr14	75920272	75924289	4017	75922817
chr14:78536608-78542824	chr14	78536608	78542824	6216	78539202
chr14:79126178-79132202	chr14	79126178	79132202	6024	79128765
chr14:79308933-79314061	chr14	79308933	79314061	5128	79311522
chr14:79751001-79752297	chr14	79751001	79752297	1296	79752160
chr14:79933796-79935618	chr14	79933796	79935618	1822	79934875
chr14:80245685-80251047	chr14	80245685	80251047	5362	80248271
chr14:80649740-80652049	chr14	80649740	80652049	2309	80651006
chr14:81355715-81356963	chr14	81355715	81356963	1248	81356596
chr14:82317918-82322455	chr14	82317918	82322455	4537	82318669
chr14:83201888-83204719	chr14	83201888	83204719	2831	83204480
chr14:84115045-84118119	chr14	84115045	84118119	3074	84117626
chr14:85018407-85024479	chr14	85018407	85024479	6072	85020963
chr14:85901922-85908434	chr14	85901922	85908434	6512	85904504
chr14:86042352-86048766	chr14	86042352	86048766	6414	86044918
chr14:86074489-86080517	chr14	86074489	86080517	6028	86077081
chr14:86095934-86102041	chr14	86095934	86102041	6107	86098526
chr14:86105459-86111494	chr14	86105459	86111494	6035	86108055
chr14:86198683-86201737	chr14	86198683	86201737	3054	86200230
chr14:86263232-86266564	chr14	86263232	86266564	3332	86263931
chr14:86608455-86611907	chr14	86608455	86611907	3452	86611066
chr14:86745042-86751140	chr14	86745042	86751140	6098	86747617
chr14:86809877-86813732	chr14	86809877	86813732	3855	86812371
chr14:87354740-87360855	chr14	87354740	87360855	6115	87357328
chr14:87413553-87419701	chr14	87413553	87419701	6148	87416133
chr14:87775466-87781576	chr14	87775466	87781576	6110	87778046
chr14:88122213-88128346	chr14	88122213	88128346	6133	88124793
chr14:88443481-88448908	chr14	88443481	88448908	5427	88446074
chr14:88652868-88655069	chr14	88652868	88655069	2201	88653881
chr14:90206773-90212804	chr14	90206773	90212804	6031	90209365
chr14:91430864-91436893	chr14	91430864	91436893	6029	91433454
chr14:91640244-91646233	chr14	91640244	91646233	5989	91642797
chr14:92227432-92233568	chr14	92227432	92233568	6136	92230024
chr14:93413032-93419170	chr14	93413032	93419170	6138	93415608
chr14:94146696-94151476	chr14	94146696	94151476	4780	94149244
chr14:96430487-96432702	chr14	96430487	96432702	2215	96430861
chr14:96764634-96767623	chr14	96764634	96767623	2989	96767226
chr14:98002199-98003171	chr14	98002199	98003171	972	98002712
chr14:101744246-101750388	chr14	101744246	101750388	6142	101746811
chr14:104412045-104416226	chr14	104412045	104416226	4181	104414608
chr14:104836942-104839690	chr14	104836942	104839690	2748	104839535
chr14:105956123-105962267	chr14	105956123	105962267	6144	105958707
chr14:106077108-106078358	chr14	106077108	106078358	1250	106077832
chr14:106158508-106161412	chr14	106158508	106161412	2904	106161063
chr14:106855883-106859279	chr14	106855883	106859279	3396	106858451
chr14_GL000009v2_random:133166-138356	chr14_GL000009v2_random	133166	138356	5190	135737
chr14_GL000009v2_random:177835-183972	chr14_GL000009v2_random	177835	183972	6137	180422
chr14_GL000194v1_random:123407-128598	chr14_GL000194v1_random	123407	128598	5191	125978
chr14_GL000194v1_random:168440-174573	chr14_GL000194v1_random	168440	174573	6133	171026
chr14_KI270722v1_random:76399-82541	chr14_KI270722v1_random	76399	82541	6142	78977
chr14_KI270722v1_random:122746-123828	chr14_KI270722v1_random	122746	123828	1082	123391
chr14_KI270725v1_random:48457-54487	chr14_KI270725v1_random	48457	54487	6030	51049
chr14_KI270726v1_random:33685-36751	chr14_KI270726v1_random	33685	36751	3066	36269
chr14_KI270844v1_alt:108039-114028	chr14_KI270844v1_alt	108039	114028	5989	110592
chr14_KI270846v1_alt:423892-430036	chr14_KI270846v1_alt	423892	430036	6144	426476
chr14_KI270846v1_alt:544877-546127	chr14_KI270846v1_alt	544877	546127	1250	545601
chr14_KI270846v1_alt:626277-629181	chr14_KI270846v1_alt	626277	629181	2904	628832
chr14_KI270846v1_alt:1347057-1350453	chr14_KI270846v1_alt	1347057	1350453	3396	1349625
chr14_KI270847v1_alt:527594-533732	chr14_KI270847v1_alt	527594	533732	6138	530170
chr14_KI270847v1_alt:1261258-1266038	chr14_KI270847v1_alt	1261258	1266038	4780	1263806
chr15:17070308-17071364	chr15	17070308	17071364	1056	17070734
chr15:20031931-20038080	chr15	20031931	20038080	6149	20034519
chr15:20194931-20200391	chr15	20194931	20200391	5460	20197489
chr15:20411496-20416998	chr15	20411496	20416998	5502	20414077
chr15:21038585-21044731	chr15	21038585	21044731	6146	21041173
chr15:21588371-21591335	chr15	21588371	21591335	2964	21590947
chr15:21628310-21631789	chr15	21628310	21631789	3479	21630927
chr15:21671492-21676965	chr15	21671492	21676965	5473	21673081
chr15:22023691-22026654	chr15	22023691	22026654	2963	22026266
chr15:22070897-22074376	chr15	22070897	22074376	3479	22073514
chr15:22112980-22119428	chr15	22112980	22119428	6448	22115549
chr15:22365148-22371538	chr15	22365148	22371538	6390	22367737
chr15:24154846-24157307	chr15	24154846	24157307	2461	24154873
chr15:24633926-24640029	chr15	24633926	24640029	6103	24636519
chr15:24705786-24709312	chr15	24705786	24709312	3526	24707549
chr15:26150896-26155895	chr15	26150896	26155895	4999	26152603
chr15:27187726-27193872	chr15	27187726	27193872	6146	27190314
chr15:27197654-27198063	chr15	27197654	27198063	409	27197696
chr15:27878847-27882206	chr15	27878847	27882206	3359	27881451
chr15:30019142-30019710	chr15	30019142	30019710	568	30019422
chr15:30240360-30246398	chr15	30240360	30246398	6038	30242954
chr15:30341196-30347357	chr15	30341196	30347357	6161	30343779
chr15:30848621-30854753	chr15	30848621	30854753	6132	30851193
chr15:31617776-31623903	chr15	31617776	31623903	6127	31620355
chr15:31627090-31633272	chr15	31627090	31633272	6182	31629681
chr15:32045683-32051786	chr15	32045683	32051786	6103	32048258
chr15:34286996-34293148	chr15	34286996	34293148	6152	34289567
chr15:35334386-35337369	chr15	35334386	35337369	2983	35337034
chr15:35385846-35391984	chr15	35385846	35391984	6138	35388430
chr15:36683151-36685510	chr15	36683151	36685510	2359	36684667
chr15:37303282-37309430	chr15	37303282	37309430	6148	37305863
chr15:37312640-37315342	chr15	37312640	37315342	2702	37315205
chr15:37399471-37405476	chr15	37399471	37405476	6005	37402053
chr15:38136665-38142840	chr15	38136665	38142840	6175	38139284
chr15:38567626-38574032	chr15	38567626	38574032	6406	38570200
chr15:38773619-38779712	chr15	38773619	38779712	6093	38776180
chr15:38797495-38803927	chr15	38797495	38803927	6432	38800056
chr15:38831583-38834185	chr15	38831583	38834185	2602	38834144
chr15:38834949-38841092	chr15	38834949	38841092	6143	38837525
chr15:42246295-42252380	chr15	42246295	42252380	6085	42248872
chr15:44456149-44456853	chr15	44456149	44456853	704	44456329
chr15:45016278-45021223	chr15	45016278	45021223	4945	45017594
chr15:45752524-45756731	chr15	45752524	45756731	4207	45755100
chr15:46332957-46333791	chr15	46332957	46333791	834	46333608
chr15:46361727-46364723	chr15	46361727	46364723	2996	46364316
chr15:46376018-46379278	chr15	46376018	46379278	3260	46378597
chr15:46536240-46542382	chr15	46536240	46542382	6142	46538832
chr15:46990783-46997253	chr15	46990783	46997253	6470	46993351
chr15:47277629-47281662	chr15	47277629	47281662	4033	47280115
chr15:47892114-47892665	chr15	47892114	47892665	551	47892229
chr15:49259578-49265724	chr15	49259578	49265724	6146	49262156
chr15:49778509-49784518	chr15	49778509	49784518	6009	49781086
chr15:49833219-49839367	chr15	49833219	49839367	6148	49835811
chr15:50984305-50987726	chr15	50984305	50987726	3421	50986896
chr15:51031621-51037649	chr15	51031621	51037649	6028	51034213
chr15:51417216-51423246	chr15	51417216	51423246	6030	51419807
chr15:52472398-52478553	chr15	52472398	52478553	6155	52474975
chr15:53135442-53141475	chr15	53135442	53141475	6033	53138034
chr15:53854418-53857022	chr15	53854418	53857022	2604	53855879
chr15:53890439-53894296	chr15	53890439	53894296	3857	53890452
chr15:54444822-54450917	chr15	54444822	54450917	6095	54447360
chr15:54475324-54479033	chr15	54475324	54479033	3709	54477897
chr15:54926081-54932099	chr15	54926081	54932099	6018	54928660
chr15:56134618-56140628	chr15	56134618	56140628	6010	56137203
chr15:56266327-56269640	chr15	56266327	56269640	3313	56268913
chr15:56311143-56317177	chr15	56311143	56317177	6034	56313737
chr15:56509531-56513603	chr15	56509531	56513603	4072	56512114
chr15:57899250-57902224	chr15	57899250	57902224	2974	57901833
chr15:57927940-57930530	chr15	57927940	57930530	2590	57930513
chr15:59125551-59131397	chr15	59125551	59131397	5846	59128128
chr15:59465694-59470741	chr15	59465694	59470741	5047	59468296
chr15:59781126-59782708	chr15	59781126	59782708	1582	59781257
chr15:62001518-62005683	chr15	62001518	62005683	4165	62004108
chr15:62016279-62019834	chr15	62016279	62019834	3555	62018875
chr15:63617009-63622042	chr15	63617009	63622042	5033	63619584
chr15:63957356-63963466	chr15	63957356	63963466	6110	63959942
chr15:67448229-67454359	chr15	67448229	67454359	6130	67450811
chr15:69617030-69623160	chr15	69617030	69623160	6130	69619613
chr15:70967987-70973741	chr15	70967987	70973741	5754	70970572
chr15:70984634-70990781	chr15	70984634	70990781	6147	70987223
chr15:71026585-71032440	chr15	71026585	71032440	5855	71028533
chr15:71367292-71372997	chr15	71367292	71372997	5705	71369868
chr15:71670512-71673779	chr15	71670512	71673779	3267	71673076
chr15:71793022-71798556	chr15	71793022	71798556	5534	71795615
chr15:72428357-72432032	chr15	72428357	72432032	3675	72430946
chr15:73215934-73222082	chr15	73215934	73222082	6148	73218514
chr15:73508419-73514470	chr15	73508419	73514470	6051	73511031
chr15:75083782-75086941	chr15	75083782	75086941	3159	75084465
chr15:75909775-75913129	chr15	75909775	75913129	3354	75912357
chr15:75971802-75977771	chr15	75971802	75977771	5969	75973955
chr15:76093115-76099535	chr15	76093115	76099535	6420	76095702
chr15:76420624-76426457	chr15	76420624	76426457	5833	76423207
chr15:76603011-76609170	chr15	76603011	76609170	6159	76605611
chr15:76719926-76725078	chr15	76719926	76725078	5152	76722515
chr15:77150514-77156644	chr15	77150514	77156644	6130	77153077
chr15:78375963-78382101	chr15	78375963	78382101	6138	78378552
chr15:79485783-79491818	chr15	79485783	79491818	6035	79488376
chr15:79745087-79751113	chr15	79745087	79751113	6026	79747678
chr15:81122791-81124879	chr15	81122791	81124879	2088	81124600
chr15:81668513-81674504	chr15	81668513	81674504	5991	81671070
chr15:82882881-82888919	chr15	82882881	82888919	6038	82885481
chr15:83450804-83456834	chr15	83450804	83456834	6030	83453395
chr15:83826523-83830021	chr15	83826523	83830021	3498	83829114
chr15:84264101-84269545	chr15	84264101	84269545	5444	84266690
chr15:84378155-84383599	chr15	84378155	84383599	5444	84380744
chr15:85051829-85057487	chr15	85051829	85057487	5658	85054407
chr15:85969814-85972684	chr15	85969814	85972684	2870	85972390
chr15:86205831-86211977	chr15	86205831	86211977	6146	86208408
chr15:86560144-86566267	chr15	86560144	86566267	6123	86562731
chr15:87001307-87006816	chr15	87001307	87006816	5509	87003565
chr15:87229793-87235895	chr15	87229793	87235895	6102	87232357
chr15:87249763-87255874	chr15	87249763	87255874	6111	87252334
chr15:87275324-87281469	chr15	87275324	87281469	6145	87277906
chr15:87327389-87333416	chr15	87327389	87333416	6027	87329986
chr15:88554598-88560263	chr15	88554598	88560263	5665	88556828
chr15:89043903-89049907	chr15	89043903	89049907	6004	89046485
chr15:89534526-89536153	chr15	89534526	89536153	1627	89534954
chr15:91175888-91181484	chr15	91175888	91181484	5596	91178480
chr15:91579507-91583697	chr15	91579507	91583697	4190	91582090
chr15:92136972-92140869	chr15	92136972	92140869	3897	92139564
chr15:93389977-93396093	chr15	93389977	93396093	6116	93392549
chr15:93627087-93631131	chr15	93627087	93631131	4044	93629703
chr15:93728857-93730774	chr15	93728857	93730774	1917	93730486
chr15:93753862-93755096	chr15	93753862	93755096	1234	93754767
chr15:94147966-94152599	chr15	94147966	94152599	4633	94150550
chr15:94208283-94211647	chr15	94208283	94211647	3364	94210870
chr15:97265580-97271604	chr15	97265580	97271604	6024	97268167
chr15:97289925-97296313	chr15	97289925	97296313	6388	97292747
chr15:97372487-97377657	chr15	97372487	97377657	5170	97375074
chr15:97413295-97419473	chr15	97413295	97419473	6178	97415894
chr15:97580936-97582679	chr15	97580936	97582679	1743	97581704
chr15:99376548-99382379	chr15	99376548	99382379	5831	99379125
chr15:99417390-99421122	chr15	99417390	99421122	3732	99419990
chr15:99827961-99833481	chr15	99827961	99833481	5520	99830540
chr15:101880277-101886693	chr15	101880277	101886693	6416	101882818
chr15:101915434-101917234	chr15	101915434	101917234	1800	101916981
chr15_KI270727v1_random:315463-318426	chr15_KI270727v1_random	315463	318426	2963	318038
chr15_KI270727v1_random:362710-366161	chr15_KI270727v1_random	362710	366161	3451	365299
chr15_KI270727v1_random:405737-411205	chr15_KI270727v1_random	405737	411205	5468	407326
chr15_KI270851v1_alt:9639-16029	chr15_KI270851v1_alt	9639	16029	6390	12228
chr15_KI270852v1_alt:346214-349177	chr15_KI270852v1_alt	346214	349177	2963	348789
chr15_KI270852v1_alt:393461-396912	chr15_KI270852v1_alt	393461	396912	3451	396050
chr15_KI270852v1_alt:436488-441956	chr15_KI270852v1_alt	436488	441956	5468	438077
chr15_KI270905v1_alt:13136-16480	chr15_KI270905v1_alt	13136	16480	3344	15738
chr15_KI270905v1_alt:2304339-2304907	chr15_KI270905v1_alt	2304339	2304907	568	2304619
chr15_KI270905v1_alt:2525314-2531352	chr15_KI270905v1_alt	2525314	2531352	6038	2527908
chr15_KI270905v1_alt:2626119-2632277	chr15_KI270905v1_alt	2626119	2632277	6158	2628702
chr15_KI270905v1_alt:3134355-3140487	chr15_KI270905v1_alt	3134355	3140487	6132	3136927
chr15_KI270905v1_alt:3902927-3909054	chr15_KI270905v1_alt	3902927	3909054	6127	3905506
chr15_KI270905v1_alt:3912242-3918424	chr15_KI270905v1_alt	3912242	3918424	6182	3914833
chr15_KI270905v1_alt:4330817-4336920	chr15_KI270905v1_alt	4330817	4336920	6103	4333392
chr16:5744952-5750998	chr16	5744952	5750998	6046	5747472
chr16:9584490-9590522	chr16	9584490	9590522	6032	9587082
chr16:9684403-9687100	chr16	9684403	9687100	2697	9686993
chr16:9728851-9731501	chr16	9728851	9731501	2650	9731435
chr16:10286720-10292852	chr16	10286720	10292852	6132	10289312
chr16:10447870-10451776	chr16	10447870	10451776	3906	10449396
chr16:12070183-12076303	chr16	12070183	12076303	6120	12072756
chr16:13086850-13092955	chr16	13086850	13092955	6105	13089389
chr16:14993145-14996001	chr16	14993145	14996001	2856	14995729
chr16:16685935-16689027	chr16	16685935	16689027	3092	16688512
chr16:16745040-16751182	chr16	16745040	16751182	6142	16747629
chr16:16769013-16774844	chr16	16769013	16774844	5831	16771583
chr16:16840517-16846556	chr16	16840517	16846556	6039	16843128
chr16:16946700-16950922	chr16	16946700	16950922	4222	16949242
chr16:17004247-17009791	chr16	17004247	17009791	5544	17006825
chr16:18821266-18827058	chr16	18821266	18827058	5792	18823845
chr16:20755652-20759034	chr16	20755652	20759034	3382	20758222
chr16:21042672-21048703	chr16	21042672	21048703	6031	21045262
chr16:21329036-21335176	chr16	21329036	21335176	6140	21331611
chr16:25601183-25604489	chr16	25601183	25604489	3306	25603739
chr16:26408520-26411335	chr16	26408520	26411335	2815	26411101
chr16:31278737-31284853	chr16	31278737	31284853	6116	31281307
chr16:31307019-31310933	chr16	31307019	31310933	3914	31308236
chr16:31629877-31636018	chr16	31629877	31636018	6141	31632454
chr16:31742173-31746983	chr16	31742173	31746983	4810	31744711
chr16:31812805-31813573	chr16	31812805	31813573	768	31813511
chr16:31900801-31906925	chr16	31900801	31906925	6124	31903376
chr16:32368137-32370380	chr16	32368137	32370380	2243	32368447
chr16:32411794-32417937	chr16	32411794	32417937	6143	32414376
chr16:32837589-32842830	chr16	32837589	32842830	5241	32839269
chr16:33831874-33835175	chr16	33831874	33835175	3301	33834459
chr16:33943219-33946139	chr16	33943219	33946139	2920	33945792
chr16:33952564-33958612	chr16	33952564	33958612	6048	33955169
chr16:34124316-34128054	chr16	34124316	34128054	3738	34126907
chr16:34214324-34218873	chr16	34214324	34218873	4549	34215425
chr16:34508699-34509773	chr16	34508699	34509773	1074	34509469
chr16:35225426-35231769	chr16	35225426	35231769	6343	35228335
chr16:35534414-35537679	chr16	35534414	35537679	3265	35535251
chr16:35608475-35614501	chr16	35608475	35614501	6026	35611067
chr16:35697819-35698414	chr16	35697819	35698414	595	35698003
chr16:35715796-35721963	chr16	35715796	35721963	6167	35718370
chr16:35827736-35832820	chr16	35827736	35832820	5084	35830324
chr16:35952390-35955554	chr16	35952390	35955554	3164	35954972
chr16:36091922-36098058	chr16	36091922	36098058	6136	36094510
chr16:46449411-46455427	chr16	46449411	46455427	6016	46452000
chr16:47221246-47222405	chr16	47221246	47222405	1159	47221671
chr16:47422388-47422828	chr16	47422388	47422828	440	47422579
chr16:47541007-47547243	chr16	47541007	47547243	6236	47543588
chr16:47550712-47552532	chr16	47550712	47552532	1820	47550804
chr16:47555729-47557030	chr16	47555729	47557030	1301	47556857
chr16:47677770-47683912	chr16	47677770	47683912	6142	47680357
chr16:47770942-47772996	chr16	47770942	47772996	2054	47771757
chr16:47807975-47814106	chr16	47807975	47814106	6131	47810558
chr16:48015465-48021489	chr16	48015465	48021489	6024	48018053
chr16:48662355-48666297	chr16	48662355	48666297	3942	48664922
chr16:48768571-48774603	chr16	48768571	48774603	6032	48771164
chr16:49134096-49136751	chr16	49134096	49136751	2655	49136683
chr16:51248905-51255051	chr16	51248905	51255051	6146	51251496
chr16:52007592-52013761	chr16	52007592	52013761	6169	52010187
chr16:52156597-52159601	chr16	52156597	52159601	3004	52158366
chr16:52195283-52198215	chr16	52195283	52198215	2932	52197866
chr16:53330553-53333435	chr16	53330553	53333435	2882	53333102
chr16:53344431-53350517	chr16	53344431	53350517	6086	53347005
chr16:54260547-54264550	chr16	54260547	54264550	4003	54263139
chr16:55311820-55314642	chr16	55311820	55314642	2822	55314415
chr16:58779887-58785996	chr16	58779887	58785996	6109	58782468
chr16:58914377-58918342	chr16	58914377	58918342	3965	58916960
chr16:58977510-58983531	chr16	58977510	58983531	6021	58980095
chr16:59559294-59565319	chr16	59559294	59565319	6025	59561882
chr16:59830705-59836849	chr16	59830705	59836849	6144	59833307
chr16:60195371-60198248	chr16	60195371	60198248	2877	60197990
chr16:60454461-60456752	chr16	60454461	60456752	2291	60456614
chr16:60705321-60708289	chr16	60705321	60708289	2968	60707922
chr16:60828032-60830103	chr16	60828032	60830103	2071	60828601
chr16:61153898-61156885	chr16	61153898	61156885	2987	61156479
chr16:62992368-62998492	chr16	62992368	62998492	6124	62994938
chr16:65236909-65240075	chr16	65236909	65240075	3166	65239500
chr16:68107729-68110000	chr16	68107729	68110000	2271	68109662
chr16:68583448-68589505	chr16	68583448	68589505	6057	68586066
chr16:69246167-69246819	chr16	69246167	69246819	652	69246649
chr16:70843043-70847154	chr16	70843043	70847154	4111	70845629
chr16:70946865-70947648	chr16	70946865	70947648	783	70947628
chr16:71304470-71308029	chr16	71304470	71308029	3559	71307064
chr16:72525310-72529198	chr16	72525310	72529198	3888	72527883
chr16:73824400-73830431	chr16	73824400	73830431	6031	73826991
chr16:75734831-75740950	chr16	75734831	75740950	6119	75737422
chr16:75821959-75827981	chr16	75821959	75827981	6022	75824547
chr16:76086766-76091171	chr16	76086766	76091171	4405	76089328
chr16:76249293-76255469	chr16	76249293	76255469	6176	76251872
chr16:76692265-76694050	chr16	76692265	76694050	1785	76693499
chr16:77263774-77270191	chr16	77263774	77270191	6417	77266333
chr16:80086062-80091657	chr16	80086062	80091657	5595	80088658
chr16:80136317-80142458	chr16	80136317	80142458	6141	80138906
chr16:82203770-82209885	chr16	82203770	82209885	6115	82206361
chr16:82303424-82309864	chr16	82303424	82309864	6440	82306004
chr16:83865624-83867840	chr16	83865624	83867840	2216	83866330
chr16:84455765-84456371	chr16	84455765	84456371	606	84456216
chr16:85874285-85876475	chr16	85874285	85876475	2190	85875166
chr16_KI270728v1_random:145424-147391	chr16_KI270728v1_random	145424	147391	1967	146882
chr16_KI270728v1_random:1099698-1104943	chr16_KI270728v1_random	1099698	1104943	5245	1101382
chr16_KI270728v1_random:1681832-1683799	chr16_KI270728v1_random	1681832	1683799	1967	1683290
chr16_KI270853v1_alt:832500-835356	chr16_KI270853v1_alt	832500	835356	2856	835084
chr16_KI270853v1_alt:2346859-2349951	chr16_KI270853v1_alt	2346859	2349951	3092	2349436
chr16_KI270853v1_alt:2405976-2412118	chr16_KI270853v1_alt	2405976	2412118	6142	2408565
chr16_KI270853v1_alt:2429947-2435778	chr16_KI270853v1_alt	2429947	2435778	5831	2432517
chr16_KI270853v1_alt:2501426-2507460	chr16_KI270853v1_alt	2501426	2507460	6034	2504032
chr16_KI270853v1_alt:2607661-2611883	chr16_KI270853v1_alt	2607661	2611883	4222	2610203
chr17:589718-592965	chr17	589718	592965	3247	590966
chr17:634396-640538	chr17	634396	640538	6142	637005
chr17:3147366-3153409	chr17	3147366	3153409	6043	3149958
chr17:3273321-3274296	chr17	3273321	3274296	975	3274118
chr17:3319372-3324852	chr17	3319372	3324852	5480	3321968
chr17:3326554-3332726	chr17	3326554	3332726	6172	3329299
chr17:3359691-3362697	chr17	3359691	3362697	3006	3362004
chr17:6802481-6808614	chr17	6802481	6808614	6133	6805051
chr17:6883373-6886493	chr17	6883373	6886493	3120	6885974
chr17:11861025-11867172	chr17	11861025	11867172	6147	11863609
chr17:12449903-12455932	chr17	12449903	12455932	6029	12452494
chr17:14530121-14534501	chr17	14530121	14534501	4380	14532708
chr17:15795293-15798529	chr17	15795293	15798529	3236	15797898
chr17:20597951-20601189	chr17	20597951	20601189	3238	20600558
chr17:22496954-22503062	chr17	22496954	22503062	6108	22499541
chr17:22552887-22554310	chr17	22552887	22554310	1423	22553920
chr17:22646444-22649602	chr17	22646444	22649602	3158	22649031
chr17:22727196-22729822	chr17	22727196	22729822	2626	22729773
chr17:27039669-27045623	chr17	27039669	27045623	5954	27042252
chr17:27099164-27105176	chr17	27099164	27105176	6012	27101744
chr17:27128492-27131187	chr17	27128492	27131187	2695	27131066
chr17:27183028-27189080	chr17	27183028	27189080	6052	27185618
chr17:30012781-30015484	chr17	30012781	30015484	2703	30013390
chr17:30406814-30413023	chr17	30406814	30413023	6209	30409446
chr17:30439408-30442125	chr17	30439408	30442125	2717	30441999
chr17:31664913-31671035	chr17	31664913	31671035	6122	31667504
chr17:32640940-32646131	chr17	32640940	32646131	5191	32643511
chr17:32678257-32684272	chr17	32678257	32684272	6015	32680839
chr17:34083021-34089185	chr17	34083021	34089185	6164	34085626
chr17:34209750-34215965	chr17	34209750	34215965	6215	34212329
chr17:34292450-34298452	chr17	34292450	34298452	6002	34295042
chr17:34334414-34337214	chr17	34334414	34337214	2800	34337012
chr17:35200292-35204957	chr17	35200292	35204957	4665	35201399
chr17:35327908-35334392	chr17	35327908	35334392	6484	35330488
chr17:35471431-35473938	chr17	35471431	35473938	2507	35473741
chr17:36019661-36023801	chr17	36019661	36023801	4140	36020157
chr17:37782199-37784308	chr17	37782199	37784308	2109	37783270
chr17:41200867-41206900	chr17	41200867	41206900	6033	41203462
chr17:43792514-43798608	chr17	43792514	43798608	6094	43795078
chr17:47381146-47384772	chr17	47381146	47384772	3626	47382871
chr17:52351276-52356891	chr17	52351276	52356891	5615	52353813
chr17:52403847-52409865	chr17	52403847	52409865	6018	52406426
chr17:52614798-52615851	chr17	52614798	52615851	1053	52615817
chr17:53758538-53759942	chr17	53758538	53759942	1404	53758755
chr17:54127539-54131531	chr17	54127539	54131531	3992	54129464
chr17:54462110-54466067	chr17	54462110	54466067	3957	54462486
chr17:54588052-54593232	chr17	54588052	54593232	5180	54590622
chr17:54657566-54663937	chr17	54657566	54663937	6371	54660117
chr17:55102129-55105456	chr17	55102129	55105456	3327	55104715
chr17:55556514-55558041	chr17	55556514	55558041	1527	55557311
chr17:55947720-55950038	chr17	55947720	55950038	2318	55949557
chr17:56334806-56337402	chr17	56334806	56337402	2596	56336306
chr17:58846270-58852395	chr17	58846270	58852395	6125	58848861
chr17:60483692-60488326	chr17	60483692	60488326	4634	60485290
chr17:60761215-60767330	chr17	60761215	60767330	6115	60763784
chr17:60881440-60887474	chr17	60881440	60887474	6034	60884031
chr17:60977519-60980207	chr17	60977519	60980207	2688	60980084
chr17:62400228-62403120	chr17	62400228	62403120	2892	62402877
chr17:63298753-63302599	chr17	63298753	63302599	3846	63301366
chr17:66596579-66602595	chr17	66596579	66602595	6016	66599171
chr17:68408123-68414142	chr17	68408123	68414142	6019	68410711
chr17:68653539-68654229	chr17	68653539	68654229	690	68653989
chr17:68999130-69005148	chr17	68999130	69005148	6018	69001705
chr17:69611943-69618099	chr17	69611943	69618099	6156	69614532
chr17:70544788-70550795	chr17	70544788	70550795	6007	70547403
chr17:71351959-71357900	chr17	71351959	71357900	5941	71354535
chr17_GL000205v2_random:64717-67007	chr17_GL000205v2_random	64717	67007	2290	66297
chr17_JH159147v1_alt:50836-56923	chr17_JH159147v1_alt	50836	56923	6087	53420
chr17_JH159148v1_alt:61095-67182	chr17_JH159148v1_alt	61095	67182	6087	63679
chr17_KI270857v1_alt:254226-258366	chr17_KI270857v1_alt	254226	258366	4140	254722
chr17_KI270857v1_alt:2021235-2023344	chr17_KI270857v1_alt	2021235	2023344	2109	2022306
chr17_KI270860v1_alt:145217-149027	chr17_KI270860v1_alt	145217	149027	3810	147806
chr18:662513-666167	chr18	662513	666167	3654	665106
chr18:969823-970812	chr18	969823	970812	989	970097
chr18:970858-976878	chr18	970858	976878	6020	973449
chr18:1029349-1035439	chr18	1029349	1035439	6090	1031896
chr18:1516189-1522240	chr18	1516189	1522240	6051	1518777
chr18:1641177-1644885	chr18	1641177	1644885	3708	1643771
chr18:2860237-2866343	chr18	2860237	2866343	6106	2862809
chr18:3695243-3700586	chr18	3695243	3700586	5343	3696785
chr18:4472145-4477324	chr18	4472145	4477324	5179	4474735
chr18:4649234-4651340	chr18	4649234	4651340	2106	4650013
chr18:5681259-5684668	chr18	5681259	5684668	3409	5683883
chr18:5858605-5859429	chr18	5858605	5859429	824	5858643
chr18:6377334-6383770	chr18	6377334	6383770	6436	6379905
chr18:8057452-8063463	chr18	8057452	8063463	6011	8060043
chr18:8146320-8152115	chr18	8146320	8152115	5795	8148236
chr18:8573214-8579366	chr18	8573214	8579366	6152	8575804
chr18:8884053-8889620	chr18	8884053	8889620	5567	8886654
chr18:9165715-9171231	chr18	9165715	9171231	5516	9168307
chr18:9976585-9982015	chr18	9976585	9982015	5430	9979182
chr18:10572668-10578678	chr18	10572668	10578678	6010	10575253
chr18:11475341-11479872	chr18	11475341	11479872	4531	11476022
chr18:12135052-12139363	chr18	12135052	12139363	4311	12137636
chr18:12167135-12173235	chr18	12167135	12173235	6100	12169721
chr18:12202444-12208458	chr18	12202444	12208458	6014	12205035
chr18:13078636-13082432	chr18	13078636	13082432	3796	13081228
chr18:13343089-13349218	chr18	13343089	13349218	6129	13345670
chr18:13857285-13863672	chr18	13857285	13863672	6387	13859868
chr18:13975860-13981891	chr18	13975860	13981891	6031	13978450
chr18:14002455-14006946	chr18	14002455	14006946	4491	14003402
chr18:14037597-14043715	chr18	14037597	14043715	6118	14040177
chr18:14424751-14429040	chr18	14424751	14429040	4289	14425524
chr18:14573645-14575804	chr18	14573645	14575804	2159	14575177
chr18:14788393-14791239	chr18	14788393	14791239	2846	14790979
chr18:14818360-14821461	chr18	14818360	14821461	3101	14820951
chr18:15229094-15235249	chr18	15229094	15235249	6155	15231692
chr18:15293801-15296439	chr18	15293801	15296439	2638	15296382
chr18:15366977-15370947	chr18	15366977	15370947	3970	15369555
chr18:21882938-21889079	chr18	21882938	21889079	6141	21885534
chr18:22808626-22812722	chr18	22808626	22812722	4096	22811218
chr18:24619042-24625072	chr18	24619042	24625072	6030	24621634
chr18:24710814-24716841	chr18	24710814	24716841	6027	24713405
chr18:25524018-25526704	chr18	25524018	25526704	2686	25526605
chr18:26238590-26244703	chr18	26238590	26244703	6113	26241172
chr18:27090108-27092973	chr18	27090108	27092973	2865	27092033
chr18:27158103-27162667	chr18	27158103	27162667	4564	27160698
chr18:27737726-27743750	chr18	27737726	27743750	6024	27740314
chr18:28221978-28225092	chr18	28221978	28225092	3114	28224553
chr18:28416544-28422561	chr18	28416544	28422561	6017	28419129
chr18:28488768-28489261	chr18	28488768	28489261	493	28488950
chr18:29048983-29053006	chr18	29048983	29053006	4023	29051480
chr18:30021862-30027457	chr18	30021862	30027457	5595	30024437
chr18:30224435-30225981	chr18	30224435	30225981	1546	30225348
chr18:30844294-30850737	chr18	30844294	30850737	6443	30846853
chr18:31347968-31353996	chr18	31347968	31353996	6028	31350556
chr18:32228075-32233934	chr18	32228075	32233934	5859	32230508
chr18:32856626-32862684	chr18	32856626	32862684	6058	32859243
chr18:33772159-33773872	chr18	33772159	33773872	1713	33773387
chr18:33860486-33861559	chr18	33860486	33861559	1073	33861222
chr18:34138614-34140925	chr18	34138614	34140925	2311	34139265
chr18:34146268-34148937	chr18	34146268	34148937	2669	34147804
chr18:34552378-34558395	chr18	34552378	34558395	6017	34554963
chr18:34665429-34671527	chr18	34665429	34671527	6098	34668013
chr18:34684149-34690591	chr18	34684149	34690591	6442	34686726
chr18:35146994-35152629	chr18	35146994	35152629	5635	35148759
chr18:36235134-36241152	chr18	36235134	36241152	6018	36237720
chr18:36873690-36877663	chr18	36873690	36877663	3973	36876254
chr18:37096079-37100068	chr18	37096079	37100068	3989	37098662
chr18:37213155-37217908	chr18	37213155	37217908	4753	37215736
chr18:37646296-37649187	chr18	37646296	37649187	2891	37648789
chr18:37800267-37804240	chr18	37800267	37804240	3973	37802490
chr18:37828288-37832931	chr18	37828288	37832931	4643	37829353
chr18:40114089-40120205	chr18	40114089	40120205	6116	40116647
chr18:40187639-40193657	chr18	40187639	40193657	6018	40190231
chr18:42250065-42253194	chr18	42250065	42253194	3129	42252287
chr18:42377270-42381885	chr18	42377270	42381885	4615	42378373
chr18:42438971-42442140	chr18	42438971	42442140	3169	42441552
chr18:43260584-43266238	chr18	43260584	43266238	5654	43263138
chr18:44021279-44024826	chr18	44021279	44024826	3547	44021410
chr18:44160816-44164543	chr18	44160816	44164543	3727	44163377
chr18:44226053-44226695	chr18	44226053	44226695	642	44226455
chr18:44250278-44254065	chr18	44250278	44254065	3787	44252830
chr18:44362362-44367414	chr18	44362362	44367414	5052	44363585
chr18:44370740-44373435	chr18	44370740	44373435	2695	44371081
chr18:44927943-44934065	chr18	44927943	44934065	6122	44930524
chr18:45028010-45031139	chr18	45028010	45031139	3129	45030599
chr18:45471882-45475603	chr18	45471882	45475603	3721	45474465
chr18:45530698-45533892	chr18	45530698	45533892	3194	45533286
chr18:45794070-45800209	chr18	45794070	45800209	6139	45796652
chr18:46923066-46928642	chr18	46923066	46928642	5576	46925671
chr18:47348225-47354243	chr18	47348225	47354243	6018	47350816
chr18:49102418-49108550	chr18	49102418	49108550	6132	49104997
chr18:49710498-49716912	chr18	49710498	49716912	6414	49713069
chr18:49771079-49776563	chr18	49771079	49776563	5484	49773660
chr18:50343959-50349987	chr18	50343959	50349987	6028	50346549
chr18:50364979-50369347	chr18	50364979	50369347	4368	50367547
chr18:51092868-51095784	chr18	51092868	51095784	2916	51095396
chr18:51700979-51706730	chr18	51700979	51706730	5751	51703193
chr18:51966904-51971486	chr18	51966904	51971486	4582	51969495
chr18:52865161-52867747	chr18	52865161	52867747	2586	52867467
chr18:53255214-53261351	chr18	53255214	53261351	6137	53257799
chr18:53828382-53834490	chr18	53828382	53834490	6108	53830955
chr18:53973767-53979840	chr18	53973767	53979840	6073	53976357
chr18:54306057-54310225	chr18	54306057	54310225	4168	54306662
chr18:54399731-54404148	chr18	54399731	54404148	4417	54402320
chr18:54569521-54575026	chr18	54569521	54575026	5505	54572098
chr18:54664206-54670337	chr18	54664206	54670337	6131	54666778
chr18:55715484-55721529	chr18	55715484	55721529	6045	55718088
chr18:55800244-55803416	chr18	55800244	55803416	3172	55801391
chr18:55887412-55893439	chr18	55887412	55893439	6027	55889999
chr18:56010560-56016110	chr18	56010560	56016110	5550	56013150
chr18:57099277-57104961	chr18	57099277	57104961	5684	57101027
chr18:59403939-59409970	chr18	59403939	59409970	6031	59406531
chr18:59673578-59674109	chr18	59673578	59674109	531	59674030
chr18:59997446-60000468	chr18	59997446	60000468	3022	59999986
chr18:60029678-60035707	chr18	60029678	60035707	6029	60032267
chr18:60520838-60523831	chr18	60520838	60523831	2993	60523412
chr18:61074523-61075511	chr18	61074523	61075511	988	61075391
chr18:61310603-61316739	chr18	61310603	61316739	6136	61313165
chr18:61557931-61561315	chr18	61557931	61561315	3384	61560524
chr18:64226384-64232470	chr18	64226384	64232470	6086	64228972
chr18:64451171-64454331	chr18	64451171	64454331	3160	64453767
chr18:65555629-65557096	chr18	65555629	65557096	1467	65556995
chr18:67088680-67090163	chr18	67088680	67090163	1483	67089456
chr18:67252532-67254364	chr18	67252532	67254364	1832	67253055
chr18:67446582-67451464	chr18	67446582	67451464	4882	67448206
chr18:68784834-68790853	chr18	68784834	68790853	6019	68787416
chr18:69251278-69255004	chr18	69251278	69255004	3726	69253859
chr18:70093372-70096902	chr18	70093372	70096902	3530	70093888
chr18:70098644-70102889	chr18	70098644	70102889	4245	70101164
chr18:70342941-70349081	chr18	70342941	70349081	6140	70345529
chr18:70746549-70752581	chr18	70746549	70752581	6032	70749141
chr18:70854240-70857837	chr18	70854240	70857837	3597	70856827
chr18:71088938-71091862	chr18	71088938	71091862	2924	71091473
chr18:71092824-71098582	chr18	71092824	71098582	5758	71095416
chr18:72966526-72972556	chr18	72966526	72972556	6030	72969117
chr18:73468779-73472857	chr18	73468779	73472857	4078	73471355
chr18:73820828-73821816	chr18	73820828	73821816	988	73821674
chr18:77285341-77291293	chr18	77285341	77291293	5952	77287934
chr18:77415976-77422002	chr18	77415976	77422002	6026	77418568
chr18:77428361-77429998	chr18	77428361	77429998	1637	77429534
chr18:77532141-77538300	chr18	77532141	77538300	6159	77534733
chr18:79078663-79081578	chr18	79078663	79081578	2915	79081207
chr18:79284621-79290766	chr18	79284621	79290766	6145	79287206
chr18:80015362-80018122	chr18	80015362	80018122	2760	80017951
chr18_GL383567v1_alt:51766-57794	chr18_GL383567v1_alt	51766	57794	6028	54356
chr18_GL383567v1_alt:72786-77154	chr18_GL383567v1_alt	72786	77154	4368	75354
chr18_GL383568v1_alt:2683-8301	chr18_GL383568v1_alt	2683	8301	5618	4819
chr18_GL383570v1_alt:74977-81011	chr18_GL383570v1_alt	74977	81011	6034	77569
chr18_GL383571v1_alt:22848-27730	chr18_GL383571v1_alt	22848	27730	4882	24472
chr18_GL383572v1_alt:149213-152128	chr18_GL383572v1_alt	149213	152128	2915	151757
chr18_KI270911v1_alt:147376-150291	chr18_KI270911v1_alt	147376	150291	2915	149920
chr19:8795844-8801996	chr19	8795844	8801996	6152	8798433
chr19:12004811-12010815	chr19	12004811	12010815	6004	12007376
chr19:15489403-15492894	chr19	15489403	15492894	3491	15491995
chr19:15595876-15596898	chr19	15595876	15596898	1022	15595902
chr19:19722271-19727201	chr19	19722271	19727201	4930	19723671
chr19:19917950-19924055	chr19	19917950	19924055	6105	19920536
chr19:20627781-20633939	chr19	20627781	20633939	6158	20630367
chr19:20892958-20895826	chr19	20892958	20895826	2868	20895546
chr19:21042812-21046039	chr19	21042812	21046039	3227	21044670
chr19:21109606-21112816	chr19	21109606	21112816	3210	21112172
chr19:21178820-21179561	chr19	21178820	21179561	741	21178960
chr19:21646213-21646614	chr19	21646213	21646614	401	21646382
chr19:21894656-21900094	chr19	21894656	21900094	5438	21896548
chr19:22155500-22161653	chr19	22155500	22161653	6153	22158111
chr19:22378441-22381432	chr19	22378441	22381432	2991	22380972
chr19:22560352-22566607	chr19	22560352	22566607	6255	22562944
chr19:22797553-22797898	chr19	22797553	22797898	345	22797564
chr19:23177824-23178788	chr19	23177824	23178788	964	23178462
chr19:23451759-23457888	chr19	23451759	23457888	6129	23454335
chr19:23890445-23896455	chr19	23890445	23896455	6010	23893017
chr19:24147528-24153703	chr19	24147528	24153703	6175	24150108
chr19:24197791-24200936	chr19	24197791	24200936	3145	24200353
chr19:24264492-24268633	chr19	24264492	24268633	4141	24265082
chr19:24405923-24410992	chr19	24405923	24410992	5069	24408505
chr19:27280553-27286414	chr19	27280553	27286414	5861	27283139
chr19:27318139-27319805	chr19	27318139	27319805	1666	27319552
chr19:27516181-27518974	chr19	27516181	27518974	2793	27517661
chr19:27695438-27701587	chr19	27695438	27701587	6149	27698026
chr19:27862508-27865954	chr19	27862508	27865954	3446	27865094
chr19:29249643-29255625	chr19	29249643	29255625	5982	29252215
chr19:30184224-30190758	chr19	30184224	30190758	6534	30187247
chr19:32587512-32593595	chr19	32587512	32593595	6083	32590101
chr19:34562190-34566017	chr19	34562190	34566017	3827	34564774
chr19:34700381-34706494	chr19	34700381	34706494	6113	34702969
chr19:36697923-36704066	chr19	36697923	36704066	6143	36700511
chr19:37048721-37054503	chr19	37048721	37054503	5782	37051308
chr19:39577422-39580719	chr19	39577422	39580719	3297	39580047
chr19:39594273-39595273	chr19	39594273	39595273	1000	39594886
chr19:39618493-39624631	chr19	39618493	39624631	6138	39620985
chr19:39632981-39636204	chr19	39632981	39636204	3223	39635533
chr19:39713961-39720092	chr19	39713961	39720092	6131	39716529
chr19:40037915-40044054	chr19	40037915	40044054	6139	40040498
chr19:41634017-41637077	chr19	41634017	41637077	3060	41635272
chr19:42677772-42680544	chr19	42677772	42680544	2772	42680365
chr19:42805450-42809000	chr19	42805450	42809000	3550	42808041
chr19:42859653-42863680	chr19	42859653	42863680	4027	42860121
chr19:43242052-43248105	chr19	43242052	43248105	6053	43244642
chr19:44221213-44226925	chr19	44221213	44226925	5712	44223352
chr19:46094518-46098478	chr19	46094518	46098478	3960	46097103
chr19:53205936-53210763	chr19	53205936	53210763	4827	53206924
chr19:54580200-54585900	chr19	54580200	54585900	5700	54582363
chr19:56787530-56788445	chr19	56787530	56788445	915	56787665
chr19:56852590-56853461	chr19	56852590	56853461	871	56853091
chr19_GL383573v1_alt:236234-239102	chr19_GL383573v1_alt	236234	239102	2868	238822
chr19_GL383576v1_alt:78386-81818	chr19_GL383576v1_alt	78386	81818	3432	80964
chr19_GL383576v1_alt:154364-160504	chr19_GL383576v1_alt	154364	160504	6140	156933
chr19_GL949746v1_alt:486590-490228	chr19_GL949746v1_alt	486590	490228	3638	488753
chr19_GL949752v1_alt:485084-488722	chr19_GL949752v1_alt	485084	488722	3638	487247
chr19_KI270867v1_alt:197823-203980	chr19_KI270867v1_alt	197823	203980	6157	200408
chr19_KI270938v1_alt:562781-566419	chr19_KI270938v1_alt	562781	566419	3638	564944
chr1_GL383520v2_alt:103679-107567	chr1_GL383520v2_alt	103679	107567	3888	106274
chr1_KI270706v1_random:7845-13993	chr1_KI270706v1_random	7845	13993	6148	10431
chr1_KI270708v1_random:45961-49685	chr1_KI270708v1_random	45961	49685	3724	46119
chr1_KI270708v1_random:89590-90670	chr1_KI270708v1_random	89590	90670	1080	90233
chr1_KI270710v1_random:18331-24345	chr1_KI270710v1_random	18331	24345	6014	20918
chr1_KI270759v1_alt:287475-292396	chr1_KI270759v1_alt	287475	292396	4921	290053
chr1_KI270760v1_alt:106508-109527	chr1_KI270760v1_alt	106508	109527	3019	109098
chr1_KI270763v1_alt:671975-672436	chr1_KI270763v1_alt	671975	672436	461	672176
chr1_KI270766v1_alt:234972-237551	chr1_KI270766v1_alt	234972	237551	2579	236457
chr2:1178191-1179327	chr2	1178191	1179327	1136	1178891
chr2:1382734-1388849	chr2	1382734	1388849	6115	1385297
chr2:1390019-1392897	chr2	1390019	1392897	2878	1392592
chr2:1505864-1509290	chr2	1505864	1509290	3426	1508473
chr2:2373113-2377010	chr2	2373113	2377010	3897	2373797
chr2:2814879-2818030	chr2	2814879	2818030	3151	2817465
chr2:3794364-3800395	chr2	3794364	3800395	6031	3796957
chr2:4078947-4082177	chr2	4078947	4082177	3230	4081538
chr2:4115297-4118682	chr2	4115297	4118682	3385	4117764
chr2:5856852-5860780	chr2	5856852	5860780	3928	5859440
chr2:5890124-5893878	chr2	5890124	5893878	3754	5892707
chr2:6327502-6331311	chr2	6327502	6331311	3809	6330073
chr2:6898825-6904509	chr2	6898825	6904509	5684	6901406
chr2:10996105-11002136	chr2	10996105	11002136	6031	10998696
chr2:11881460-11887603	chr2	11881460	11887603	6143	11884042
chr2:12134100-12139611	chr2	12134100	12139611	5511	12136034
chr2:12521757-12527771	chr2	12521757	12527771	6014	12524334
chr2:13421766-13428243	chr2	13421766	13428243	6477	13424405
chr2:13733270-13739284	chr2	13733270	13739284	6014	13735851
chr2:13807034-13808139	chr2	13807034	13808139	1105	13807708
chr2:14488757-14491426	chr2	14488757	14491426	2669	14491340
chr2:14501452-14507609	chr2	14501452	14507609	6157	14504042
chr2:14783321-14789477	chr2	14783321	14789477	6156	14785909
chr2:16230135-16233961	chr2	16230135	16233961	3826	16232749
chr2:16593725-16599758	chr2	16593725	16599758	6033	16596318
chr2:17488712-17491127	chr2	17488712	17491127	2415	17490994
chr2:17983131-17989079	chr2	17983131	17989079	5948	17985714
chr2:18012016-18018024	chr2	18012016	18018024	6008	18014601
chr2:18162221-18168665	chr2	18162221	18168665	6444	18164801
chr2:18458207-18464323	chr2	18458207	18464323	6116	18460796
chr2:18634774-18635915	chr2	18634774	18635915	1141	18635713
chr2:18692198-18698337	chr2	18692198	18698337	6139	18694781
chr2:19014535-19018373	chr2	19014535	19018373	3838	19017134
chr2:19280059-19281113	chr2	19280059	19281113	1054	19280503
chr2:19383971-19390103	chr2	19383971	19390103	6132	19386553
chr2:20872293-20875989	chr2	20872293	20875989	3696	20872434
chr2:20905451-20911612	chr2	20905451	20911612	6161	20908062
chr2:21188061-21190966	chr2	21188061	21190966	2905	21190324
chr2:21208575-21214737	chr2	21208575	21214737	6162	21211164
chr2:21521001-21527090	chr2	21521001	21527090	6089	21523581
chr2:21903319-21909344	chr2	21903319	21909344	6025	21905907
chr2:23224851-23230886	chr2	23224851	23230886	6035	23227443
chr2:23437657-23440148	chr2	23437657	23440148	2491	23438898
chr2:24193425-24198640	chr2	24193425	24198640	5215	24195999
chr2:24531453-24536833	chr2	24531453	24536833	5380	24534030
chr2:24800323-24806471	chr2	24800323	24806471	6148	24802916
chr2:29672175-29675090	chr2	29672175	29675090	2915	29674763
chr2:30717944-30721119	chr2	30717944	30721119	3175	30720526
chr2:31624368-31628981	chr2	31624368	31628981	4613	31626946
chr2:31678098-31684166	chr2	31678098	31684166	6068	31680604
chr2:31740162-31744053	chr2	31740162	31744053	3891	31742745
chr2:31896904-31899025	chr2	31896904	31899025	2121	31897805
chr2:32100467-32106586	chr2	32100467	32106586	6119	32103054
chr2:32660601-32662964	chr2	32660601	32662964	2363	32662356
chr2:33044128-33048026	chr2	33044128	33048026	3898	33046700
chr2:33198132-33199407	chr2	33198132	33199407	1275	33198486
chr2:34553644-34556407	chr2	34553644	34556407	2763	34556230
chr2:34572557-34575548	chr2	34572557	34575548	2991	34574172
chr2:35106860-35113009	chr2	35106860	35113009	6149	35109439
chr2:35233432-35236066	chr2	35233432	35236066	2634	35236023
chr2:35319757-35325900	chr2	35319757	35325900	6143	35322343
chr2:35511721-35514714	chr2	35511721	35514714	2993	35514252
chr2:35563061-35569205	chr2	35563061	35569205	6144	35565650
chr2:35900921-35907019	chr2	35900921	35907019	6098	35903472
chr2:36112506-36118537	chr2	36112506	36118537	6031	36115098
chr2:37594197-37600327	chr2	37594197	37600327	6130	37596755
chr2:37935902-37942355	chr2	37935902	37942355	6453	37938482
chr2:37956656-37963156	chr2	37956656	37963156	6500	37959240
chr2:38004695-38010858	chr2	38004695	38010858	6163	38007293
chr2:38132407-38138592	chr2	38132407	38138592	6185	38135006
chr2:39575018-39581152	chr2	39575018	39581152	6134	39577604
chr2:40008598-40014619	chr2	40008598	40014619	6021	40011188
chr2:40232600-40238627	chr2	40232600	40238627	6027	40235187
chr2:40707513-40709985	chr2	40707513	40709985	2472	40709712
chr2:41272588-41274244	chr2	41272588	41274244	1656	41274107
chr2:41514847-41516945	chr2	41514847	41516945	2098	41515675
chr2:43542869-43549021	chr2	43542869	43549021	6152	43545462
chr2:43660471-43666500	chr2	43660471	43666500	6029	43663060
chr2:45059559-45065587	chr2	45059559	45065587	6028	45062147
chr2:46472058-46478104	chr2	46472058	46478104	6046	46474635
chr2:46819577-46821287	chr2	46819577	46821287	1710	46820875
chr2:47910567-47913568	chr2	47910567	47913568	3001	47913155
chr2:48052882-48058419	chr2	48052882	48058419	5537	48055474
chr2:48296696-48299754	chr2	48296696	48299754	3058	48299277
chr2:48702264-48708160	chr2	48702264	48708160	5896	48704477
chr2:48975657-48976989	chr2	48975657	48976989	1332	48976570
chr2:49008027-49011614	chr2	49008027	49011614	3587	49010616
chr2:49180531-49186388	chr2	49180531	49186388	5857	49183096
chr2:49544992-49545882	chr2	49544992	49545882	890	49545005
chr2:49822801-49827260	chr2	49822801	49827260	4459	49824929
chr2:51312721-51318845	chr2	51312721	51318845	6124	51315295
chr2:51359980-51363635	chr2	51359980	51363635	3655	51361281
chr2:51381202-51384220	chr2	51381202	51384220	3018	51383788
chr2:51496212-51499113	chr2	51496212	51499113	2901	51498760
chr2:51769031-51775205	chr2	51769031	51775205	6174	51771633
chr2:51850731-51854024	chr2	51850731	51854024	3293	51853332
chr2:52039405-52045552	chr2	52039405	52045552	6147	52042004
chr2:52534633-52535478	chr2	52534633	52535478	845	52535022
chr2:52587579-52590912	chr2	52587579	52590912	3333	52590176
chr2:52846857-52853099	chr2	52846857	52853099	6242	52849438
chr2:53046875-53048234	chr2	53046875	53048234	1359	53047868
chr2:54172606-54175617	chr2	54172606	54175617	3011	54175117
chr2:55736329-55742393	chr2	55736329	55742393	6064	55738950
chr2:55788120-55794261	chr2	55788120	55794261	6141	55790703
chr2:55831543-55837683	chr2	55831543	55837683	6140	55834112
chr2:56059701-56066003	chr2	56059701	56066003	6302	56062241
chr2:56137150-56143276	chr2	56137150	56143276	6126	56139724
chr2:56161804-56164416	chr2	56161804	56164416	2612	56164383
chr2:56551597-56557745	chr2	56551597	56557745	6148	56554187
chr2:56631243-56637392	chr2	56631243	56637392	6149	56633825
chr2:56660300-56662929	chr2	56660300	56662929	2629	56662894
chr2:57066514-57067735	chr2	57066514	57067735	1221	57067315
chr2:57270866-57276951	chr2	57270866	57276951	6085	57273439
chr2:58381542-58387566	chr2	58381542	58387566	6024	58384127
chr2:59086750-59092886	chr2	59086750	59092886	6136	59089331
chr2:59122895-59126766	chr2	59122895	59126766	3871	59125434
chr2:60130176-60136340	chr2	60130176	60136340	6164	60132781
chr2:60203200-60207771	chr2	60203200	60207771	4571	60203916
chr2:62515520-62521655	chr2	62515520	62521655	6135	62518108
chr2:62580885-62586986	chr2	62580885	62586986	6101	62583412
chr2:62616418-62622729	chr2	62616418	62622729	6311	62618995
chr2:62644222-62645695	chr2	62644222	62645695	1473	62644959
chr2:62645710-62651726	chr2	62645710	62651726	6016	62648304
chr2:62748985-62755137	chr2	62748985	62755137	6152	62751572
chr2:63087672-63092353	chr2	63087672	63092353	4681	63090262
chr2:63703631-63706595	chr2	63703631	63706595	2964	63704886
chr2:65924170-65930343	chr2	65924170	65930343	6173	65926775
chr2:65963061-65969214	chr2	65963061	65969214	6153	65965654
chr2:66138949-66144939	chr2	66138949	66144939	5990	66141531
chr2:66346884-66353026	chr2	66346884	66353026	6142	66349472
chr2:66609645-66615764	chr2	66609645	66615764	6119	66612220
chr2:66618984-66621401	chr2	66618984	66621401	2417	66620553
chr2:66627085-66633235	chr2	66627085	66633235	6150	66629673
chr2:66642648-66648743	chr2	66642648	66648743	6095	66645204
chr2:66855267-66858977	chr2	66855267	66858977	3710	66855847
chr2:66908379-66911826	chr2	66908379	66911826	3447	66910970
chr2:67189811-67195967	chr2	67189811	67195967	6156	67192400
chr2:67738970-67745083	chr2	67738970	67745083	6113	67741544
chr2:68397734-68404006	chr2	68397734	68404006	6272	68400323
chr2:68613648-68618913	chr2	68613648	68618913	5265	68616241
chr2:68711525-68714764	chr2	68711525	68714764	3239	68714073
chr2:71245812-71251556	chr2	71245812	71251556	5744	71248022
chr2:71411474-71417501	chr2	71411474	71417501	6027	71414066
chr2:72015949-72021960	chr2	72015949	72021960	6011	72018535
chr2:73480076-73486099	chr2	73480076	73486099	6023	73482666
chr2:73504736-73508194	chr2	73504736	73508194	3458	73507366
chr2:73664500-73670630	chr2	73664500	73670630	6130	73667085
chr2:74786530-74789063	chr2	74786530	74789063	2533	74788941
chr2:74970104-74973692	chr2	74970104	74973692	3588	74972687
chr2:75081927-75085143	chr2	75081927	75085143	3216	75084515
chr2:75365298-75367361	chr2	75365298	75367361	2063	75365727
chr2:75368896-75375035	chr2	75368896	75375035	6139	75371475
chr2:76090648-76096785	chr2	76090648	76096785	6137	76093236
chr2:76171560-76174722	chr2	76171560	76174722	3162	76174114
chr2:76345152-76351328	chr2	76345152	76351328	6176	76347757
chr2:76647991-76654020	chr2	76647991	76654020	6029	76650587
chr2:76702092-76708115	chr2	76702092	76708115	6023	76704667
chr2:76722834-76729033	chr2	76722834	76729033	6199	76725426
chr2:76775758-76781758	chr2	76775758	76781758	6000	76778348
chr2:78722544-78725950	chr2	78722544	78725950	3406	78725138
chr2:79077739-79083528	chr2	79077739	79083528	5789	79080336
chr2:79105693-79111696	chr2	79105693	79111696	6003	79108284
chr2:79282256-79288271	chr2	79282256	79288271	6015	79284848
chr2:79408319-79411453	chr2	79408319	79411453	3134	79410888
chr2:79877853-79882325	chr2	79877853	79882325	4472	79880405
chr2:79990718-79991241	chr2	79990718	79991241	523	79990866
chr2:80093001-80099154	chr2	80093001	80099154	6153	80095591
chr2:80210213-80216378	chr2	80210213	80216378	6165	80212801
chr2:80960060-80962326	chr2	80960060	80962326	2266	80960864
chr2:81356965-81363100	chr2	81356965	81363100	6135	81359555
chr2:81916623-81921491	chr2	81916623	81921491	4868	81919213
chr2:81945897-81951658	chr2	81945897	81951658	5761	81947770
chr2:84369336-84372291	chr2	84369336	84372291	2955	84371853
chr2:84383775-84385779	chr2	84383775	84385779	2004	84385553
chr2:84505558-84511700	chr2	84505558	84511700	6142	84508155
chr2:86655238-86661268	chr2	86655238	86661268	6030	86657829
chr2:87269986-87272755	chr2	87269986	87272755	2769	87272552
chr2:89921879-89923079	chr2	89921879	89923079	1200	89922937
chr2:90350348-90356484	chr2	90350348	90356484	6136	90352931
chr2:91948751-91950717	chr2	91948751	91950717	1966	91950207
chr2:94613333-94619273	chr2	94613333	94619273	5940	94615588
chr2:94949438-94953034	chr2	94949438	94953034	3596	94952003
chr2:95252086-95258210	chr2	95252086	95258210	6124	95254669
chr2:96039961-96046104	chr2	96039961	96046104	6143	96042557
chr2:96416647-96420380	chr2	96416647	96420380	3733	96419247
chr2:97174544-97176908	chr2	97174544	97176908	2364	97175214
chr2:97225627-97231779	chr2	97225627	97231779	6152	97228224
chr2:97596035-97602198	chr2	97596035	97602198	6163	97598625
chr2:97892902-97896689	chr2	97892902	97896689	3787	97895456
chr2:99129769-99133476	chr2	99129769	99133476	3707	99132211
chr2:99225827-99227653	chr2	99225827	99227653	1826	99226499
chr2:100151607-100157797	chr2	100151607	100157797	6190	100154254
chr2:101455311-101460384	chr2	101455311	101460384	5073	101456800
chr2:102566355-102572385	chr2	102566355	102572385	6030	102568946
chr2:102874020-102880174	chr2	102874020	102880174	6154	102876614
chr2:103470674-103476244	chr2	103470674	103476244	5570	103473270
chr2:103694152-103694956	chr2	103694152	103694956	804	103694594
chr2:104623760-104630175	chr2	104623760	104630175	6415	104626307
chr2:104953609-104959755	chr2	104953609	104959755	6146	104956191
chr2:105205801-105209450	chr2	105205801	105209450	3649	105208395
chr2:107139276-107145392	chr2	107139276	107145392	6116	107141857
chr2:108203143-108209267	chr2	108203143	108209267	6124	108205724
chr2:108340637-108345685	chr2	108340637	108345685	5048	108341903
chr2:109111631-109117785	chr2	109111631	109117785	6154	109114223
chr2:109930242-109931182	chr2	109930242	109931182	940	109930782
chr2:110072260-110073918	chr2	110072260	110073918	1658	110072829
chr2:110226128-110229134	chr2	110226128	110229134	3006	110228727
chr2:110412395-110418532	chr2	110412395	110418532	6137	110414965
chr2:112503812-112509845	chr2	112503812	112509845	6033	112506404
chr2:112523797-112528236	chr2	112523797	112528236	4439	112526375
chr2:112609366-112612693	chr2	112609366	112612693	3327	112611286
chr2:113471481-113477545	chr2	113471481	113477545	6064	113474075
chr2:114012974-114019126	chr2	114012974	114019126	6152	114015560
chr2:114096298-114102405	chr2	114096298	114102405	6107	114098884
chr2:114355751-114358908	chr2	114355751	114358908	3157	114358326
chr2:114689065-114693862	chr2	114689065	114693862	4797	114691668
chr2:114895876-114897370	chr2	114895876	114897370	1494	114897324
chr2:115329437-115333922	chr2	115329437	115333922	4485	115332012
chr2:115376550-115382573	chr2	115376550	115382573	6023	115379140
chr2:115628811-115632655	chr2	115628811	115632655	3844	115630991
chr2:115799431-115805573	chr2	115799431	115805573	6142	115802021
chr2:115889046-115895541	chr2	115889046	115895541	6495	115891682
chr2:115960073-115966152	chr2	115960073	115966152	6079	115962615
chr2:116048941-116054967	chr2	116048941	116054967	6026	116051533
chr2:116119707-116123564	chr2	116119707	116123564	3857	116122297
chr2:116331798-116337365	chr2	116331798	116337365	5567	116334367
chr2:116929297-116931175	chr2	116929297	116931175	1878	116930480
chr2:117459104-117462264	chr2	117459104	117462264	3160	117461693
chr2:117593416-117595323	chr2	117593416	117595323	1907	117594980
chr2:117766016-117769725	chr2	117766016	117769725	3709	117768599
chr2:117871311-117875825	chr2	117871311	117875825	4514	117873905
chr2:118137000-118143020	chr2	118137000	118143020	6020	118139582
chr2:118451326-118457738	chr2	118451326	118457738	6412	118453887
chr2:118895761-118901792	chr2	118895761	118901792	6031	118898352
chr2:118995361-118998659	chr2	118995361	118998659	3298	118997936
chr2:120024758-120025391	chr2	120024758	120025391	633	120025082
chr2:120045672-120051818	chr2	120045672	120051818	6146	120048247
chr2:120080108-120085627	chr2	120080108	120085627	5519	120082693
chr2:121438558-121439638	chr2	121438558	121439638	1080	121438918
chr2:122012673-122018708	chr2	122012673	122018708	6035	122015267
chr2:122046204-122052249	chr2	122046204	122052249	6045	122048789
chr2:122121416-122125606	chr2	122121416	122125606	4190	122121731
chr2:122140900-122143591	chr2	122140900	122143591	2691	122143526
chr2:122345967-122348628	chr2	122345967	122348628	2661	122348558
chr2:123798596-123804706	chr2	123798596	123804706	6110	123801140
chr2:124356306-124362334	chr2	124356306	124362334	6028	124358892
chr2:124593139-124599168	chr2	124593139	124599168	6029	124595726
chr2:125026639-125030384	chr2	125026639	125030384	3745	125029185
chr2:126178048-126184064	chr2	126178048	126184064	6016	126180628
chr2:126451369-126456679	chr2	126451369	126456679	5310	126453960
chr2:126611280-126613892	chr2	126611280	126613892	2612	126613855
chr2:126957644-126964063	chr2	126957644	126964063	6419	126960206
chr2:127594597-127596080	chr2	127594597	127596080	1483	127595061
chr2:128858984-128865016	chr2	128858984	128865016	6032	128861576
chr2:128943307-128949431	chr2	128943307	128949431	6124	128945899
chr2:129038218-129044252	chr2	129038218	129044252	6034	129040729
chr2:129411066-129415379	chr2	129411066	129415379	4313	129413645
chr2:129682427-129685909	chr2	129682427	129685909	3482	129685019
chr2:131341481-131347665	chr2	131341481	131347665	6184	131344071
chr2:131613928-131617597	chr2	131613928	131617597	3669	131616517
chr2:132062875-132069016	chr2	132062875	132069016	6141	132065457
chr2:132125166-132127805	chr2	132125166	132127805	2639	132127748
chr2:132452481-132456552	chr2	132452481	132456552	4071	132455069
chr2:133383071-133389184	chr2	133383071	133389184	6113	133385635
chr2:133465007-133471038	chr2	133465007	133471038	6031	133467598
chr2:134209190-134212559	chr2	134209190	134212559	3369	134211780
chr2:134595120-134598122	chr2	134595120	134598122	3002	134597702
chr2:134650508-134656574	chr2	134650508	134656574	6066	134653134
chr2:134746514-134752631	chr2	134746514	134752631	6117	134749100
chr2:135480618-135484178	chr2	135480618	135484178	3560	135483205
chr2:136261091-136263744	chr2	136261091	136263744	2653	136263017
chr2:136940864-136947121	chr2	136940864	136947121	6257	136943469
chr2:137070564-137076737	chr2	137070564	137076737	6173	137073192
chr2:137281407-137285585	chr2	137281407	137285585	4178	137283987
chr2:137309506-137315534	chr2	137309506	137315534	6028	137312094
chr2:137393160-137399190	chr2	137393160	137399190	6030	137395751
chr2:137582343-137588434	chr2	137582343	137588434	6091	137584924
chr2:138538747-138544882	chr2	138538747	138544882	6135	138541331
chr2:138575352-138576912	chr2	138575352	138576912	1560	138576678
chr2:139532787-139538975	chr2	139532787	139538975	6188	139535407
chr2:140303664-140306935	chr2	140303664	140306935	3271	140306241
chr2:140965561-140970585	chr2	140965561	140970585	5024	140968118
chr2:141442429-141448851	chr2	141442429	141448851	6422	141445015
chr2:142405101-142405736	chr2	142405101	142405736	635	142405233
chr2:142607779-142613812	chr2	142607779	142613812	6033	142610371
chr2:142709706-142711596	chr2	142709706	142711596	1890	142709837
chr2:142806275-142812293	chr2	142806275	142812293	6018	142808861
chr2:143536378-143542524	chr2	143536378	143542524	6146	143538968
chr2:144634552-144639142	chr2	144634552	144639142	4590	144635244
chr2:144897598-144903603	chr2	144897598	144903603	6005	144900187
chr2:145603724-145605297	chr2	145603724	145605297	1573	145604820
chr2:145946186-145952338	chr2	145946186	145952338	6152	145948769
chr2:147409945-147413726	chr2	147409945	147413726	3781	147412504
chr2:147580469-147586902	chr2	147580469	147586902	6433	147583039
chr2:147743424-147745007	chr2	147743424	147745007	1583	147744974
chr2:148148940-148154956	chr2	148148940	148154956	6016	148151530
chr2:148226112-148231635	chr2	148226112	148231635	5523	148228697
chr2:148322844-148328854	chr2	148322844	148328854	6010	148325423
chr2:149251308-149258103	chr2	149251308	149258103	6795	149253872
chr2:149402732-149406773	chr2	149402732	149406773	4041	149405322
chr2:149494258-149500670	chr2	149494258	149500670	6412	149496856
chr2:149501242-149507406	chr2	149501242	149507406	6164	149503817
chr2:149545087-149551217	chr2	149545087	149551217	6130	149547674
chr2:149637880-149643991	chr2	149637880	149643991	6111	149640462
chr2:149671523-149674433	chr2	149671523	149674433	2910	149674026
chr2:149790630-149796753	chr2	149790630	149796753	6123	149793208
chr2:149834084-149837925	chr2	149834084	149837925	3841	149836679
chr2:149878817-149879494	chr2	149878817	149879494	677	149879182
chr2:151471243-151473198	chr2	151471243	151473198	1955	151472959
chr2:151698868-151704889	chr2	151698868	151704889	6021	151701453
chr2:153007766-153013796	chr2	153007766	153013796	6030	153010358
chr2:153251473-153257477	chr2	153251473	153257477	6004	153254056
chr2:153397921-153403952	chr2	153397921	153403952	6031	153400513
chr2:153433831-153439958	chr2	153433831	153439958	6127	153436416
chr2:153627765-153629222	chr2	153627765	153629222	1457	153628934
chr2:153646471-153650752	chr2	153646471	153650752	4281	153649053
chr2:154147919-154154081	chr2	154147919	154154081	6162	154150517
chr2:154558993-154559495	chr2	154558993	154559495	502	154559009
chr2:154954644-154958535	chr2	154954644	154958535	3891	154957231
chr2:155345507-155351986	chr2	155345507	155351986	6479	155348109
chr2:155443836-155446550	chr2	155443836	155446550	2714	155446424
chr2:155466628-155472644	chr2	155466628	155472644	6016	155469209
chr2:155570236-155573536	chr2	155570236	155573536	3300	155572808
chr2:155763399-155767519	chr2	155763399	155767519	4120	155763709
chr2:156370256-156376389	chr2	156370256	156376389	6133	156372857
chr2:156715011-156716526	chr2	156715011	156716526	1515	156716057
chr2:156771371-156775796	chr2	156771371	156775796	4425	156773962
chr2:156962342-156968483	chr2	156962342	156968483	6141	156964922
chr2:156993982-156994870	chr2	156993982	156994870	888	156994344
chr2:157097259-157102803	chr2	157097259	157102803	5544	157099863
chr2:157273823-157279956	chr2	157273823	157279956	6133	157276412
chr2:157397599-157403696	chr2	157397599	157403696	6097	157400187
chr2:158328023-158332502	chr2	158328023	158332502	4479	158330596
chr2:158332476-158333760	chr2	158332476	158333760	1284	158332621
chr2:159036364-159040237	chr2	159036364	159040237	3873	159038938
chr2:159472086-159476186	chr2	159472086	159476186	4100	159473157
chr2:160525034-160528908	chr2	160525034	160528908	3874	160527601
chr2:160623126-160628717	chr2	160623126	160628717	5591	160625168
chr2:160723320-160725512	chr2	160723320	160725512	2192	160725255
chr2:160756918-160763090	chr2	160756918	160763090	6172	160759509
chr2:160850732-160856748	chr2	160850732	160856748	6016	160853310
chr2:160997498-161002173	chr2	160997498	161002173	4675	161000089
chr2:161141323-161145133	chr2	161141323	161145133	3810	161143901
chr2:161457298-161462858	chr2	161457298	161462858	5560	161459083
chr2:161696307-161699009	chr2	161696307	161699009	2702	161698896
chr2:161715342-161718906	chr2	161715342	161718906	3564	161717880
chr2:161886797-161891911	chr2	161886797	161891911	5114	161889370
chr2:162452939-162456897	chr2	162452939	162456897	3958	162455525
chr2:162568875-162570712	chr2	162568875	162570712	1837	162569117
chr2:163011679-163014688	chr2	163011679	163014688	3009	163013682
chr2:164120937-164121719	chr2	164120937	164121719	782	164121606
chr2:165039552-165042766	chr2	165039552	165042766	3214	165042141
chr2:165731663-165737694	chr2	165731663	165737694	6031	165734254
chr2:166505580-166512006	chr2	166505580	166512006	6426	166508186
chr2:166702725-166708745	chr2	166702725	166708745	6020	166705317
chr2:166847459-166847647	chr2	166847459	166847647	188	166847614
chr2:166907613-166913537	chr2	166907613	166913537	5924	166910200
chr2:166935413-166939399	chr2	166935413	166939399	3986	166937683
chr2:167009065-167012321	chr2	167009065	167012321	3256	167011660
chr2:167022451-167027783	chr2	167022451	167027783	5332	167025042
chr2:167029153-167031521	chr2	167029153	167031521	2368	167029793
chr2:167081946-167087967	chr2	167081946	167087967	6021	167084529
chr2:167096075-167099964	chr2	167096075	167099964	3889	167096136
chr2:167441879-167447993	chr2	167441879	167447993	6114	167444455
chr2:167662955-167668974	chr2	167662955	167668974	6019	167665551
chr2:167804326-167810426	chr2	167804326	167810426	6100	167806903
chr2:169308223-169313735	chr2	169308223	169313735	5512	169310789
chr2:169429680-169430091	chr2	169429680	169430091	411	169430025
chr2:169615857-169619648	chr2	169615857	169619648	3791	169618441
chr2:170622573-170628671	chr2	170622573	170628671	6098	170625154
chr2:171349852-171356109	chr2	171349852	171356109	6257	171352556
chr2:171641285-171647419	chr2	171641285	171647419	6134	171643864
chr2:171755565-171759168	chr2	171755565	171759168	3603	171757809
chr2:172187264-172193414	chr2	172187264	172193414	6150	172189855
chr2:172264705-172270864	chr2	172264705	172270864	6159	172267293
chr2:173527289-173533317	chr2	173527289	173533317	6028	173529880
chr2:173699375-173705410	chr2	173699375	173705410	6035	173701969
chr2:174404458-174410482	chr2	174404458	174410482	6024	174407047
chr2:175481951-175487994	chr2	175481951	175487994	6043	175484557
chr2:175588546-175594563	chr2	175588546	175594563	6017	175591140
chr2:175691462-175694637	chr2	175691462	175694637	3175	175691828
chr2:175700383-175703087	chr2	175700383	175703087	2704	175702625
chr2:176218152-176223588	chr2	176218152	176223588	5436	176220751
chr2:176305923-176312032	chr2	176305923	176312032	6109	176308479
chr2:176623034-176624677	chr2	176623034	176624677	1643	176624395
chr2:177368872-177374083	chr2	177368872	177374083	5211	177370796
chr2:179061184-179067325	chr2	179061184	179067325	6141	179063766
chr2:179087387-179093560	chr2	179087387	179093560	6173	179089976
chr2:179751936-179758099	chr2	179751936	179758099	6163	179754520
chr2:180299347-180302079	chr2	180299347	180302079	2732	180300994
chr2:180526723-180532728	chr2	180526723	180532728	6005	180529304
chr2:180585619-180591717	chr2	180585619	180591717	6098	180588215
chr2:180782408-180785837	chr2	180782408	180785837	3429	180784998
chr2:180833661-180839689	chr2	180833661	180839689	6028	180836251
chr2:181448739-181451543	chr2	181448739	181451543	2804	181451322
chr2:181766627-181769886	chr2	181766627	181769886	3259	181769205
chr2:181798561-181804707	chr2	181798561	181804707	6146	181801139
chr2:182025225-182031239	chr2	182025225	182031239	6014	182027799
chr2:182124352-182126050	chr2	182124352	182126050	1698	182125486
chr2:182174747-182177716	chr2	182174747	182177716	2969	182177274
chr2:182560064-182565540	chr2	182560064	182565540	5476	182562643
chr2:182745741-182749694	chr2	182745741	182749694	3953	182748318
chr2:182768825-182772642	chr2	182768825	182772642	3817	182771415
chr2:183295885-183298070	chr2	183295885	183298070	2185	183297953
chr2:183448314-183454476	chr2	183448314	183454476	6162	183450896
chr2:183913146-183916202	chr2	183913146	183916202	3056	183915732
chr2:184229958-184234729	chr2	184229958	184234729	4771	184232544
chr2:184280611-184281867	chr2	184280611	184281867	1256	184281823
chr2:185412622-185413848	chr2	185412622	185413848	1226	185413654
chr2:185419434-185425462	chr2	185419434	185425462	6028	185422023
chr2:185585887-185591908	chr2	185585887	185591908	6021	185588476
chr2:185682368-185688480	chr2	185682368	185688480	6112	185684938
chr2:185841720-185847756	chr2	185841720	185847756	6036	185844320
chr2:185975843-185976379	chr2	185975843	185976379	536	185976313
chr2:186252085-186252426	chr2	186252085	186252426	341	186252255
chr2:186395755-186398943	chr2	186395755	186398943	3188	186398335
chr2:186896079-186899904	chr2	186896079	186899904	3825	186898666
chr2:186986049-186988732	chr2	186986049	186988732	2683	186988551
chr2:187186130-187187126	chr2	187186130	187187126	996	187186587
chr2:189269274-189270657	chr2	189269274	189270657	1383	189269825
chr2:189886992-189891213	chr2	189886992	189891213	4221	189889516
chr2:189970986-189977125	chr2	189970986	189977125	6139	189973572
chr2:190772250-190778401	chr2	190772250	190778401	6151	190774835
chr2:190957391-190959556	chr2	190957391	190959556	2165	190957995
chr2:192268435-192274450	chr2	192268435	192274450	6015	192271017
chr2:192833938-192837784	chr2	192833938	192837784	3846	192836533
chr2:192925167-192931291	chr2	192925167	192931291	6124	192927756
chr2:193032509-193037944	chr2	193032509	193037944	5435	193035096
chr2:193212420-193218448	chr2	193212420	193218448	6028	193215008
chr2:193704913-193710934	chr2	193704913	193710934	6021	193707493
chr2:193830868-193837004	chr2	193830868	193837004	6136	193833457
chr2:194009956-194011263	chr2	194009956	194011263	1307	194010459
chr2:194471740-194473146	chr2	194471740	194473146	1406	194471882
chr2:194541263-194542445	chr2	194541263	194542445	1182	194541285
chr2:194804399-194807404	chr2	194804399	194807404	3005	194806982
chr2:194954913-194957523	chr2	194954913	194957523	2610	194956629
chr2:195067521-195073543	chr2	195067521	195073543	6022	195070110
chr2:195264676-195269845	chr2	195264676	195269845	5169	195266301
chr2:195373191-195379241	chr2	195373191	195379241	6050	195375804
chr2:195931204-195933132	chr2	195931204	195933132	1928	195933007
chr2:196521488-196527500	chr2	196521488	196527500	6012	196524064
chr2:196704555-196710639	chr2	196704555	196710639	6084	196707099
chr2:196752639-196758336	chr2	196752639	196758336	5697	196755220
chr2:197562509-197566508	chr2	197562509	197566508	3999	197565072
chr2:197608632-197612131	chr2	197608632	197612131	3499	197611200
chr2:197634735-197640761	chr2	197634735	197640761	6026	197637328
chr2:197687546-197693561	chr2	197687546	197693561	6015	197690125
chr2:197768729-197769452	chr2	197768729	197769452	723	197769249
chr2:198425634-198428945	chr2	198425634	198428945	3311	198428210
chr2:198784445-198786426	chr2	198784445	198786426	1981	198786401
chr2:199239608-199243659	chr2	199239608	199243659	4051	199242176
chr2:199560072-199562727	chr2	199560072	199562727	2655	199562680
chr2:200115119-200118851	chr2	200115119	200118851	3732	200116092
chr2:200561046-200567211	chr2	200561046	200567211	6165	200563646
chr2:201589968-201595182	chr2	201589968	201595182	5214	201592569
chr2:204461264-204464089	chr2	204461264	204464089	2825	204462014
chr2:204766998-204770540	chr2	204766998	204770540	3542	204769590
chr2:204991072-204997106	chr2	204991072	204997106	6034	204993667
chr2:205203457-205206125	chr2	205203457	205206125	2668	205206034
chr2:205601783-205604198	chr2	205601783	205604198	2415	205602464
chr2:206411078-206416210	chr2	206411078	206416210	5132	206412648
chr2:206680854-206682358	chr2	206680854	206682358	1504	206681964
chr2:206894207-206900352	chr2	206894207	206900352	6145	206896804
chr2:208519879-208525988	chr2	208519879	208525988	6109	208522140
chr2:208680352-208686512	chr2	208680352	208686512	6160	208682940
chr2:208687131-208690455	chr2	208687131	208690455	3324	208689475
chr2:208746490-208752645	chr2	208746490	208752645	6155	208749081
chr2:209228714-209231778	chr2	209228714	209231778	3064	209230522
chr2:209746180-209752208	chr2	209746180	209752208	6028	209748768
chr2:210332655-210333254	chr2	210332655	210333254	599	210332994
chr2:210346849-210350625	chr2	210346849	210350625	3776	210348156
chr2:210401240-210404897	chr2	210401240	210404897	3657	210403706
chr2:210902064-210904207	chr2	210902064	210904207	2143	210903126
chr2:210978784-210985667	chr2	210978784	210985667	6883	210981383
chr2:211253917-211256763	chr2	211253917	211256763	2846	211256507
chr2:211782685-211784091	chr2	211782685	211784091	1406	211783957
chr2:211807145-211810662	chr2	211807145	211810662	3517	211809277
chr2:213344378-213348906	chr2	213344378	213348906	4528	213346973
chr2:213353899-213359904	chr2	213353899	213359904	6005	213356335
chr2:213567231-213573262	chr2	213567231	213573262	6031	213569823
chr2:213674386-213677131	chr2	213674386	213677131	2745	213676971
chr2:214272299-214278451	chr2	214272299	214278451	6152	214274884
chr2:214632369-214636255	chr2	214632369	214636255	3886	214634951
chr2:214937955-214942069	chr2	214937955	214942069	4114	214940552
chr2:216977758-216983154	chr2	216977758	216983154	5396	216979308
chr2:217132361-217135675	chr2	217132361	217135675	3314	217134994
chr2:217674594-217677886	chr2	217674594	217677886	3292	217676710
chr2:218102605-218108683	chr2	218102605	218108683	6078	218105141
chr2:218766673-218770836	chr2	218766673	218770836	4163	218769247
chr2:219813509-219819659	chr2	219813509	219819659	6150	219816097
chr2:220382217-220388343	chr2	220382217	220388343	6126	220384805
chr2:221090707-221091488	chr2	221090707	221091488	781	221090878
chr2:222149601-222155632	chr2	222149601	222155632	6031	222152193
chr2:225519279-225522186	chr2	225519279	225522186	2907	225521862
chr2:227540197-227544146	chr2	227540197	227544146	3949	227542745
chr2:227835978-227840151	chr2	227835978	227840151	4173	227836272
chr2:227964733-227968932	chr2	227964733	227968932	4199	227967313
chr2:228001580-228007066	chr2	228001580	228007066	5486	228004149
chr2:228199138-228205299	chr2	228199138	228205299	6161	228201725
chr2:228229025-228234515	chr2	228229025	228234515	5490	228231616
chr2:228419987-228426024	chr2	228419987	228426024	6037	228422580
chr2:228693001-228695634	chr2	228693001	228695634	2633	228693855
chr2:228930476-228933433	chr2	228930476	228933433	2957	228933052
chr2:229965374-229968092	chr2	229965374	229968092	2718	229967965
chr2:230112071-230115909	chr2	230112071	230115909	3838	230114650
chr2:230337069-230342513	chr2	230337069	230342513	5444	230339084
chr2:230488712-230491168	chr2	230488712	230491168	2456	230489109
chr2:232031501-232037991	chr2	232031501	232037991	6490	232034056
chr2:232149196-232155229	chr2	232149196	232155229	6033	232151787
chr2:232176806-232181609	chr2	232176806	232181609	4803	232179398
chr2:233577839-233583870	chr2	233577839	233583870	6031	233580427
chr2:233612059-233616614	chr2	233612059	233616614	4555	233614644
chr2:233630838-233635398	chr2	233630838	233635398	4560	233633398
chr2:234358204-234360906	chr2	234358204	234360906	2702	234360792
chr2:234754959-234757518	chr2	234754959	234757518	2559	234757294
chr2:236383666-236389689	chr2	236383666	236389689	6023	236386250
chr2:236409291-236410370	chr2	236409291	236410370	1079	236410197
chr2:237843471-237849565	chr2	237843471	237849565	6094	237846047
chr2:238372131-238375668	chr2	238372131	238375668	3537	238374717
chr20:160200-161120	chr20	160200	161120	920	160852
chr20:1540644-1546331	chr20	1540644	1546331	5687	1543219
chr20:1638602-1645001	chr20	1638602	1645001	6399	1641197
chr20:4283734-4289881	chr20	4283734	4289881	6147	4286314
chr20:4495807-4501964	chr20	4495807	4501964	6157	4498394
chr20:5458531-5463827	chr20	5458531	5463827	5296	5460015
chr20:6315821-6321844	chr20	6315821	6321844	6023	6318412
chr20:7116194-7122199	chr20	7116194	7122199	6005	7118773
chr20:7807018-7810723	chr20	7807018	7810723	3705	7809442
chr20:7951569-7956199	chr20	7951569	7956199	4630	7954124
chr20:8108866-8114917	chr20	8108866	8114917	6051	8111474
chr20:8378977-8382273	chr20	8378977	8382273	3296	8381531
chr20:8595101-8601127	chr20	8595101	8601127	6026	8597691
chr20:11420267-11423089	chr20	11420267	11423089	2822	11422879
chr20:12123711-12129700	chr20	12123711	12129700	5989	12126301
chr20:12359564-12363173	chr20	12359564	12363173	3609	12362153
chr20:12422677-12427244	chr20	12422677	12427244	4567	12425259
chr20:12443116-12449140	chr20	12443116	12449140	6024	12445709
chr20:12801017-12807044	chr20	12801017	12807044	6027	12803607
chr20:14460536-14461506	chr20	14460536	14461506	970	14461013
chr20:14461502-14467675	chr20	14461502	14467675	6173	14464122
chr20:16787839-16791878	chr20	16787839	16791878	4039	16790420
chr20:16907437-16913577	chr20	16907437	16913577	6140	16910017
chr20:17114790-17120918	chr20	17114790	17120918	6128	17117373
chr20:18755270-18761370	chr20	18755270	18761370	6100	18757859
chr20:18861216-18867349	chr20	18861216	18867349	6133	18863800
chr20:18949967-18954391	chr20	18949967	18954391	4424	18952557
chr20:19161645-19167812	chr20	19161645	19167812	6167	19164230
chr20:19295213-19296521	chr20	19295213	19296521	1308	19295945
chr20:19803640-19805028	chr20	19803640	19805028	1388	19804786
chr20:19852883-19855530	chr20	19852883	19855530	2647	19855469
chr20:21479989-21483593	chr20	21479989	21483593	3604	21482579
chr20:21877875-21883950	chr20	21877875	21883950	6075	21879859
chr20:21910853-21916881	chr20	21910853	21916881	6028	21913441
chr20:22040464-22046614	chr20	22040464	22046614	6150	22043044
chr20:22869590-22873827	chr20	22869590	22873827	4237	22872178
chr20:22987592-22993720	chr20	22987592	22993720	6128	22990179
chr20:23615337-23621466	chr20	23615337	23621466	6129	23617929
chr20:23786816-23789436	chr20	23786816	23789436	2620	23789403
chr20:23896851-23903006	chr20	23896851	23903006	6155	23899440
chr20:24396493-24400887	chr20	24396493	24400887	4394	24399093
chr20:24552313-24557870	chr20	24552313	24557870	5557	24554892
chr20:25713656-25717695	chr20	25713656	25717695	4039	25716242
chr20:25727392-25728206	chr20	25727392	25728206	814	25727964
chr20:26202509-26204045	chr20	26202509	26204045	1536	26203848
chr20:28572686-28575024	chr20	28572686	28575024	2338	28574413
chr20:28776315-28779757	chr20	28776315	28779757	3442	28778907
chr20:28788314-28794415	chr20	28788314	28794415	6101	28790852
chr20:29229892-29230948	chr20	29229892	29230948	1056	29230319
chr20:29366059-29372220	chr20	29366059	29372220	6161	29368644
chr20:29466155-29472288	chr20	29466155	29472288	6133	29468732
chr20:30140833-30145075	chr20	30140833	30145075	4242	30143423
chr20:30831834-30836469	chr20	30831834	30836469	4635	30832922
chr20:30882876-30889027	chr20	30882876	30889027	6151	30885473
chr20:30944112-30950140	chr20	30944112	30950140	6028	30946701
chr20:30950141-30950553	chr20	30950141	30950553	412	30950520
chr20:30970455-30976471	chr20	30970455	30976471	6016	30973042
chr20:31263045-31268587	chr20	31263045	31268587	5542	31265624
chr20:35071283-35077392	chr20	35071283	35077392	6109	35073857
chr20:39483724-39486437	chr20	39483724	39486437	2713	39486311
chr20:41801298-41807397	chr20	41801298	41807397	6099	41803868
chr20:41965084-41967964	chr20	41965084	41967964	2880	41967657
chr20:42614937-42620967	chr20	42614937	42620967	6030	42617527
chr20:43401428-43404425	chr20	43401428	43404425	2997	43404006
chr20:43871149-43877271	chr20	43871149	43877271	6122	43873723
chr20:45472119-45478614	chr20	45472119	45478614	6495	45474766
chr20:45660033-45666559	chr20	45660033	45666559	6526	45663008
chr20:45687891-45693981	chr20	45687891	45693981	6090	45690428
chr20:53455562-53461566	chr20	53455562	53461566	6004	53458147
chr20:54882170-54886617	chr20	54882170	54886617	4447	54884747
chr20:55062652-55067739	chr20	55062652	55067739	5087	55064088
chr20:55220304-55226469	chr20	55220304	55226469	6165	55222897
chr20:55274360-55278180	chr20	55274360	55278180	3820	55276950
chr20:55492502-55496786	chr20	55492502	55496786	4284	55495066
chr20:55517454-55520242	chr20	55517454	55520242	2788	55520030
chr20:55806896-55809624	chr20	55806896	55809624	2728	55809499
chr20:55900229-55906399	chr20	55900229	55906399	6170	55902816
chr20:56106833-56108002	chr20	56106833	56108002	1169	56107696
chr20:59531777-59537803	chr20	59531777	59537803	6026	59534366
chr20:60615704-60618919	chr20	60615704	60618919	3215	60618315
chr21:5248335-5252523	chr21	5248335	5252523	4188	5250934
chr21:5252810-5255764	chr21	5252810	5255764	2954	5255402
chr21:5293195-5295944	chr21	5293195	5295944	2749	5294980
chr21:5386998-5388055	chr21	5386998	5388055	1057	5387424
chr21:5572187-5575220	chr21	5572187	5575220	3033	5574640
chr21:5766547-5769407	chr21	5766547	5769407	2860	5769138
chr21:5887131-5889991	chr21	5887131	5889991	2860	5889722
chr21:6340692-6343737	chr21	6340692	6343737	3045	6343153
chr21:6510882-6513512	chr21	6510882	6513512	2630	6513492
chr21:7067409-7070442	chr21	7067409	7070442	3033	7069862
chr21:7317414-7318471	chr21	7317414	7318471	1057	7317840
chr21:7449187-7452220	chr21	7449187	7452220	3033	7451640
chr21:7632523-7635516	chr21	7632523	7635516	2993	7635091
chr21:8164617-8167477	chr21	8164617	8167477	2860	8167208
chr21:8347662-8350522	chr21	8347662	8350522	2860	8350253
chr21:8767450-8773597	chr21	8767450	8773597	6147	8770032
chr21:9138074-9143275	chr21	9138074	9143275	5201	9140646
chr21:9183088-9189219	chr21	9183088	9189219	6131	9185673
chr21:9333721-9339873	chr21	9333721	9339873	6152	9336312
chr21:10349674-10355828	chr21	10349674	10355828	6154	10352258
chr21:10803461-10804518	chr21	10803461	10804518	1057	10803887
chr21:13146086-13147831	chr21	13146086	13147831	1745	13146706
chr21:13990185-13995598	chr21	13990185	13995598	5413	13992051
chr21:14933877-14939951	chr21	14933877	14939951	6074	14936433
chr21:15449830-15454725	chr21	15449830	15454725	4895	15452441
chr21:15914555-15920735	chr21	15914555	15920735	6180	15917169
chr21:15950078-15952848	chr21	15950078	15952848	2770	15951770
chr21:16127487-16133646	chr21	16127487	16133646	6159	16129792
chr21:16150479-16153416	chr21	16150479	16153416	2937	16153066
chr21:16410062-16412984	chr21	16410062	16412984	2922	16412566
chr21:17748071-17752268	chr21	17748071	17752268	4197	17750663
chr21:17769753-17776204	chr21	17769753	17776204	6451	17772337
chr21:18435103-18436490	chr21	18435103	18436490	1387	18435719
chr21:18870077-18876908	chr21	18870077	18876908	6831	18872665
chr21:19071741-19075923	chr21	19071741	19075923	4182	19074330
chr21:20127464-20128364	chr21	20127464	20128364	900	20127532
chr21:21443910-21446508	chr21	21443910	21446508	2598	21444420
chr21:22087497-22092463	chr21	22087497	22092463	4966	22088597
chr21:24914604-24918898	chr21	24914604	24918898	4294	24917189
chr21:27431913-27437202	chr21	27431913	27437202	5289	27434529
chr21:28620115-28620655	chr21	28620115	28620655	540	28620355
chr21:28812238-28813028	chr21	28812238	28813028	790	28812725
chr21:31814220-31820362	chr21	31814220	31820362	6142	31816816
chr21:33925606-33931606	chr21	33925606	33931606	6000	33928194
chr21:35182792-35185429	chr21	35182792	35185429	2637	35185351
chr21:35493766-35499791	chr21	35493766	35499791	6025	35496353
chr21:37774348-37777280	chr21	37774348	37777280	2932	37776936
chr21:40022874-40028842	chr21	40022874	40028842	5968	40025459
chr21:40305422-40307085	chr21	40305422	40307085	1663	40307030
chr21:43119202-43121831	chr21	43119202	43121831	2629	43121811
chr21:46578333-46582758	chr21	46578333	46582758	4425	46579045
chr21_GL383578v2_alt:23371-26570	chr21_GL383578v2_alt	23371	26570	3199	25955
chr21_GL383579v2_alt:152078-158104	chr21_GL383579v2_alt	152078	158104	6026	154667
chr21_GL383580v2_alt:66486-69557	chr21_GL383580v2_alt	66486	69557	3071	69065
chr22:10930514-10933711	chr22	10930514	10933711	3197	10933100
chr22:11132433-11134389	chr22	11132433	11134389	1956	11133879
chr22:11332166-11336966	chr22	11332166	11336966	4800	11334759
chr22:11428056-11433204	chr22	11428056	11433204	5148	11429638
chr22:11466473-11467555	chr22	11466473	11467555	1082	11467118
chr22:11589018-11595168	chr22	11589018	11595168	6150	11591612
chr22:12031366-12037491	chr22	12031366	12037491	6125	12033951
chr22:12105842-12111971	chr22	12105842	12111971	6129	12108398
chr22:12185980-12191136	chr22	12185980	12191136	5156	12188518
chr22:12314262-12318451	chr22	12314262	12318451	4189	12316865
chr22:12318739-12321690	chr22	12318739	12321690	2951	12321329
chr22:12364296-12367048	chr22	12364296	12367048	2752	12366083
chr22:12375457-12376934	chr22	12375457	12376934	1477	12376025
chr22:12432136-12433192	chr22	12432136	12433192	1056	12432562
chr22:15214621-15220667	chr22	15214621	15220667	6046	15217227
chr22:15931299-15934198	chr22	15931299	15934198	2899	15933888
chr22:15980063-15986114	chr22	15980063	15986114	6051	15982679
chr22:16494616-16496572	chr22	16494616	16496572	1956	16496062
chr22:17293296-17296529	chr22	17293296	17296529	3233	17295885
chr22:22052402-22055863	chr22	22052402	22055863	3461	22053859
chr22:22276800-22282812	chr22	22276800	22282812	6012	22279381
chr22:28333850-28340033	chr22	28333850	28340033	6183	28336426
chr22:28386847-28392869	chr22	28386847	28392869	6022	28389430
chr22:32294665-32300684	chr22	32294665	32300684	6019	32297241
chr22:34386372-34390129	chr22	34386372	34390129	3757	34388944
chr22:34549683-34555708	chr22	34549683	34555708	6025	34552271
chr22:34677368-34683400	chr22	34677368	34683400	6032	34679955
chr22:34745640-34750209	chr22	34745640	34750209	4569	34748222
chr22:35024982-35031413	chr22	35024982	35031413	6431	35027538
chr22:47345785-47351662	chr22	47345785	47351662	5877	47348377
chr22:48985761-48991792	chr22	48985761	48991792	6031	48988353
chr22:50750147-50754445	chr22	50750147	50754445	4298	50752730
chr22_KI270733v1_random:81034-83895	chr22_KI270733v1_random	81034	83895	2861	83626
chr22_KI270737v1_random:99876-103838	chr22_KI270737v1_random	99876	103838	3962	102463
chr2_GL582966v2_alt:23969-29986	chr2_GL582966v2_alt	23969	29986	6017	26548
chr2_KI270771v1_alt:54783-56661	chr2_KI270771v1_alt	54783	56661	1878	55966
chr2_KI270774v1_alt:65928-72043	chr2_KI270774v1_alt	65928	72043	6115	68491
chr2_KI270774v1_alt:73213-76091	chr2_KI270774v1_alt	73213	76091	2878	75786
chr2_KI270774v1_alt:188235-191661	chr2_KI270774v1_alt	188235	191661	3426	190844
chr2_KI270775v1_alt:57375-63454	chr2_KI270775v1_alt	57375	63454	6079	59917
chr2_KI270894v1_alt:161996-168131	chr2_KI270894v1_alt	161996	168131	6135	164578
chr3:301751-304914	chr3	301751	304914	3163	304329
chr3:367661-374053	chr3	367661	374053	6392	370185
chr3:610496-614048	chr3	610496	614048	3552	613059
chr3:1029905-1033203	chr3	1029905	1033203	3298	1032476
chr3:1654774-1656821	chr3	1654774	1656821	2047	1655223
chr3:1913508-1919645	chr3	1913508	1919645	6137	1916077
chr3:2424064-2430141	chr3	2424064	2430141	6077	2426658
chr3:2547961-2550293	chr3	2547961	2550293	2332	2549787
chr3:2666594-2672735	chr3	2666594	2672735	6141	2669179
chr3:3885605-3892071	chr3	3885605	3892071	6466	3888198
chr3:3937362-3942013	chr3	3937362	3942013	4651	3938452
chr3:4237796-4240416	chr3	4237796	4240416	2620	4240349
chr3:4242065-4246393	chr3	4242065	4246393	4328	4242862
chr3:4265584-4267568	chr3	4265584	4267568	1984	4267313
chr3:4363362-4367403	chr3	4363362	4367403	4041	4364312
chr3:5371484-5376545	chr3	5371484	5376545	5061	5373902
chr3:5524853-5527488	chr3	5524853	5527488	2635	5526643
chr3:5590805-5596951	chr3	5590805	5596951	6146	5593387
chr3:5939847-5944708	chr3	5939847	5944708	4861	5941142
chr3:6025624-6030480	chr3	6025624	6030480	4856	6026807
chr3:6030856-6036835	chr3	6030856	6036835	5979	6033028
chr3:6266919-6273034	chr3	6266919	6273034	6115	6269501
chr3:6317792-6318322	chr3	6317792	6318322	530	6317937
chr3:6484911-6490929	chr3	6484911	6490929	6018	6487498
chr3:6536640-6541943	chr3	6536640	6541943	5303	6538080
chr3:6764136-6770100	chr3	6764136	6770100	5964	6766724
chr3:6887232-6892144	chr3	6887232	6892144	4912	6889820
chr3:6945054-6951190	chr3	6945054	6951190	6136	6947642
chr3:7529943-7532767	chr3	7529943	7532767	2824	7532207
chr3:7782798-7783461	chr3	7782798	7783461	663	7783140
chr3:7892834-7896738	chr3	7892834	7896738	3904	7895403
chr3:8064756-8068738	chr3	8064756	8068738	3982	8065202
chr3:8333571-8334676	chr3	8333571	8334676	1105	8334338
chr3:11488672-11492490	chr3	11488672	11492490	3818	11488991
chr3:11861987-11868130	chr3	11861987	11868130	6143	11864571
chr3:11892250-11894885	chr3	11892250	11894885	2635	11894853
chr3:12028021-12033291	chr3	12028021	12033291	5270	12030466
chr3:13985140-13989713	chr3	13985140	13989713	4573	13987723
chr3:13989714-13993743	chr3	13989714	13993743	4029	13992292
chr3:14188809-14194405	chr3	14188809	14194405	5596	14191371
chr3:15391507-15397614	chr3	15391507	15397614	6107	15394085
chr3:15480181-15484403	chr3	15480181	15484403	4222	15482798
chr3:15697496-15698143	chr3	15697496	15698143	647	15697819
chr3:15907246-15913378	chr3	15907246	15913378	6132	15909824
chr3:16158871-16164990	chr3	16158871	16164990	6119	16161430
chr3:16954028-16958182	chr3	16954028	16958182	4154	16956617
chr3:16964031-16966796	chr3	16964031	16966796	2765	16966603
chr3:17096576-17100129	chr3	17096576	17100129	3553	17099166
chr3:17342947-17344119	chr3	17342947	17344119	1172	17343555
chr3:17612891-17619039	chr3	17612891	17619039	6148	17615472
chr3:17654472-17655184	chr3	17654472	17655184	712	17654748
chr3:17999696-18005818	chr3	17999696	18005818	6122	18002280
chr3:18689808-18692563	chr3	18689808	18692563	2755	18692397
chr3:18924258-18925417	chr3	18924258	18925417	1159	18924805
chr3:18930482-18936506	chr3	18930482	18936506	6024	18933080
chr3:18957806-18963833	chr3	18957806	18963833	6027	18960394
chr3:19037716-19040354	chr3	19037716	19040354	2638	19039754
chr3:19097368-19103347	chr3	19097368	19103347	5979	19099919
chr3:19288233-19291826	chr3	19288233	19291826	3593	19290835
chr3:19370610-19376625	chr3	19370610	19376625	6015	19373199
chr3:19590260-19595386	chr3	19590260	19595386	5126	19592850
chr3:19635043-19636670	chr3	19635043	19636670	1627	19635486
chr3:19843977-19847098	chr3	19843977	19847098	3121	19844105
chr3:20260937-20263550	chr3	20260937	20263550	2613	20263521
chr3:20265851-20268964	chr3	20265851	20268964	3113	20268408
chr3:20353752-20359248	chr3	20353752	20359248	5496	20356338
chr3:20427891-20433570	chr3	20427891	20433570	5679	20429707
chr3:20815432-20821531	chr3	20815432	20821531	6099	20817989
chr3:21249724-21255755	chr3	21249724	21255755	6031	21252319
chr3:21556087-21561608	chr3	21556087	21561608	5521	21557749
chr3:21983139-21989177	chr3	21983139	21989177	6038	21985755
chr3:22408802-22414999	chr3	22408802	22414999	6197	22411173
chr3:22737735-22743754	chr3	22737735	22743754	6019	22740327
chr3:22854549-22856312	chr3	22854549	22856312	1763	22856202
chr3:23087348-23093459	chr3	23087348	23093459	6111	23089895
chr3:23296317-23301810	chr3	23296317	23301810	5493	23298876
chr3:23560066-23563576	chr3	23560066	23563576	3510	23562657
chr3:24053473-24058888	chr3	24053473	24058888	5415	24056080
chr3:24078952-24084478	chr3	24078952	24084478	5526	24081535
chr3:24089458-24095491	chr3	24089458	24095491	6033	24092050
chr3:24975769-24981919	chr3	24975769	24981919	6150	24978342
chr3:25241317-25247778	chr3	25241317	25247778	6461	25243898
chr3:25356514-25362929	chr3	25356514	25362929	6415	25359068
chr3:25699456-25702074	chr3	25699456	25702074	2618	25702048
chr3:25993157-25996911	chr3	25993157	25996911	3754	25995713
chr3:26036528-26042769	chr3	26036528	26042769	6241	26039213
chr3:26124470-26130617	chr3	26124470	26130617	6147	26127050
chr3:26239082-26245212	chr3	26239082	26245212	6130	26241650
chr3:26294247-26297507	chr3	26294247	26297507	3260	26296832
chr3:26384735-26390767	chr3	26384735	26390767	6032	26387327
chr3:26398017-26404045	chr3	26398017	26404045	6028	26400609
chr3:26526816-26530134	chr3	26526816	26530134	3318	26529402
chr3:26728188-26730137	chr3	26728188	26730137	1949	26728239
chr3:26810159-26813919	chr3	26810159	26813919	3760	26812008
chr3:26897261-26899925	chr3	26897261	26899925	2664	26899520
chr3:26917461-26920547	chr3	26917461	26920547	3086	26920056
chr3:26953636-26959822	chr3	26953636	26959822	6186	26956218
chr3:27258226-27262111	chr3	27258226	27262111	3885	27260809
chr3:27815983-27821983	chr3	27815983	27821983	6000	27818549
chr3:28272984-28276245	chr3	28272984	28276245	3261	28273110
chr3:28364749-28370304	chr3	28364749	28370304	5555	28366731
chr3:28526807-28529664	chr3	28526807	28529664	2857	28529414
chr3:28687167-28689890	chr3	28687167	28689890	2723	28689756
chr3:29051622-29055743	chr3	29051622	29055743	4121	29054198
chr3:29108111-29112113	chr3	29108111	29112113	4002	29108694
chr3:29357055-29362575	chr3	29357055	29362575	5520	29359634
chr3:29813430-29814737	chr3	29813430	29814737	1307	29814569
chr3:29979460-29985802	chr3	29979460	29985802	6342	29982012
chr3:30125288-30126899	chr3	30125288	30126899	1611	30126170
chr3:30385680-30388905	chr3	30385680	30388905	3225	30388270
chr3:33281055-33287153	chr3	33281055	33287153	6098	33283636
chr3:33964689-33970774	chr3	33964689	33970774	6085	33967269
chr3:33983652-33987482	chr3	33983652	33987482	3830	33985771
chr3:34079713-34085844	chr3	34079713	34085844	6131	34082296
chr3:34116080-34119859	chr3	34116080	34119859	3779	34118660
chr3:34413126-34419172	chr3	34413126	34419172	6046	34415735
chr3:34427736-34433885	chr3	34427736	34433885	6149	34430329
chr3:35167838-35173080	chr3	35167838	35173080	5242	35169546
chr3:35477379-35483260	chr3	35477379	35483260	5881	35479955
chr3:35818653-35824692	chr3	35818653	35824692	6039	35821244
chr3:35900375-35903148	chr3	35900375	35903148	2773	35902956
chr3:36048688-36054094	chr3	36048688	36054094	5406	36051276
chr3:36069018-36072806	chr3	36069018	36072806	3788	36071603
chr3:36535023-36536207	chr3	36535023	36536207	1184	36536056
chr3:36621475-36625027	chr3	36621475	36625027	3552	36624087
chr3:37425353-37431516	chr3	37425353	37431516	6163	37427943
chr3:37612962-37619102	chr3	37612962	37619102	6140	37615554
chr3:37654695-37659874	chr3	37654695	37659874	5179	37657278
chr3:39310354-39311643	chr3	39310354	39311643	1289	39311272
chr3:39366644-39372763	chr3	39366644	39372763	6119	39369224
chr3:39614995-39620312	chr3	39614995	39620312	5317	39617583
chr3:39737994-39743148	chr3	39737994	39743148	5154	39740552
chr3:39872341-39876416	chr3	39872341	39876416	4075	39874929
chr3:40154990-40161029	chr3	40154990	40161029	6039	40157583
chr3:40902374-40908432	chr3	40902374	40908432	6058	40904996
chr3:40945299-40951405	chr3	40945299	40951405	6106	40947869
chr3:40953869-40960021	chr3	40953869	40960021	6152	40956458
chr3:41387374-41390918	chr3	41387374	41390918	3544	41389960
chr3:41540070-41542835	chr3	41540070	41542835	2765	41542608
chr3:41558876-41564433	chr3	41558876	41564433	5557	41561452
chr3:41642194-41648350	chr3	41642194	41648350	6156	41644781
chr3:41776582-41777857	chr3	41776582	41777857	1275	41777010
chr3:41803489-41806721	chr3	41803489	41806721	3232	41806072
chr3:41850984-41851690	chr3	41850984	41851690	706	41851665
chr3:42281922-42288074	chr3	42281922	42288074	6152	42284513
chr3:43486298-43487820	chr3	43486298	43487820	1522	43487392
chr3:43800888-43805982	chr3	43800888	43805982	5094	43803465
chr3:43934442-43940020	chr3	43934442	43940020	5578	43937024
chr3:43940015-43946521	chr3	43940015	43946521	6506	43942600
chr3:44816246-44820136	chr3	44816246	44820136	3890	44818831
chr3:46771885-46776155	chr3	46771885	46776155	4270	46774479
chr3:46783105-46789138	chr3	46783105	46789138	6033	46785698
chr3:48841975-48843410	chr3	48841975	48843410	1435	48843002
chr3:50903771-50907825	chr3	50903771	50907825	4054	50906351
chr3:50973137-50979172	chr3	50973137	50979172	6035	50975730
chr3:51147343-51151337	chr3	51147343	51151337	3994	51149928
chr3:51250869-51256191	chr3	51250869	51256191	5322	51253452
chr3:51298405-51304919	chr3	51298405	51304919	6514	51300991
chr3:51363488-51368114	chr3	51363488	51368114	4626	51366075
chr3:53365276-53371325	chr3	53365276	53371325	6049	53367885
chr3:53921747-53927805	chr3	53921747	53927805	6058	53924336
chr3:54394322-54400323	chr3	54394322	54400323	6001	54396904
chr3:54458770-54464920	chr3	54458770	54464920	6150	54461364
chr3:55046104-55052129	chr3	55046104	55052129	6025	55048690
chr3:56065539-56069169	chr3	56065539	56069169	3630	56068126
chr3:56600445-56602834	chr3	56600445	56602834	2389	56602564
chr3:57807327-57809023	chr3	57807327	57809023	1696	57807858
chr3:58275643-58281729	chr3	58275643	58281729	6086	58278189
chr3:58758539-58764668	chr3	58758539	58764668	6129	58761123
chr3:58948607-58949632	chr3	58948607	58949632	1025	58948877
chr3:59096829-59100974	chr3	59096829	59100974	4145	59097101
chr3:59220843-59226778	chr3	59220843	59226778	5935	59223419
chr3:59354781-59360946	chr3	59354781	59360946	6165	59357379
chr3:60960425-60966566	chr3	60960425	60966566	6141	60963017
chr3:61100060-61105394	chr3	61100060	61105394	5334	61102642
chr3:61204826-61210955	chr3	61204826	61210955	6129	61207407
chr3:61259278-61264275	chr3	61259278	61264275	4997	61260411
chr3:62847281-62852331	chr3	62847281	62852331	5050	62849865
chr3:63211708-63217714	chr3	63211708	63217714	6006	63214296
chr3:66272731-66273478	chr3	66272731	66273478	747	66273379
chr3:66288336-66293113	chr3	66288336	66293113	4777	66290902
chr3:66763671-66767703	chr3	66763671	66767703	4032	66766247
chr3:67135989-67139390	chr3	67135989	67139390	3401	67138594
chr3:67759428-67764196	chr3	67759428	67764196	4768	67762006
chr3:67775624-67782070	chr3	67775624	67782070	6446	67778198
chr3:67903149-67905793	chr3	67903149	67905793	2644	67905740
chr3:68076319-68082339	chr3	68076319	68082339	6020	68078899
chr3:68581104-68584943	chr3	68581104	68584943	3839	68583707
chr3:68719447-68725825	chr3	68719447	68725825	6378	68721983
chr3:68826890-68833325	chr3	68826890	68833325	6435	68829776
chr3:68841560-68847714	chr3	68841560	68847714	6154	68844105
chr3:69475205-69481363	chr3	69475205	69481363	6158	69477792
chr3:69574373-69577603	chr3	69574373	69577603	3230	69576940
chr3:69631368-69637484	chr3	69631368	69637484	6116	69633947
chr3:70006660-70010482	chr3	70006660	70010482	3822	70009227
chr3:70015566-70019787	chr3	70015566	70019787	4221	70018172
chr3:70285056-70291083	chr3	70285056	70291083	6027	70287646
chr3:70445023-70450387	chr3	70445023	70450387	5364	70447603
chr3:70451605-70455501	chr3	70451605	70455501	3896	70454194
chr3:70675668-70681798	chr3	70675668	70681798	6130	70678260
chr3:70791388-70796928	chr3	70791388	70796928	5540	70793973
chr3:70846248-70849181	chr3	70846248	70849181	2933	70848820
chr3:70894500-70898957	chr3	70894500	70898957	4457	70895397
chr3:72710341-72716487	chr3	72710341	72716487	6146	72712925
chr3:73332850-73338990	chr3	73332850	73338990	6140	73335441
chr3:73368461-73374615	chr3	73368461	73374615	6154	73371045
chr3:74156962-74163113	chr3	74156962	74163113	6151	74159552
chr3:74194128-74197348	chr3	74194128	74197348	3220	74196718
chr3:74450511-74455786	chr3	74450511	74455786	5275	74453104
chr3:74552941-74555886	chr3	74552941	74555886	2945	74555501
chr3:75091959-75098014	chr3	75091959	75098014	6055	75094572
chr3:75119849-75125881	chr3	75119849	75125881	6032	75122441
chr3:75273453-75279470	chr3	75273453	75279470	6017	75276043
chr3:75483458-75489612	chr3	75483458	75489612	6154	75486041
chr3:75793905-75799073	chr3	75793905	75799073	5168	75796480
chr3:75831756-75837912	chr3	75831756	75837912	6156	75834352
chr3:75845058-75851126	chr3	75845058	75851126	6068	75847596
chr3:75865806-75866696	chr3	75865806	75866696	890	75866309
chr3:75874781-75875227	chr3	75874781	75875227	446	75875162
chr3:75917024-75921318	chr3	75917024	75921318	4294	75919624
chr3:76029366-76032762	chr3	76029366	76032762	3396	76031953
chr3:77210593-77216723	chr3	77210593	77216723	6130	77213164
chr3:77763677-77769663	chr3	77763677	77769663	5986	77766269
chr3:77839447-77845837	chr3	77839447	77845837	6390	77841986
chr3:77985141-77988587	chr3	77985141	77988587	3446	77987724
chr3:78463343-78465987	chr3	78463343	78465987	2644	78464486
chr3:78777687-78778445	chr3	78777687	78778445	758	78778422
chr3:79129777-79133955	chr3	79129777	79133955	4178	79131270
chr3:79292085-79293596	chr3	79292085	79293596	1511	79292964
chr3:80146343-80152720	chr3	80146343	80152720	6377	80148922
chr3:80417858-80419621	chr3	80417858	80419621	1763	80418171
chr3:80866422-80867754	chr3	80866422	80867754	1332	80867716
chr3:80891646-80897665	chr3	80891646	80897665	6019	80894234
chr3:81051389-81057413	chr3	81051389	81057413	6024	81053985
chr3:81525186-81526243	chr3	81525186	81526243	1057	81525620
chr3:82104884-82111042	chr3	82104884	82111042	6158	82107475
chr3:82111337-82115329	chr3	82111337	82115329	3992	82111491
chr3:82152795-82154056	chr3	82152795	82154056	1261	82152853
chr3:82170465-82173608	chr3	82170465	82173608	3143	82173050
chr3:82268404-82274117	chr3	82268404	82274117	5713	82270988
chr3:82333148-82337336	chr3	82333148	82337336	4188	82335712
chr3:82370309-82376434	chr3	82370309	82376434	6125	82372899
chr3:82658990-82661934	chr3	82658990	82661934	2944	82661549
chr3:82701494-82707830	chr3	82701494	82707830	6336	82704004
chr3:82720588-82722427	chr3	82720588	82722427	1839	82722064
chr3:83243846-83248362	chr3	83243846	83248362	4516	83246235
chr3:83288787-83290079	chr3	83288787	83290079	1292	83289024
chr3:83646572-83650613	chr3	83646572	83650613	4041	83646745
chr3:84359951-84362560	chr3	84359951	84362560	2609	84362513
chr3:84403082-84405909	chr3	84403082	84405909	2827	84405661
chr3:84591708-84594500	chr3	84591708	84594500	2792	84594292
chr3:84809767-84815899	chr3	84809767	84815899	6132	84812351
chr3:85398005-85400767	chr3	85398005	85400767	2762	85400537
chr3:86871227-86876967	chr3	86871227	86876967	5740	86873789
chr3:87340526-87346504	chr3	87340526	87346504	5978	87343114
chr3:87647889-87654326	chr3	87647889	87654326	6437	87650460
chr3:87939103-87940277	chr3	87939103	87940277	1174	87939461
chr3:88503101-88509122	chr3	88503101	88509122	6021	88505682
chr3:88654616-88657550	chr3	88654616	88657550	2934	88657240
chr3:88768224-88771110	chr3	88768224	88771110	2886	88768963
chr3:89345615-89351640	chr3	89345615	89351640	6025	89348203
chr3:89460825-89466856	chr3	89460825	89466856	6031	89463417
chr3:89869044-89875069	chr3	89869044	89875069	6025	89871635
chr3:89896549-89900106	chr3	89896549	89900106	3557	89899121
chr3:89939076-89945113	chr3	89939076	89945113	6037	89941676
chr3:90104986-90111136	chr3	90104986	90111136	6150	90107570
chr3:90169567-90175598	chr3	90169567	90175598	6031	90172159
chr3:90187673-90193762	chr3	90187673	90193762	6089	90190237
chr3:90264835-90265898	chr3	90264835	90265898	1063	90264937
chr3:90278617-90281397	chr3	90278617	90281397	2780	90281205
chr3:90307077-90312451	chr3	90307077	90312451	5374	90309662
chr3:90312446-90313356	chr3	90312446	90313356	910	90312963
chr3:90382470-90388451	chr3	90382470	90388451	5981	90385036
chr3:90430658-90436681	chr3	90430658	90436681	6023	90433240
chr3:91314638-91320763	chr3	91314638	91320763	6125	91317218
chr3:91335444-91341679	chr3	91335444	91341679	6235	91338001
chr3:93726079-93731446	chr3	93726079	93731446	5367	93728653
chr3:93801388-93806262	chr3	93801388	93806262	4874	93803975
chr3:94237684-94238665	chr3	94237684	94238665	981	94237915
chr3:95013433-95016448	chr3	95013433	95016448	3015	95014781
chr3:95059814-95065951	chr3	95059814	95065951	6137	95062392
chr3:95282944-95286719	chr3	95282944	95286719	3775	95285533
chr3:95548574-95551631	chr3	95548574	95551631	3057	95550856
chr3:95657314-95663341	chr3	95657314	95663341	6027	95659895
chr3:96569305-96572735	chr3	96569305	96572735	3430	96571873
chr3:96623314-96624498	chr3	96623314	96624498	1184	96623767
chr3:96639573-96642480	chr3	96639573	96642480	2907	96642129
chr3:96936611-96942758	chr3	96936611	96942758	6147	96939194
chr3:96979060-96985198	chr3	96979060	96985198	6138	96981641
chr3:97505189-97508984	chr3	97505189	97508984	3795	97507750
chr3:97542094-97548211	chr3	97542094	97548211	6117	97544679
chr3:97904737-97910773	chr3	97904737	97910773	6036	97907334
chr3:98090104-98093174	chr3	98090104	98093174	3070	98092659
chr3:98377950-98381177	chr3	98377950	98381177	3227	98380539
chr3:98477985-98481509	chr3	98477985	98481509	3524	98480577
chr3:98801700-98804977	chr3	98801700	98804977	3277	98804134
chr3:99058681-99064815	chr3	99058681	99064815	6134	99061253
chr3:99288595-99294302	chr3	99288595	99294302	5707	99291187
chr3:99361041-99362065	chr3	99361041	99362065	1024	99361486
chr3:99733146-99739243	chr3	99733146	99739243	6097	99735739
chr3:100472377-100476929	chr3	100472377	100476929	4552	100474962
chr3:100670568-100673456	chr3	100670568	100673456	2888	100673148
chr3:100685377-100691510	chr3	100685377	100691510	6133	100687965
chr3:100933988-100937022	chr3	100933988	100937022	3034	100936564
chr3:101003169-101006993	chr3	101003169	101006993	3824	101005758
chr3:101294075-101296897	chr3	101294075	101296897	2822	101296652
chr3:101536931-101541323	chr3	101536931	101541323	4392	101537798
chr3:101750444-101754042	chr3	101750444	101754042	3598	101750500
chr3:101905442-101911839	chr3	101905442	101911839	6397	101908007
chr3:101919066-101925500	chr3	101919066	101925500	6434	101921650
chr3:101967375-101971554	chr3	101967375	101971554	4179	101967981
chr3:102836264-102842422	chr3	102836264	102842422	6158	102838863
chr3:102920371-102922860	chr3	102920371	102922860	2489	102922204
chr3:102967698-102971402	chr3	102967698	102971402	3704	102970304
chr3:103131217-103133199	chr3	103131217	103133199	1982	103131459
chr3:103478151-103484300	chr3	103478151	103484300	6149	103480744
chr3:103556537-103562569	chr3	103556537	103562569	6032	103559129
chr3:104463843-104469976	chr3	104463843	104469976	6133	104466428
chr3:104690949-104697119	chr3	104690949	104697119	6170	104693562
chr3:106218410-106223993	chr3	106218410	106223993	5583	106220996
chr3:107692204-107698221	chr3	107692204	107698221	6017	107694783
chr3:107885796-107888284	chr3	107885796	107888284	2488	107887549
chr3:108363975-108366931	chr3	108363975	108366931	2956	108366565
chr3:109404971-109407866	chr3	109404971	109407866	2895	109407555
chr3:109455920-109459790	chr3	109455920	109459790	3870	109458508
chr3:109508196-109514400	chr3	109508196	109514400	6204	109510790
chr3:110117565-110120452	chr3	110117565	110120452	2887	110120243
chr3:110632031-110638051	chr3	110632031	110638051	6020	110634614
chr3:110830864-110836421	chr3	110830864	110836421	5557	110833439
chr3:110911437-110917460	chr3	110911437	110917460	6023	110914025
chr3:111386755-111390765	chr3	111386755	111390765	4010	111388666
chr3:111441149-111447572	chr3	111441149	111447572	6423	111443726
chr3:111467916-111474265	chr3	111467916	111474265	6349	111470473
chr3:111556203-111562234	chr3	111556203	111562234	6031	111558795
chr3:111752629-111758749	chr3	111752629	111758749	6120	111755239
chr3:112160269-112166385	chr3	112160269	112166385	6116	112162859
chr3:112233483-112239593	chr3	112233483	112239593	6110	112236057
chr3:112659127-112665164	chr3	112659127	112665164	6037	112661736
chr3:113481415-113484977	chr3	113481415	113484977	3562	113483965
chr3:114988096-114992005	chr3	114988096	114992005	3909	114990693
chr3:115196934-115198981	chr3	115196934	115198981	2047	115198207
chr3:115312305-115318470	chr3	115312305	115318470	6165	115314893
chr3:116203398-116209426	chr3	116203398	116209426	6028	116205991
chr3:116505420-116508370	chr3	116505420	116508370	2950	116508008
chr3:116922088-116925108	chr3	116922088	116925108	3020	116924589
chr3:118008147-118008851	chr3	118008147	118008851	704	118008262
chr3:119001470-119007490	chr3	119001470	119007490	6020	119004051
chr3:119106586-119112745	chr3	119106586	119112745	6159	119109177
chr3:119563180-119569317	chr3	119563180	119569317	6137	119565759
chr3:120233745-120237323	chr3	120233745	120237323	3578	120235590
chr3:120372615-120378640	chr3	120372615	120378640	6025	120375204
chr3:120732565-120738623	chr3	120732565	120738623	6058	120735132
chr3:120758421-120761786	chr3	120758421	120761786	3365	120761013
chr3:120896203-120902353	chr3	120896203	120902353	6150	120898797
chr3:120973554-120979692	chr3	120973554	120979692	6138	120976132
chr3:121002653-121007122	chr3	121002653	121007122	4469	121005139
chr3:121057983-121064434	chr3	121057983	121064434	6451	121060560
chr3:121090780-121095991	chr3	121090780	121095991	5211	121093360
chr3:121106242-121112620	chr3	121106242	121112620	6378	121108801
chr3:121197489-121201839	chr3	121197489	121201839	4350	121200071
chr3:121211878-121217641	chr3	121211878	121217641	5763	121213801
chr3:121300936-121302659	chr3	121300936	121302659	1723	121302134
chr3:121345956-121351477	chr3	121345956	121351477	5521	121348545
chr3:121351482-121356825	chr3	121351482	121356825	5343	121353270
chr3:121857672-121863828	chr3	121857672	121863828	6156	121860258
chr3:121902360-121908514	chr3	121902360	121908514	6154	121904937
chr3:121932760-121938786	chr3	121932760	121938786	6026	121935352
chr3:122041911-122047938	chr3	122041911	122047938	6027	122044505
chr3:122137076-122143228	chr3	122137076	122143228	6152	122139679
chr3:122836101-122836627	chr3	122836101	122836627	526	122836583
chr3:123849747-123852691	chr3	123849747	123852691	2944	123852317
chr3:126586012-126591777	chr3	126586012	126591777	5765	126588567
chr3:126785838-126791613	chr3	126785838	126791613	5775	126788413
chr3:130160441-130166560	chr3	130160441	130166560	6119	130163028
chr3:130910129-130911599	chr3	130910129	130911599	1470	130911036
chr3:131207592-131212523	chr3	131207592	131212523	4931	131209573
chr3:131263586-131269696	chr3	131263586	131269696	6110	131265802
chr3:131628436-131629146	chr3	131628436	131629146	710	131628485
chr3:131862718-131865356	chr3	131862718	131865356	2638	131865294
chr3:132048856-132054295	chr3	132048856	132054295	5439	132051442
chr3:132371232-132377261	chr3	132371232	132377261	6029	132373823
chr3:132582971-132584711	chr3	132582971	132584711	1740	132583138
chr3:132741144-132747312	chr3	132741144	132747312	6168	132743735
chr3:132760656-132766652	chr3	132760656	132766652	5996	132763230
chr3:132807088-132809933	chr3	132807088	132809933	2845	132809680
chr3:132946006-132952034	chr3	132946006	132952034	6028	132948596
chr3:132999519-133005662	chr3	132999519	133005662	6143	133002098
chr3:133143991-133147359	chr3	133143991	133147359	3368	133146552
chr3:133306371-133309682	chr3	133306371	133309682	3311	133308949
chr3:133723674-133729811	chr3	133723674	133729811	6137	133726245
chr3:134095787-134100273	chr3	134095787	134100273	4486	134098302
chr3:134582192-134587735	chr3	134582192	134587735	5543	134584766
chr3:135002247-135005976	chr3	135002247	135005976	3729	135002546
chr3:135025209-135031249	chr3	135025209	135031249	6040	135027812
chr3:135252214-135258230	chr3	135252214	135258230	6016	135254804
chr3:135281801-135282894	chr3	135281801	135282894	1093	135282498
chr3:135395870-135399881	chr3	135395870	135399881	4011	135398451
chr3:136370367-136374273	chr3	136370367	136374273	3906	136372936
chr3:136479056-136485103	chr3	136479056	136485103	6047	136481668
chr3:136522576-136528385	chr3	136522576	136528385	5809	136525183
chr3:136963693-136969736	chr3	136963693	136969736	6043	136966284
chr3:137001778-137007921	chr3	137001778	137007921	6143	137004353
chr3:137314251-137317873	chr3	137314251	137317873	3622	137316825
chr3:137372109-137377745	chr3	137372109	137377745	5636	137373890
chr3:137390935-137394814	chr3	137390935	137394814	3879	137393516
chr3:137454173-137460983	chr3	137454173	137460983	6810	137457543
chr3:137633714-137639732	chr3	137633714	137639732	6018	137636295
chr3:137951726-137955442	chr3	137951726	137955442	3716	137954315
chr3:139026622-139030860	chr3	139026622	139030860	4238	139029383
chr3:139166503-139172599	chr3	139166503	139172599	6096	139169057
chr3:139190644-139196765	chr3	139190644	139196765	6121	139193231
chr3:139565364-139571485	chr3	139565364	139571485	6121	139567929
chr3:139877463-139883576	chr3	139877463	139883576	6113	139880017
chr3:140042525-140046784	chr3	140042525	140046784	4259	140045118
chr3:140479951-140486093	chr3	140479951	140486093	6142	140482530
chr3:140511808-140514125	chr3	140511808	140514125	2317	140513723
chr3:140797237-140803746	chr3	140797237	140803746	6509	140799847
chr3:141135363-141141479	chr3	141135363	141141479	6116	141137922
chr3:141295540-141301590	chr3	141295540	141301590	6050	141298125
chr3:141757129-141763153	chr3	141757129	141763153	6024	141759744
chr3:142135406-142141502	chr3	142135406	142141502	6096	142137962
chr3:142475105-142481234	chr3	142475105	142481234	6129	142477680
chr3:144260146-144261011	chr3	144260146	144261011	865	144260285
chr3:144372053-144373069	chr3	144372053	144373069	1016	144372198
chr3:144614615-144620769	chr3	144614615	144620769	6154	144617193
chr3:145252617-145258622	chr3	145252617	145258622	6005	145255208
chr3:145459549-145463475	chr3	145459549	145463475	3926	145462138
chr3:145478497-145479995	chr3	145478497	145479995	1498	145479585
chr3:145825445-145828558	chr3	145825445	145828558	3113	145825721
chr3:145874716-145877872	chr3	145874716	145877872	3156	145876623
chr3:146434777-146440623	chr3	146434777	146440623	5846	146437364
chr3:146732760-146736361	chr3	146732760	146736361	3601	146735341
chr3:146940674-146946795	chr3	146940674	146946795	6121	146943265
chr3:146960455-146964337	chr3	146960455	146964337	3882	146963073
chr3:147124205-147130283	chr3	147124205	147130283	6078	147126782
chr3:147205668-147209161	chr3	147205668	147209161	3493	147208249
chr3:147707794-147713608	chr3	147707794	147713608	5814	147709707
chr3:148503864-148507255	chr3	148503864	148507255	3391	148506451
chr3:148558932-148562376	chr3	148558932	148562376	3444	148561510
chr3:148689768-148692997	chr3	148689768	148692997	3229	148692354
chr3:148780637-148786767	chr3	148780637	148786767	6130	148783219
chr3:151569736-151575862	chr3	151569736	151575862	6126	151572308
chr3:152367042-152371316	chr3	152367042	152371316	4274	152369598
chr3:153235756-153241782	chr3	153235756	153241782	6026	153238348
chr3:153415203-153417528	chr3	153415203	153417528	2325	153417263
chr3:153519179-153520670	chr3	153519179	153520670	1491	153519506
chr3:153930272-153932586	chr3	153930272	153932586	2314	153931016
chr3:153983402-153989527	chr3	153983402	153989527	6125	153985989
chr3:153997632-153998528	chr3	153997632	153998528	896	153997977
chr3:154433580-154439720	chr3	154433580	154439720	6140	154436169
chr3:154594101-154597065	chr3	154594101	154597065	2964	154596668
chr3:154819995-154826090	chr3	154819995	154826090	6095	154822568
chr3:155119416-155125444	chr3	155119416	155125444	6028	155122005
chr3:155506351-155512216	chr3	155506351	155512216	5865	155508942
chr3:155998070-156004549	chr3	155998070	156004549	6479	156000639
chr3:156064010-156069199	chr3	156064010	156069199	5189	156065787
chr3:156194778-156198913	chr3	156194778	156198913	4135	156197395
chr3:156278973-156284990	chr3	156278973	156284990	6017	156281553
chr3:156950218-156951913	chr3	156950218	156951913	1695	156951445
chr3:157191028-157194385	chr3	157191028	157194385	3357	157193614
chr3:157798535-157804240	chr3	157798535	157804240	5705	157801109
chr3:158144131-158146886	chr3	158144131	158146886	2755	158146717
chr3:158194496-158198661	chr3	158194496	158198661	4165	158197089
chr3:158324235-158330363	chr3	158324235	158330363	6128	158326817
chr3:158422079-158425797	chr3	158422079	158425797	3718	158424667
chr3:158511108-158517123	chr3	158511108	158517123	6015	158513704
chr3:158985603-158992025	chr3	158985603	158992025	6422	158988175
chr3:159084916-159090338	chr3	159084916	159090338	5422	159087506
chr3:159095379-159101394	chr3	159095379	159101394	6015	159097955
chr3:159231501-159232447	chr3	159231501	159232447	946	159231718
chr3:159382110-159385065	chr3	159382110	159385065	2955	159384697
chr3:159392310-159398352	chr3	159392310	159398352	6042	159394903
chr3:159505478-159511616	chr3	159505478	159511616	6138	159508055
chr3:159569170-159575234	chr3	159569170	159575234	6064	159571714
chr3:159687597-159692013	chr3	159687597	159692013	4416	159690184
chr3:160973877-160977113	chr3	160973877	160977113	3236	160976462
chr3:161001840-161005263	chr3	161001840	161005263	3423	161004428
chr3:161010017-161014225	chr3	161010017	161014225	4208	161012606
chr3:161120828-161121764	chr3	161120828	161121764	936	161121391
chr3:161190315-161196276	chr3	161190315	161196276	5961	161192899
chr3:161748519-161751469	chr3	161748519	161751469	2950	161751110
chr3:162186546-162189785	chr3	162186546	162189785	3239	162189134
chr3:162244131-162247707	chr3	162244131	162247707	3576	162246708
chr3:162379053-162381945	chr3	162379053	162381945	2892	162381645
chr3:162405866-162411893	chr3	162405866	162411893	6027	162408455
chr3:162447715-162450747	chr3	162447715	162450747	3032	162450248
chr3:163146451-163150779	chr3	163146451	163150779	4328	163149065
chr3:163169731-163174397	chr3	163169731	163174397	4666	163171406
chr3:164409706-164413265	chr3	164409706	164413265	3559	164412338
chr3:165471588-165474788	chr3	165471588	165474788	3200	165474183
chr3:165879803-165880718	chr3	165879803	165880718	915	165880024
chr3:166006024-166008873	chr3	166006024	166008873	2849	166008621
chr3:166021102-166027124	chr3	166021102	166027124	6022	166023688
chr3:166626741-166629651	chr3	166626741	166629651	2910	166629318
chr3:166905252-166910085	chr3	166905252	166910085	4833	166906475
chr3:167042728-167044792	chr3	167042728	167044792	2064	167044094
chr3:167388960-167391638	chr3	167388960	167391638	2678	167391573
chr3:168351428-168353078	chr3	168351428	168353078	1650	168351880
chr3:168764449-168770163	chr3	168764449	168770163	5714	168767040
chr3:169005640-169006454	chr3	169005640	169006454	814	169006098
chr3:169716052-169716742	chr3	169716052	169716742	690	169716442
chr3:170616822-170621907	chr3	170616822	170621907	5085	170618224
chr3:170662387-170668526	chr3	170662387	170668526	6139	170664958
chr3:170878556-170884584	chr3	170878556	170884584	6028	170881149
chr3:170924914-170930270	chr3	170924914	170930270	5356	170927516
chr3:170932917-170939072	chr3	170932917	170939072	6155	170935514
chr3:170969788-170975736	chr3	170969788	170975736	5948	170972032
chr3:172491235-172494260	chr3	172491235	172494260	3025	172493837
chr3:172659993-172666110	chr3	172659993	172666110	6117	172662553
chr3:173083494-173087994	chr3	173083494	173087994	4500	173086123
chr3:173446062-173452201	chr3	173446062	173452201	6139	173448650
chr3:173498054-173500747	chr3	173498054	173500747	2693	173500640
chr3:174259685-174265694	chr3	174259685	174265694	6009	174262273
chr3:174829123-174832465	chr3	174829123	174832465	3342	174831696
chr3:175299053-175300740	chr3	175299053	175300740	1687	175300377
chr3:175365869-175368485	chr3	175365869	175368485	2616	175368444
chr3:175781710-175787737	chr3	175781710	175787737	6027	175784291
chr3:175870355-175873377	chr3	175870355	175873377	3022	175872922
chr3:176448155-176454298	chr3	176448155	176454298	6143	176450758
chr3:177388770-177394751	chr3	177388770	177394751	5981	177391362
chr3:177659339-177665319	chr3	177659339	177665319	5980	177661951
chr3:178936859-178942449	chr3	178936859	178942449	5590	178939448
chr3:178983375-178985960	chr3	178983375	178985960	2585	178985928
chr3:179126722-179132866	chr3	179126722	179132866	6144	179129310
chr3:180673946-180675706	chr3	180673946	180675706	1760	180675068
chr3:181000404-181002311	chr3	181000404	181002311	1907	181001086
chr3:181041413-181046904	chr3	181041413	181046904	5491	181043324
chr3:181319256-181325432	chr3	181319256	181325432	6176	181321833
chr3:181585391-181591552	chr3	181585391	181591552	6161	181587975
chr3:182150421-182157170	chr3	182150421	182157170	6749	182153284
chr3:182311874-182312520	chr3	182311874	182312520	646	182312172
chr3:183234696-183238141	chr3	183234696	183238141	3445	183237288
chr3:186903540-186910007	chr3	186903540	186910007	6467	186906102
chr3:187424407-187428816	chr3	187424407	187428816	4409	187426998
chr3:188372709-188378861	chr3	188372709	188378861	6152	188375295
chr3:188966082-188967846	chr3	188966082	188967846	1764	188967649
chr3:189017229-189025537	chr3	189017229	189025537	8308	189019820
chr3:189253049-189259453	chr3	189253049	189259453	6404	189255611
chr3:191010541-191016561	chr3	191010541	191016561	6020	191013131
chr3:192149315-192155328	chr3	192149315	192155328	6013	192151905
chr3:192739213-192745242	chr3	192739213	192745242	6029	192741803
chr3:192961457-192965642	chr3	192961457	192965642	4185	192962215
chr3:192965839-192970719	chr3	192965839	192970719	4880	192968449
chr3:193336237-193339430	chr3	193336237	193339430	3193	193338822
chr3_GL000221v1_random:88277-93436	chr3_GL000221v1_random	88277	93436	5159	90814
chr3_GL000221v1_random:132976-139105	chr3_GL000221v1_random	132976	139105	6129	135564
chr3_KI270777v1_alt:13318-19437	chr3_KI270777v1_alt	13318	19437	6119	15900
chr3_KI270782v1_alt:144227-150356	chr3_KI270782v1_alt	144227	150356	6129	146812
chr3_KI270783v1_alt:80337-85833	chr3_KI270783v1_alt	80337	85833	5496	82923
chr4:37397-39412	chr4	37397	39412	2015	37929
chr4:165848-171989	chr4	165848	171989	6141	168439
chr4:182731-187214	chr4	182731	187214	4483	184600
chr4:363771-364600	chr4	363771	364600	829	364279
chr4:2026515-2029172	chr4	2026515	2029172	2657	2029099
chr4:3160920-3167073	chr4	3160920	3167073	6153	3163514
chr4:4013498-4019703	chr4	4013498	4019703	6205	4016066
chr4:4953897-4959919	chr4	4953897	4959919	6022	4956478
chr4:4996517-5002158	chr4	4996517	5002158	5641	4998965
chr4:5170295-5176435	chr4	5170295	5176435	6140	5172897
chr4:5241574-5247720	chr4	5241574	5247720	6146	5244167
chr4:5332498-5335941	chr4	5332498	5335941	3443	5335065
chr4:5438601-5444628	chr4	5438601	5444628	6027	5441193
chr4:5480586-5486704	chr4	5480586	5486704	6118	5483175
chr4:5490577-5496698	chr4	5490577	5496698	6121	5493167
chr4:5761914-5767928	chr4	5761914	5767928	6014	5764490
chr4:10423436-10428533	chr4	10423436	10428533	5097	10424690
chr4:10775393-10781420	chr4	10775393	10781420	6027	10777984
chr4:10824426-10829322	chr4	10824426	10829322	4896	10825886
chr4:11060915-11066938	chr4	11060915	11066938	6023	11063504
chr4:11143617-11149641	chr4	11143617	11149641	6024	11146211
chr4:11168170-11171814	chr4	11168170	11171814	3644	11170765
chr4:11378740-11384770	chr4	11378740	11384770	6030	11381332
chr4:11578358-11583535	chr4	11578358	11583535	5177	11579965
chr4:11960086-11963210	chr4	11960086	11963210	3124	11961866
chr4:12155171-12160093	chr4	12155171	12160093	4922	12157728
chr4:13661252-13664468	chr4	13661252	13664468	3216	13663827
chr4:13739807-13745828	chr4	13739807	13745828	6021	13741990
chr4:14009454-14015486	chr4	14009454	14015486	6032	14012046
chr4:14207099-14213244	chr4	14207099	14213244	6145	14209686
chr4:14420552-14426660	chr4	14420552	14426660	6108	14423128
chr4:14471194-14474545	chr4	14471194	14474545	3351	14473774
chr4:14660296-14666326	chr4	14660296	14666326	6030	14662887
chr4:16367300-16372841	chr4	16367300	16372841	5541	16369868
chr4:16402379-16408540	chr4	16402379	16408540	6161	16404978
chr4:18548190-18549767	chr4	18548190	18549767	1577	18549504
chr4:18597128-18603273	chr4	18597128	18603273	6145	18599712
chr4:19077911-19083929	chr4	19077911	19083929	6018	19080491
chr4:19334653-19337576	chr4	19334653	19337576	2923	19337244
chr4:19338619-19340587	chr4	19338619	19340587	1968	19339873
chr4:19862802-19868968	chr4	19862802	19868968	6166	19865379
chr4:19915677-19920142	chr4	19915677	19920142	4465	19918260
chr4:20668669-20671518	chr4	20668669	20671518	2849	20671259
chr4:20716348-20722473	chr4	20716348	20722473	6125	20718918
chr4:21071647-21076284	chr4	21071647	21076284	4637	21074225
chr4:21103586-21109754	chr4	21103586	21109754	6168	21106184
chr4:21267371-21268066	chr4	21267371	21268066	695	21267937
chr4:22034847-22039154	chr4	22034847	22039154	4307	22037430
chr4:22193186-22194644	chr4	22193186	22194644	1458	22194282
chr4:22377321-22379487	chr4	22377321	22379487	2166	22378723
chr4:22886151-22892298	chr4	22886151	22892298	6147	22888744
chr4:23176209-23176633	chr4	23176209	23176633	424	23176244
chr4:23641744-23647772	chr4	23641744	23647772	6028	23644334
chr4:26543806-26547055	chr4	26543806	26547055	3249	26546393
chr4:26649711-26652407	chr4	26649711	26652407	2696	26652301
chr4:26970253-26976379	chr4	26970253	26976379	6126	26972828
chr4:27070203-27076264	chr4	27070203	27076264	6061	27072825
chr4:27228880-27232367	chr4	27228880	27232367	3487	27231467
chr4:27375687-27381719	chr4	27375687	27381719	6032	27378279
chr4:29821750-29823570	chr4	29821750	29823570	1820	29823326
chr4:29872124-29874898	chr4	29872124	29874898	2774	29874793
chr4:30046397-30046829	chr4	30046397	30046829	432	30046424
chr4:32360575-32366580	chr4	32360575	32366580	6005	32363140
chr4:34622245-34625912	chr4	34622245	34625912	3667	34624832
chr4:35632257-35632762	chr4	35632257	35632762	505	35632463
chr4:35676843-35681160	chr4	35676843	35681160	4317	35679430
chr4:35830418-35831867	chr4	35830418	35831867	1449	35831705
chr4:36434095-36440248	chr4	36434095	36440248	6153	36436686
chr4:36802527-36805373	chr4	36802527	36805373	2846	36805084
chr4:37103058-37104399	chr4	37103058	37104399	1341	37103742
chr4:37310632-37313612	chr4	37310632	37313612	2980	37313216
chr4:37938536-37942537	chr4	37938536	37942537	4001	37941111
chr4:38432186-38438652	chr4	38432186	38438652	6466	38434785
chr4:38442787-38448926	chr4	38442787	38448926	6139	38445379
chr4:39671161-39673151	chr4	39671161	39673151	1990	39673051
chr4:40764086-40767616	chr4	40764086	40767616	3530	40766670
chr4:41270421-41276554	chr4	41270421	41276554	6133	41273017
chr4:41900582-41905565	chr4	41900582	41905565	4983	41903195
chr4:42696300-42702436	chr4	42696300	42702436	6136	42698875
chr4:42790831-42792140	chr4	42790831	42792140	1309	42791818
chr4:43574929-43575020	chr4	43574929	43575020	91	43574956
chr4:43611655-43614627	chr4	43611655	43614627	2972	43614239
chr4:43721364-43724140	chr4	43721364	43724140	2776	43723200
chr4:43742980-43744843	chr4	43742980	43744843	1863	43744297
chr4:43856825-43860192	chr4	43856825	43860192	3367	43859409
chr4:44300715-44303514	chr4	44300715	44303514	2799	44303307
chr4:45105249-45109192	chr4	45105249	45109192	3943	45107703
chr4:45169933-45171064	chr4	45169933	45171064	1131	45170127
chr4:46165569-46166428	chr4	46165569	46166428	859	46166309
chr4:46662823-46666336	chr4	46662823	46666336	3513	46664742
chr4:46724604-46725871	chr4	46724604	46725871	1267	46725053
chr4:46751788-46753372	chr4	46751788	46753372	1584	46753005
chr4:47078941-47079476	chr4	47078941	47079476	535	47079200
chr4:47241887-47244651	chr4	47241887	47244651	2764	47244471
chr4:48051954-48057974	chr4	48051954	48057974	6020	48054546
chr4:48864580-48870732	chr4	48864580	48870732	6152	48867169
chr4:48886342-48889338	chr4	48886342	48889338	2996	48888925
chr4:48917870-48923851	chr4	48917870	48923851	5981	48920447
chr4:49169833-49175964	chr4	49169833	49175964	6131	49172397
chr4:51935074-51941089	chr4	51935074	51941089	6015	51937667
chr4:51947509-51953366	chr4	51947509	51953366	5857	51950081
chr4:51985080-51990530	chr4	51985080	51990530	5450	51986994
chr4:52086264-52092676	chr4	52086264	52092676	6412	52088870
chr4:52119227-52123104	chr4	52119227	52123104	3877	52119568
chr4:52165191-52171337	chr4	52165191	52171337	6146	52167799
chr4:52213154-52218184	chr4	52213154	52218184	5030	52215738
chr4:52218222-52222263	chr4	52218222	52222263	4041	52220810
chr4:52275193-52277177	chr4	52275193	52277177	1984	52277030
chr4:52319788-52325813	chr4	52319788	52325813	6025	52322375
chr4:52441976-52446283	chr4	52441976	52446283	4307	52444562
chr4:52454796-52458690	chr4	52454796	52458690	3894	52455141
chr4:52499401-52504885	chr4	52499401	52504885	5484	52501946
chr4:52768173-52774291	chr4	52768173	52774291	6118	52770743
chr4:52895176-52901291	chr4	52895176	52901291	6115	52897743
chr4:53095723-53098569	chr4	53095723	53098569	2846	53098304
chr4:53213660-53219784	chr4	53213660	53219784	6124	53216234
chr4:53404014-53410137	chr4	53404014	53410137	6123	53406597
chr4:53663792-53670275	chr4	53663792	53670275	6483	53666397
chr4:53823629-53829782	chr4	53823629	53829782	6153	53826222
chr4:55057736-55059591	chr4	55057736	55059591	1855	55058144
chr4:55164275-55170237	chr4	55164275	55170237	5962	55166645
chr4:55230999-55234934	chr4	55230999	55234934	3935	55233206
chr4:56073512-56075557	chr4	56073512	56075557	2045	56075274
chr4:56331254-56337382	chr4	56331254	56337382	6128	56333834
chr4:57295411-57299054	chr4	57295411	57299054	3643	57297984
chr4:57467408-57470456	chr4	57467408	57470456	3048	57469986
chr4:57531853-57537985	chr4	57531853	57537985	6132	57534442
chr4:57555751-57558569	chr4	57555751	57558569	2818	57558328
chr4:57562316-57568347	chr4	57562316	57568347	6031	57564907
chr4:57619337-57625277	chr4	57619337	57625277	5940	57621916
chr4:57743822-57748318	chr4	57743822	57748318	4496	57745328
chr4:57894739-57899612	chr4	57894739	57899612	4873	57897323
chr4:58023275-58026295	chr4	58023275	58026295	3020	58025867
chr4:58579631-58585744	chr4	58579631	58585744	6113	58582199
chr4:58849941-58851206	chr4	58849941	58851206	1265	58850056
chr4:59112203-59114093	chr4	59112203	59114093	1890	59112353
chr4:59301001-59303250	chr4	59301001	59303250	2249	59301830
chr4:59717560-59720219	chr4	59717560	59720219	2659	59720152
chr4:60046051-60051023	chr4	60046051	60051023	4972	60048639
chr4:60150470-60156414	chr4	60150470	60156414	5944	60152998
chr4:60269025-60272016	chr4	60269025	60272016	2991	60271616
chr4:60286940-60288101	chr4	60286940	60288101	1161	60287959
chr4:60413392-60419841	chr4	60413392	60419841	6449	60415974
chr4:60626253-60629461	chr4	60626253	60629461	3208	60628942
chr4:60731759-60736434	chr4	60731759	60736434	4675	60734345
chr4:60831273-60837284	chr4	60831273	60837284	6011	60833863
chr4:60972055-60976048	chr4	60972055	60976048	3993	60974640
chr4:61104163-61107041	chr4	61104163	61107041	2878	61106744
chr4:61367239-61373248	chr4	61367239	61373248	6009	61369817
chr4:61641294-61647303	chr4	61641294	61647303	6009	61643877
chr4:61754618-61760805	chr4	61754618	61760805	6187	61757208
chr4:61939927-61945962	chr4	61939927	61945962	6035	61942521
chr4:62088338-62094802	chr4	62088338	62094802	6464	62090885
chr4:62726948-62732969	chr4	62726948	62732969	6021	62729537
chr4:63178834-63182139	chr4	63178834	63182139	3305	63181431
chr4:63213489-63217287	chr4	63213489	63217287	3798	63216115
chr4:63244989-63250959	chr4	63244989	63250959	5970	63247564
chr4:63570577-63572598	chr4	63570577	63572598	2021	63572255
chr4:63948074-63953638	chr4	63948074	63953638	5564	63950665
chr4:64237440-64239520	chr4	64237440	64239520	2080	64238364
chr4:64335816-64337123	chr4	64335816	64337123	1307	64336100
chr4:64859153-64865171	chr4	64859153	64865171	6018	64861732
chr4:64992964-64996528	chr4	64992964	64996528	3564	64995552
chr4:65052166-65058198	chr4	65052166	65058198	6032	65054752
chr4:65288237-65294261	chr4	65288237	65294261	6024	65290824
chr4:65767410-65770184	chr4	65767410	65770184	2774	65768730
chr4:65993299-65999302	chr4	65993299	65999302	6003	65995889
chr4:66254274-66258350	chr4	66254274	66258350	4076	66256859
chr4:66400605-66402040	chr4	66400605	66402040	1435	66401738
chr4:66457335-66463478	chr4	66457335	66463478	6143	66459912
chr4:66984464-66986509	chr4	66984464	66986509	2045	66985758
chr4:67062389-67068523	chr4	67062389	67068523	6134	67064957
chr4:67096090-67097998	chr4	67096090	67097998	1908	67097328
chr4:67173792-67176407	chr4	67173792	67176407	2615	67176122
chr4:67253098-67255234	chr4	67253098	67255234	2136	67255188
chr4:67294850-67301125	chr4	67294850	67301125	6275	67297430
chr4:67409222-67410537	chr4	67409222	67410537	1315	67409282
chr4:67967414-67973442	chr4	67967414	67973442	6028	67970004
chr4:68509804-68515820	chr4	68509804	68515820	6016	68512396
chr4:68530433-68536663	chr4	68530433	68536663	6230	68533031
chr4:68641689-68646386	chr4	68641689	68646386	4697	68642816
chr4:68677498-68683661	chr4	68677498	68683661	6163	68680090
chr4:68768212-68774369	chr4	68768212	68774369	6157	68770800
chr4:69075790-69078481	chr4	69075790	69078481	2691	69078385
chr4:69183354-69187165	chr4	69183354	69187165	3811	69185927
chr4:69694104-69696885	chr4	69694104	69696885	2781	69696688
chr4:69927149-69929799	chr4	69927149	69929799	2650	69929737
chr4:70015396-70019676	chr4	70015396	70019676	4280	70016236
chr4:70207215-70213358	chr4	70207215	70213358	6143	70209781
chr4:70417906-70424057	chr4	70417906	70424057	6151	70420494
chr4:70431750-70437856	chr4	70431750	70437856	6106	70434308
chr4:71053846-71059857	chr4	71053846	71059857	6011	71056420
chr4:71084405-71090496	chr4	71084405	71090496	6091	71086993
chr4:71142955-71146702	chr4	71142955	71146702	3747	71145535
chr4:71573377-71576056	chr4	71573377	71576056	2679	71575891
chr4:71716462-71720245	chr4	71716462	71720245	3783	71719018
chr4:71791666-71797803	chr4	71791666	71797803	6137	71794244
chr4:72138262-72142298	chr4	72138262	72142298	4036	72140850
chr4:72163776-72169919	chr4	72163776	72169919	6143	72166363
chr4:72230867-72237005	chr4	72230867	72237005	6138	72233457
chr4:72514834-72520993	chr4	72514834	72520993	6159	72517424
chr4:72633207-72637490	chr4	72633207	72637490	4283	72633928
chr4:72835504-72841662	chr4	72835504	72841662	6158	72838126
chr4:72878788-72884866	chr4	72878788	72884866	6078	72881355
chr4:73512879-73518974	chr4	73512879	73518974	6095	73515416
chr4:74245481-74250213	chr4	74245481	74250213	4732	74248068
chr4:74707978-74714418	chr4	74707978	74714418	6440	74710550
chr4:74717539-74723587	chr4	74717539	74723587	6048	74720147
chr4:74784259-74785551	chr4	74784259	74785551	1292	74785013
chr4:75074258-75080389	chr4	75074258	75080389	6131	75076819
chr4:75198981-75202612	chr4	75198981	75202612	3631	75201572
chr4:75215015-75221174	chr4	75215015	75221174	6159	75217595
chr4:75270579-75276607	chr4	75270579	75276607	6028	75273170
chr4:75291666-75295542	chr4	75291666	75295542	3876	75294235
chr4:75387765-75391597	chr4	75387765	75391597	3832	75390355
chr4:75415866-75418532	chr4	75415866	75418532	2666	75418491
chr4:75442536-75448552	chr4	75442536	75448552	6016	75445123
chr4:77295521-77298434	chr4	77295521	77298434	2913	77298060
chr4:77321655-77327742	chr4	77321655	77327742	6087	77324213
chr4:77338062-77342150	chr4	77338062	77342150	4088	77340647
chr4:77458616-77464738	chr4	77458616	77464738	6122	77461186
chr4:77513826-77519354	chr4	77513826	77519354	5528	77516395
chr4:77519420-77522514	chr4	77519420	77522514	3094	77521304
chr4:77527779-77531098	chr4	77527779	77531098	3319	77530364
chr4:77543745-77548057	chr4	77543745	77548057	4312	77546336
chr4:78112832-78118967	chr4	78112832	78118967	6135	78115417
chr4:78121980-78125572	chr4	78121980	78125572	3592	78124561
chr4:78192050-78195922	chr4	78192050	78195922	3872	78192369
chr4:78271318-78277463	chr4	78271318	78277463	6145	78273902
chr4:78301853-78307882	chr4	78301853	78307882	6029	78304453
chr4:78976438-78982589	chr4	78976438	78982589	6151	78979016
chr4:79220696-79222324	chr4	79220696	79222324	1628	79221963
chr4:80396626-80397601	chr4	80396626	80397601	975	80396968
chr4:80669983-80676175	chr4	80669983	80676175	6192	80672592
chr4:80855406-80861562	chr4	80855406	80861562	6156	80857995
chr4:81125878-81130097	chr4	81125878	81130097	4219	81128419
chr4:81931746-81937925	chr4	81931746	81937925	6179	81934363
chr4:82297535-82303686	chr4	82297535	82303686	6151	82300122
chr4:82658713-82659810	chr4	82658713	82659810	1097	82658922
chr4:83952175-83958205	chr4	83952175	83958205	6030	83954769
chr4:84115556-84116858	chr4	84115556	84116858	1302	84116120
chr4:84758852-84761557	chr4	84758852	84761557	2705	84760392
chr4:84980694-84984109	chr4	84980694	84984109	3415	84983265
chr4:85130580-85134021	chr4	85130580	85134021	3441	85132837
chr4:85136619-85139034	chr4	85136619	85139034	2415	85138137
chr4:85189015-85193303	chr4	85189015	85193303	4288	85191595
chr4:85500717-85506879	chr4	85500717	85506879	6162	85503305
chr4:85622099-85628225	chr4	85622099	85628225	6126	85624674
chr4:85661518-85667643	chr4	85661518	85667643	6125	85664099
chr4:85848602-85853614	chr4	85848602	85853614	5012	85850036
chr4:85891217-85893779	chr4	85891217	85893779	2562	85891948
chr4:86070390-86076419	chr4	86070390	86076419	6029	86072981
chr4:86251145-86254837	chr4	86251145	86254837	3692	86253762
chr4:86407903-86414047	chr4	86407903	86414047	6144	86410490
chr4:86724817-86728643	chr4	86724817	86728643	3826	86727401
chr4:87347103-87353146	chr4	87347103	87353146	6043	87349707
chr4:87483088-87486888	chr4	87483088	87486888	3800	87485653
chr4:89084494-89088052	chr4	89084494	89088052	3558	89086696
chr4:89093190-89094039	chr4	89093190	89094039	849	89093314
chr4:90152884-90159024	chr4	90152884	90159024	6140	90155467
chr4:90203197-90207226	chr4	90203197	90207226	4029	90205785
chr4:90296300-90298777	chr4	90296300	90298777	2477	90298081
chr4:90479376-90485523	chr4	90479376	90485523	6147	90481959
chr4:90489524-90492941	chr4	90489524	90492941	3417	90492105
chr4:90675739-90681757	chr4	90675739	90681757	6018	90678318
chr4:90699987-90706061	chr4	90699987	90706061	6074	90702560
chr4:91148485-91152428	chr4	91148485	91152428	3943	91151057
chr4:91159902-91166068	chr4	91159902	91166068	6166	91162518
chr4:91174822-91180682	chr4	91174822	91180682	5860	91177407
chr4:91376761-91382855	chr4	91376761	91382855	6094	91379339
chr4:91401404-91405251	chr4	91401404	91405251	3847	91403984
chr4:91520892-91523931	chr4	91520892	91523931	3039	91523462
chr4:91786026-91792049	chr4	91786026	91792049	6023	91788616
chr4:91858348-91864459	chr4	91858348	91864459	6111	91860915
chr4:92115958-92118928	chr4	92115958	92118928	2970	92118554
chr4:92199402-92203426	chr4	92199402	92203426	4024	92201983
chr4:92250039-92252822	chr4	92250039	92252822	2783	92252616
chr4:92916365-92922491	chr4	92916365	92922491	6126	92918939
chr4:92938563-92944694	chr4	92938563	92944694	6131	92941156
chr4:93322046-93325950	chr4	93322046	93325950	3904	93324624
chr4:93589053-93595080	chr4	93589053	93595080	6027	93591644
chr4:93608283-93614338	chr4	93608283	93614338	6055	93610902
chr4:93638307-93644337	chr4	93638307	93644337	6030	93640899
chr4:93724986-93729081	chr4	93724986	93729081	4095	93727574
chr4:93927898-93933213	chr4	93927898	93933213	5315	93929495
chr4:94144318-94148665	chr4	94144318	94148665	4347	94145056
chr4:94309125-94315291	chr4	94309125	94315291	6166	94311726
chr4:94319767-94325921	chr4	94319767	94325921	6154	94322350
chr4:94835758-94841785	chr4	94835758	94841785	6027	94838347
chr4:95133878-95140064	chr4	95133878	95140064	6186	95136498
chr4:95171232-95177256	chr4	95171232	95177256	6024	95173829
chr4:95711024-95714474	chr4	95711024	95714474	3450	95713595
chr4:96409195-96415225	chr4	96409195	96415225	6030	96411785
chr4:96575890-96580225	chr4	96575890	96580225	4335	96578481
chr4:96869181-96872786	chr4	96869181	96872786	3605	96871768
chr4:97254605-97258543	chr4	97254605	97258543	3938	97257185
chr4:97397399-97401127	chr4	97397399	97401127	3728	97399891
chr4:97427562-97430504	chr4	97427562	97430504	2942	97430156
chr4:97560897-97566581	chr4	97560897	97566581	5684	97563030
chr4:97795198-97801329	chr4	97795198	97801329	6131	97797775
chr4:97932358-97938918	chr4	97932358	97938918	6560	97934944
chr4:98010960-98013580	chr4	98010960	98013580	2620	98013534
chr4:98018021-98024143	chr4	98018021	98024143	6122	98020606
chr4:98122019-98126696	chr4	98122019	98126696	4677	98122769
chr4:98279624-98283007	chr4	98279624	98283007	3383	98282197
chr4:98532177-98533543	chr4	98532177	98533543	1366	98533277
chr4:98592435-98598463	chr4	98592435	98598463	6028	98595027
chr4:99093950-99099992	chr4	99093950	99099992	6042	99096523
chr4:99114079-99117819	chr4	99114079	99117819	3740	99114252
chr4:99170824-99176431	chr4	99170824	99176431	5607	99173313
chr4:99227147-99231611	chr4	99227147	99231611	4464	99229703
chr4:99242229-99248672	chr4	99242229	99248672	6443	99244812
chr4:99257461-99260550	chr4	99257461	99260550	3089	99260062
chr4:99765432-99771462	chr4	99765432	99771462	6030	99768028
chr4:99792655-99798764	chr4	99792655	99798764	6109	99795228
chr4:100000524-100006553	chr4	100000524	100006553	6029	100003116
chr4:100043522-100049475	chr4	100043522	100049475	5953	100046114
chr4:100154084-100157166	chr4	100154084	100157166	3082	100156669
chr4:100666937-100669356	chr4	100666937	100669356	2419	100668531
chr4:101405667-101411695	chr4	101405667	101411695	6028	101408254
chr4:101453861-101457889	chr4	101453861	101457889	4028	101456436
chr4:101506911-101510421	chr4	101506911	101510421	3510	101509502
chr4:102204930-102210958	chr4	102204930	102210958	6028	102207518
chr4:102373765-102374743	chr4	102373765	102374743	978	102374428
chr4:102374729-102380899	chr4	102374729	102380899	6170	102377340
chr4:102697355-102702634	chr4	102697355	102702634	5279	102699946
chr4:103250265-103256290	chr4	103250265	103256290	6025	103252855
chr4:103597457-103603496	chr4	103597457	103603496	6039	103600043
chr4:103826440-103831975	chr4	103826440	103831975	5535	103829032
chr4:104134044-104137640	chr4	104134044	104137640	3596	104136515
chr4:104199749-104202169	chr4	104199749	104202169	2420	104200102
chr4:104321484-104327628	chr4	104321484	104327628	6144	104324072
chr4:104562130-104568630	chr4	104562130	104568630	6500	104564760
chr4:104687024-104692901	chr4	104687024	104692901	5877	104689475
chr4:105009025-105010052	chr4	105009025	105010052	1027	105009656
chr4:105080084-105083726	chr4	105080084	105083726	3642	105082669
chr4:105307236-105313391	chr4	105307236	105313391	6155	105309827
chr4:105729743-105735830	chr4	105729743	105735830	6087	105732279
chr4:105770372-105776797	chr4	105770372	105776797	6425	105772945
chr4:105852124-105856152	chr4	105852124	105856152	4028	105854683
chr4:105980442-105985120	chr4	105980442	105985120	4678	105981648
chr4:106402467-106408593	chr4	106402467	106408593	6126	106405038
chr4:106465569-106472049	chr4	106465569	106472049	6480	106468140
chr4:106535100-106541246	chr4	106535100	106541246	6146	106537695
chr4:106558088-106564232	chr4	106558088	106564232	6144	106560680
chr4:106571057-106577070	chr4	106571057	106577070	6013	106573633
chr4:106638222-106639953	chr4	106638222	106639953	1731	106639315
chr4:106710383-106713844	chr4	106710383	106713844	3461	106712966
chr4:106882613-106883489	chr4	106882613	106883489	876	106883033
chr4:106972745-106979025	chr4	106972745	106979025	6280	106975330
chr4:107206672-107210557	chr4	107206672	107210557	3885	107209260
chr4:108435420-108441589	chr4	108435420	108441589	6169	108438011
chr4:109140243-109144596	chr4	109140243	109144596	4353	109141522
chr4:109582573-109587597	chr4	109582573	109587597	5024	109584037
chr4:109852610-109855910	chr4	109852610	109855910	3300	109855127
chr4:109894299-109900438	chr4	109894299	109900438	6139	109896889
chr4:109934344-109939674	chr4	109934344	109939674	5330	109936134
chr4:110321835-110327953	chr4	110321835	110327953	6118	110324409
chr4:110385722-110391030	chr4	110385722	110391030	5308	110388312
chr4:110405849-110409694	chr4	110405849	110409694	3845	110408441
chr4:110426196-110432628	chr4	110426196	110432628	6432	110428777
chr4:110687459-110693684	chr4	110687459	110693684	6225	110690251
chr4:110757482-110763634	chr4	110757482	110763634	6152	110760070
chr4:110870809-110876821	chr4	110870809	110876821	6012	110873388
chr4:111094643-111100776	chr4	111094643	111100776	6133	111097229
chr4:111147045-111153196	chr4	111147045	111153196	6151	111149631
chr4:111247766-111251572	chr4	111247766	111251572	3806	111250361
chr4:111557951-111559315	chr4	111557951	111559315	1364	111559175
chr4:111949204-111952083	chr4	111949204	111952083	2879	111951761
chr4:112303775-112309667	chr4	112303775	112309667	5892	112306337
chr4:113266888-113269091	chr4	113266888	113269091	2203	113268836
chr4:113424514-113430701	chr4	113424514	113430701	6187	113427103
chr4:113489138-113495167	chr4	113489138	113495167	6029	113491729
chr4:114424208-114429586	chr4	114424208	114429586	5378	114426329
chr4:114525867-114526659	chr4	114525867	114526659	792	114526550
chr4:114834611-114837333	chr4	114834611	114837333	2722	114834701
chr4:115349647-115356146	chr4	115349647	115356146	6499	115352224
chr4:115446635-115452847	chr4	115446635	115452847	6212	115449206
chr4:115651798-115655039	chr4	115651798	115655039	3241	115652765
chr4:115704982-115707922	chr4	115704982	115707922	2940	115707656
chr4:116079604-116081444	chr4	116079604	116081444	1840	116081104
chr4:116251913-116258029	chr4	116251913	116258029	6116	116254497
chr4:116775043-116781055	chr4	116775043	116781055	6012	116777629
chr4:117111129-117111791	chr4	117111129	117111791	662	117111519
chr4:117272569-117273483	chr4	117272569	117273483	914	117272901
chr4:117518427-117521068	chr4	117518427	117521068	2641	117519690
chr4:117655484-117659090	chr4	117655484	117659090	3606	117658074
chr4:117666663-117671121	chr4	117666663	117671121	4458	117669237
chr4:117680157-117685274	chr4	117680157	117685274	5117	117682736
chr4:118777126-118780907	chr4	118777126	118780907	3781	118779691
chr4:119061901-119068062	chr4	119061901	119068062	6161	119064492
chr4:119251686-119255882	chr4	119251686	119255882	4196	119252321
chr4:119274113-119280127	chr4	119274113	119280127	6014	119276687
chr4:119324267-119327261	chr4	119324267	119327261	2994	119326853
chr4:119380942-119386254	chr4	119380942	119386254	5312	119383238
chr4:119948726-119954758	chr4	119948726	119954758	6032	119951318
chr4:120250735-120256048	chr4	120250735	120256048	5313	120253325
chr4:120530402-120534177	chr4	120530402	120534177	3775	120532972
chr4:120984728-120991156	chr4	120984728	120991156	6428	120987300
chr4:120996062-121002150	chr4	120996062	121002150	6088	120998631
chr4:121544696-121548493	chr4	121544696	121548493	3797	121547274
chr4:122459775-122465995	chr4	122459775	122465995	6220	122462437
chr4:122569177-122575328	chr4	122569177	122575328	6151	122571769
chr4:122652658-122656850	chr4	122652658	122656850	4192	122655250
chr4:122939633-122945796	chr4	122939633	122945796	6163	122942221
chr4:122998313-123004460	chr4	122998313	123004460	6147	123000892
chr4:123224211-123228380	chr4	123224211	123228380	4169	123226798
chr4:123633277-123639076	chr4	123633277	123639076	5799	123635858
chr4:124039635-124045972	chr4	124039635	124045972	6337	124042227
chr4:124125825-124131963	chr4	124125825	124131963	6138	124128401
chr4:124269373-124274981	chr4	124269373	124274981	5608	124271954
chr4:124391468-124395394	chr4	124391468	124395394	3926	124394060
chr4:124611937-124618085	chr4	124611937	124618085	6148	124614527
chr4:125255659-125259401	chr4	125255659	125259401	3742	125258246
chr4:125803744-125806468	chr4	125803744	125806468	2724	125806356
chr4:126204779-126207554	chr4	126204779	126207554	2775	126207356
chr4:126378099-126381855	chr4	126378099	126381855	3756	126378944
chr4:126860856-126867000	chr4	126860856	126867000	6144	126863442
chr4:127062560-127068603	chr4	127062560	127068603	6043	127065170
chr4:127262326-127265233	chr4	127262326	127265233	2907	127263672
chr4:127458138-127464612	chr4	127458138	127464612	6474	127460709
chr4:127650220-127656245	chr4	127650220	127656245	6025	127652809
chr4:127899755-127905623	chr4	127899755	127905623	5868	127902097
chr4:128431506-128437643	chr4	128431506	128437643	6137	128434094
chr4:129049721-129053557	chr4	129049721	129053557	3836	129052312
chr4:129121171-129126977	chr4	129121171	129126977	5806	129123124
chr4:129181606-129185782	chr4	129181606	129185782	4176	129184183
chr4:129295360-129298327	chr4	129295360	129298327	2967	129297965
chr4:129715499-129721626	chr4	129715499	129721626	6127	129718072
chr4:129870738-129876882	chr4	129870738	129876882	6144	129873331
chr4:129877924-129881026	chr4	129877924	129881026	3102	129880500
chr4:129943062-129948448	chr4	129943062	129948448	5386	129944538
chr4:130015897-130018952	chr4	130015897	130018952	3055	130018476
chr4:130046202-130052342	chr4	130046202	130052342	6140	130048788
chr4:130436820-130443019	chr4	130436820	130443019	6199	130439438
chr4:131397654-131404013	chr4	131397654	131404013	6359	131400200
chr4:131454759-131456476	chr4	131454759	131456476	1717	131456439
chr4:132631286-132637304	chr4	132631286	132637304	6018	132633867
chr4:133685178-133691033	chr4	133685178	133691033	5855	133687766
chr4:133733942-133739952	chr4	133733942	133739952	6010	133736522
chr4:134037071-134039834	chr4	134037071	134039834	2763	134038410
chr4:134783525-134787062	chr4	134783525	134787062	3537	134783763
chr4:134923018-134929206	chr4	134923018	134929206	6188	134925602
chr4:135074471-135079082	chr4	135074471	135079082	4611	135077233
chr4:135079464-135083851	chr4	135079464	135083851	4387	135080490
chr4:135178140-135183747	chr4	135178140	135183747	5607	135180316
chr4:135374860-135381291	chr4	135374860	135381291	6431	135377488
chr4:135467974-135474423	chr4	135467974	135474423	6449	135470535
chr4:135623952-135627296	chr4	135623952	135627296	3344	135626512
chr4:135747791-135750766	chr4	135747791	135750766	2975	135750411
chr4:135872775-135873732	chr4	135872775	135873732	957	135873012
chr4:136293494-136299546	chr4	136293494	136299546	6052	136296109
chr4:137567142-137573518	chr4	137567142	137573518	6376	137569656
chr4:137913010-137915637	chr4	137913010	137915637	2627	137915587
chr4:138504301-138506306	chr4	138504301	138506306	2005	138505061
chr4:138779670-138785700	chr4	138779670	138785700	6030	138782208
chr4:138881278-138887439	chr4	138881278	138887439	6161	138883865
chr4:140782680-140788847	chr4	140782680	140788847	6167	140785257
chr4:140820370-140826494	chr4	140820370	140826494	6124	140822956
chr4:141068388-141070073	chr4	141068388	141070073	1685	141069648
chr4:141184893-141186388	chr4	141184893	141186388	1495	141186119
chr4:141362420-141366705	chr4	141362420	141366705	4285	141364989
chr4:141490733-141491880	chr4	141490733	141491880	1147	141490808
chr4:141503846-141510060	chr4	141503846	141510060	6214	141506477
chr4:141877346-141883376	chr4	141877346	141883376	6030	141879937
chr4:141987107-141992707	chr4	141987107	141992707	5600	141989605
chr4:142246147-142247795	chr4	142246147	142247795	1648	142247381
chr4:142627167-142628039	chr4	142627167	142628039	872	142627840
chr4:143445791-143449910	chr4	143445791	143449910	4119	143448379
chr4:143588242-143594376	chr4	143588242	143594376	6134	143590826
chr4:143659114-143665240	chr4	143659114	143665240	6126	143661677
chr4:143891889-143894581	chr4	143891889	143894581	2692	143891898
chr4:144147928-144154054	chr4	144147928	144154054	6126	144150502
chr4:144237349-144240120	chr4	144237349	144240120	2771	144239959
chr4:144245684-144249634	chr4	144245684	144249634	3950	144247065
chr4:144956610-144961308	chr4	144956610	144961308	4698	144959180
chr4:144985849-144986544	chr4	144985849	144986544	695	144986335
chr4:145223100-145228630	chr4	145223100	145228630	5530	145225665
chr4:145239632-145240512	chr4	145239632	145240512	880	145239750
chr4:145365052-145369371	chr4	145365052	145369371	4319	145367639
chr4:145399377-145400668	chr4	145399377	145400668	1291	145399436
chr4:145591320-145597421	chr4	145591320	145597421	6101	145593906
chr4:145997754-146003843	chr4	145997754	146003843	6089	146000343
chr4:146042271-146048439	chr4	146042271	146048439	6168	146044854
chr4:146552929-146559080	chr4	146552929	146559080	6151	146555523
chr4:146618677-146620788	chr4	146618677	146620788	2111	146620005
chr4:147449524-147451212	chr4	147449524	147451212	1688	147449845
chr4:147465925-147471941	chr4	147465925	147471941	6016	147468516
chr4:147999928-148003886	chr4	147999928	148003886	3958	148002501
chr4:148317874-148323904	chr4	148317874	148323904	6030	148320464
chr4:148497740-148500791	chr4	148497740	148500791	3051	148500302
chr4:148515990-148522367	chr4	148515990	148522367	6377	148518492
chr4:148592968-148596286	chr4	148592968	148596286	3318	148595554
chr4:149088594-149094734	chr4	149088594	149094734	6140	149091185
chr4:149355246-149358576	chr4	149355246	149358576	3330	149357833
chr4:149591455-149595334	chr4	149591455	149595334	3879	149594045
chr4:153854291-153860194	chr4	153854291	153860194	5903	153856299
chr4:153978077-153984223	chr4	153978077	153984223	6146	153980667
chr4:154144577-154150105	chr4	154144577	154150105	5528	154147170
chr4:154170013-154172731	chr4	154170013	154172731	2718	154172601
chr4:154771774-154776471	chr4	154771774	154776471	4697	154774315
chr4:154787204-154790356	chr4	154787204	154790356	3152	154789762
chr4:155281849-155286433	chr4	155281849	155286433	4584	155284438
chr4:156284540-156290599	chr4	156284540	156290599	6059	156287176
chr4:157157345-157163450	chr4	157157345	157163450	6105	157159921
chr4:157174892-157180916	chr4	157174892	157180916	6024	157177482
chr4:157417013-157417381	chr4	157417013	157417381	368	157417362
chr4:157754824-157760968	chr4	157754824	157760968	6144	157757402
chr4:157921647-157927767	chr4	157921647	157927767	6120	157924231
chr4:158084240-158090272	chr4	158084240	158090272	6032	158086830
chr4:158118475-158119394	chr4	158118475	158119394	919	158119055
chr4:158362555-158368702	chr4	158362555	158368702	6147	158365136
chr4:158463188-158467525	chr4	158463188	158467525	4337	158465786
chr4:158473274-158476169	chr4	158473274	158476169	2895	158476036
chr4:158544449-158550599	chr4	158544449	158550599	6150	158547037
chr4:159528029-159534173	chr4	159528029	159534173	6144	159530613
chr4:159609414-159615539	chr4	159609414	159615539	6125	159612009
chr4:159623727-159630180	chr4	159623727	159630180	6453	159626286
chr4:159709512-159715562	chr4	159709512	159715562	6050	159712125
chr4:159872404-159877958	chr4	159872404	159877958	5554	159874994
chr4:159929070-159935208	chr4	159929070	159935208	6138	159931657
chr4:160120217-160126215	chr4	160120217	160126215	5998	160122801
chr4:160151167-160157326	chr4	160151167	160157326	6159	160153759
chr4:160336491-160342940	chr4	160336491	160342940	6449	160339071
chr4:160637469-160639055	chr4	160637469	160639055	1586	160638305
chr4:160703998-160706862	chr4	160703998	160706862	2864	160706568
chr4:160748522-160750923	chr4	160748522	160750923	2401	160749273
chr4:161112172-161118708	chr4	161112172	161118708	6536	161114837
chr4:161832350-161834000	chr4	161832350	161834000	1650	161832468
chr4:162476977-162479592	chr4	162476977	162479592	2615	162479547
chr4:162798240-162801500	chr4	162798240	162801500	3260	162799919
chr4:163054618-163058782	chr4	163054618	163058782	4164	163057228
chr4:163207006-163212968	chr4	163207006	163212968	5962	163209525
chr4:163409309-163411098	chr4	163409309	163411098	1789	163410281
chr4:163719033-163725152	chr4	163719033	163725152	6119	163721617
chr4:164031440-164032796	chr4	164031440	164032796	1356	164031919
chr4:164553492-164559523	chr4	164553492	164559523	6031	164556083
chr4:165265608-165270909	chr4	165265608	165270909	5301	165267899
chr4:165896781-165902732	chr4	165896781	165902732	5951	165898816
chr4:166370513-166374390	chr4	166370513	166374390	3877	166373072
chr4:166764197-166770324	chr4	166764197	166770324	6127	166766776
chr4:167276135-167282161	chr4	167276135	167282161	6026	167278722
chr4:167283996-167286883	chr4	167283996	167286883	2887	167286546
chr4:167343516-167349561	chr4	167343516	167349561	6045	167346104
chr4:167707925-167708782	chr4	167707925	167708782	857	167708705
chr4:167911564-167911931	chr4	167911564	167911931	367	167911568
chr4:167982027-167984829	chr4	167982027	167984829	2802	167984621
chr4:169468601-169472592	chr4	169468601	169472592	3991	169468704
chr4:169495541-169500548	chr4	169495541	169500548	5007	169496992
chr4:169515501-169521532	chr4	169515501	169521532	6031	169518093
chr4:169542027-169544599	chr4	169542027	169544599	2572	169544555
chr4:170263278-170269442	chr4	170263278	170269442	6164	170265869
chr4:170355934-170364005	chr4	170355934	170364005	8071	170360437
chr4:170409625-170412544	chr4	170409625	170412544	2919	170412203
chr4:170505054-170511194	chr4	170505054	170511194	6140	170507653
chr4:170782980-170789002	chr4	170782980	170789002	6022	170785574
chr4:171309989-171314712	chr4	171309989	171314712	4723	171312745
chr4:171354302-171357182	chr4	171354302	171357182	2880	171355852
chr4:171591200-171595393	chr4	171591200	171595393	4193	171591650
chr4:171799261-171803525	chr4	171799261	171803525	4264	171801865
chr4:172296368-172302514	chr4	172296368	172302514	6146	172298955
chr4:173078839-173084938	chr4	173078839	173084938	6099	173081396
chr4:173603062-173609186	chr4	173603062	173609186	6124	173605649
chr4:173962946-173969035	chr4	173962946	173969035	6089	173965519
chr4:174411896-174418039	chr4	174411896	174418039	6143	174414486
chr4:175178696-175183119	chr4	175178696	175183119	4423	175181512
chr4:175599972-175605332	chr4	175599972	175605332	5360	175602608
chr4:175941402-175944153	chr4	175941402	175944153	2751	175943968
chr4:176362640-176369413	chr4	176362640	176369413	6773	176365086
chr4:177700415-177701547	chr4	177700415	177701547	1132	177701087
chr4:177843902-177848420	chr4	177843902	177848420	4518	177846493
chr4:178445701-178448249	chr4	178445701	178448249	2548	178447392
chr4:178510937-178515468	chr4	178510937	178515468	4531	178513496
chr4:178858554-178862727	chr4	178858554	178862727	4173	178861129
chr4:178985779-178989648	chr4	178985779	178989648	3869	178988342
chr4:179984720-179987232	chr4	179984720	179987232	2512	179986445
chr4:180855869-180859658	chr4	180855869	180859658	3789	180858435
chr4:181408889-181414915	chr4	181408889	181414915	6026	181411477
chr4:181627338-181630863	chr4	181627338	181630863	3525	181629925
chr4:181779640-181783326	chr4	181779640	181783326	3686	181782208
chr4:181919736-181923262	chr4	181919736	181923262	3526	181922322
chr4:182030081-182033946	chr4	182030081	182033946	3865	182032640
chr4:182356716-182362873	chr4	182356716	182362873	6157	182359307
chr4:182779057-182785080	chr4	182779057	182785080	6023	182781642
chr4:183276997-183279787	chr4	183276997	183279787	2790	183279564
chr4:186110393-186116420	chr4	186110393	186116420	6027	186112985
chr4:186180383-186185922	chr4	186180383	186185922	5539	186182970
chr4:187856785-187862920	chr4	187856785	187862920	6135	187859355
chr4:188558269-188564287	chr4	188558269	188564287	6018	188560853
chr4:188750525-188751493	chr4	188750525	188751493	968	188751453
chr4:188858972-188861762	chr4	188858972	188861762	2790	188861535
chr4:189239992-189246154	chr4	189239992	189246154	6162	189242570
chr4_GL000008v2_random:91301-97432	chr4_GL000008v2_random	91301	97432	6131	93857
chr4_GL000257v2_alt:218056-222753	chr4_GL000257v2_alt	218056	222753	4697	219183
chr4_GL000257v2_alt:253855-260018	chr4_GL000257v2_alt	253855	260018	6163	256447
chr4_GL000257v2_alt:344232-350389	chr4_GL000257v2_alt	344232	350389	6157	346820
chr4_GL383528v1_alt:104291-107958	chr4_GL383528v1_alt	104291	107958	3667	106878
chr4_KI270788v1_alt:92681-97993	chr4_KI270788v1_alt	92681	97993	5312	95271
chr5:2060793-2062559	chr5	2060793	2062559	1766	2061164
chr5:3663675-3667021	chr5	3663675	3667021	3346	3666228
chr5:3899741-3901258	chr5	3899741	3901258	1517	3900620
chr5:4496346-4502372	chr5	4496346	4502372	6026	4498936
chr5:4887581-4893698	chr5	4887581	4893698	6117	4890159
chr5:7125279-7131299	chr5	7125279	7131299	6020	7127867
chr5:8084215-8090244	chr5	8084215	8090244	6029	8086803
chr5:9002480-9007787	chr5	9002480	9007787	5307	9005062
chr5:9584176-9587221	chr5	9584176	9587221	3045	9586757
chr5:11666769-11673042	chr5	11666769	11673042	6273	11669350
chr5:15567602-15570511	chr5	15567602	15570511	2909	15570178
chr5:15906515-15912550	chr5	15906515	15912550	6035	15909107
chr5:16357471-16359197	chr5	16357471	16359197	1726	16359110
chr5:16394998-16401086	chr5	16394998	16401086	6088	16397550
chr5:16632668-16638753	chr5	16632668	16638753	6085	16635196
chr5:16651388-16654731	chr5	16651388	16654731	3343	16653983
chr5:17749600-17755756	chr5	17749600	17755756	6156	17752191
chr5:18005255-18006022	chr5	18005255	18006022	767	18005360
chr5:19505142-19506079	chr5	19505142	19506079	937	19505906
chr5:19513852-19516846	chr5	19513852	19516846	2994	19516437
chr5:20387162-20389544	chr5	20387162	20389544	2382	20388155
chr5:21624565-21627681	chr5	21624565	21627681	3116	21627066
chr5:22026921-22028164	chr5	22026921	22028164	1243	22027402
chr5:23175786-23179705	chr5	23175786	23179705	3919	23175917
chr5:23853351-23856896	chr5	23853351	23856896	3545	23855935
chr5:24037230-24039765	chr5	24037230	24039765	2535	24039725
chr5:24305266-24308071	chr5	24305266	24308071	2805	24307840
chr5:24654721-24660895	chr5	24654721	24660895	6174	24657312
chr5:25077653-25083685	chr5	25077653	25083685	6032	25080245
chr5:25113737-25119754	chr5	25113737	25119754	6017	25116322
chr5:25378529-25384556	chr5	25378529	25384556	6027	25381120
chr5:25650195-25655078	chr5	25650195	25655078	4883	25652777
chr5:27613371-27616134	chr5	27613371	27616134	2763	27615135
chr5:27883890-27890022	chr5	27883890	27890022	6132	27886479
chr5:28196153-28200113	chr5	28196153	28200113	3960	28198744
chr5:28756566-28759314	chr5	28756566	28759314	2748	28757410
chr5:29186603-29191259	chr5	29186603	29191259	4656	29189175
chr5:29486063-29489015	chr5	29486063	29489015	2952	29487374
chr5:29536167-29539962	chr5	29536167	29539962	3795	29538746
chr5:30012511-30013249	chr5	30012511	30013249	738	30013191
chr5:30359046-30365384	chr5	30359046	30365384	6338	30361825
chr5:30423377-30429507	chr5	30423377	30429507	6130	30425961
chr5:30496098-30499978	chr5	30496098	30499978	3880	30496411
chr5:30817969-30823996	chr5	30817969	30823996	6027	30820560
chr5:32755805-32760114	chr5	32755805	32760114	4309	32758190
chr5:33095903-33102047	chr5	33095903	33102047	6144	33098487
chr5:33348166-33354286	chr5	33348166	33354286	6120	33350750
chr5:34134618-34135572	chr5	34134618	34135572	954	34135507
chr5:34428760-34434920	chr5	34428760	34434920	6160	34431340
chr5:34443391-34445617	chr5	34443391	34445617	2226	34444377
chr5:34640686-34646840	chr5	34640686	34646840	6154	34643268
chr5:35256058-35262086	chr5	35256058	35262086	6028	35258551
chr5:35348052-35354506	chr5	35348052	35354506	6454	35350584
chr5:35568225-35574246	chr5	35568225	35574246	6021	35570808
chr5:36184263-36190366	chr5	36184263	36190366	6103	36186831
chr5:36291398-36294654	chr5	36291398	36294654	3256	36293989
chr5:36916503-36919143	chr5	36916503	36919143	2640	36919113
chr5:37258806-37261654	chr5	37258806	37261654	2848	37261372
chr5:37457848-37459373	chr5	37457848	37459373	1525	37458414
chr5:37650964-37657453	chr5	37650964	37657453	6489	37653527
chr5:37674240-37679991	chr5	37674240	37679991	5751	37676822
chr5:38169496-38175529	chr5	38169496	38175529	6033	38172088
chr5:38625599-38631747	chr5	38625599	38631747	6148	38628184
chr5:38986640-38988608	chr5	38986640	38988608	1968	38987311
chr5:39242141-39245069	chr5	39242141	39245069	2928	39244728
chr5:39275744-39281886	chr5	39275744	39281886	6142	39278326
chr5:39593232-39599492	chr5	39593232	39599492	6260	39595720
chr5:39682520-39688612	chr5	39682520	39688612	6092	39685105
chr5:40296740-40302182	chr5	40296740	40302182	5442	40299335
chr5:40417239-40423350	chr5	40417239	40423350	6111	40419789
chr5:40447817-40454360	chr5	40447817	40454360	6543	40450506
chr5:40468742-40474889	chr5	40468742	40474889	6147	40471325
chr5:40561399-40565212	chr5	40561399	40565212	3813	40563971
chr5:40642769-40645159	chr5	40642769	40645159	2390	40644668
chr5:41073277-41079428	chr5	41073277	41079428	6151	41075864
chr5:41487919-41494088	chr5	41487919	41494088	6169	41490523
chr5:41533921-41537076	chr5	41533921	41537076	3155	41536508
chr5:41564500-41570685	chr5	41564500	41570685	6185	41567120
chr5:41604728-41609541	chr5	41604728	41609541	4813	41607318
chr5:42254239-42260389	chr5	42254239	42260389	6150	42256823
chr5:42412311-42418555	chr5	42412311	42418555	6244	42414901
chr5:42476884-42483030	chr5	42476884	42483030	6146	42479473
chr5:43260613-43266748	chr5	43260613	43266748	6135	43263197
chr5:43322897-43329010	chr5	43322897	43329010	6113	43325475
chr5:43438837-43443391	chr5	43438837	43443391	4554	43441446
chr5:43667275-43673422	chr5	43667275	43673422	6147	43669869
chr5:43756228-43758769	chr5	43756228	43758769	2541	43756635
chr5:43808179-43814321	chr5	43808179	43814321	6142	43810762
chr5:43910556-43914065	chr5	43910556	43914065	3509	43913064
chr5:43959952-43966376	chr5	43959952	43966376	6424	43962532
chr5:43975851-43982164	chr5	43975851	43982164	6313	43978440
chr5:44059889-44065351	chr5	44059889	44065351	5462	44062478
chr5:44104316-44109016	chr5	44104316	44109016	4700	44105133
chr5:44201731-44206773	chr5	44201731	44206773	5042	44204241
chr5:44617656-44618531	chr5	44617656	44618531	875	44618414
chr5:45237858-45244003	chr5	45237858	45244003	6145	45240432
chr5:45493599-45499615	chr5	45493599	45499615	6016	45496456
chr5:45580536-45586672	chr5	45580536	45586672	6136	45583113
chr5:45743085-45749194	chr5	45743085	45749194	6109	45745655
chr5:45832860-45838845	chr5	45832860	45838845	5985	45835431
chr5:45881229-45887211	chr5	45881229	45887211	5982	45883818
chr5:45921773-45926743	chr5	45921773	45926743	4970	45924346
chr5:46106274-46112358	chr5	46106274	46112358	6084	46108809
chr5:46156301-46160497	chr5	46156301	46160497	4196	46158712
chr5:46385244-46389231	chr5	46385244	46389231	3987	46387815
chr5:50168796-50174963	chr5	50168796	50174963	6167	50171379
chr5:50256986-50263123	chr5	50256986	50263123	6137	50259573
chr5:50452986-50459008	chr5	50452986	50459008	6022	50455572
chr5:50467523-50471398	chr5	50467523	50471398	3875	50467880
chr5:50483964-50490136	chr5	50483964	50490136	6172	50486582
chr5:50596109-50602273	chr5	50596109	50602273	6164	50598698
chr5:51330782-51335996	chr5	51330782	51335996	5214	51333370
chr5:51700495-51701053	chr5	51700495	51701053	558	51700870
chr5:51737136-51741145	chr5	51737136	51741145	4009	51739724
chr5:51755504-51758649	chr5	51755504	51758649	3145	51758083
chr5:51785148-51791298	chr5	51785148	51791298	6150	51787733
chr5:52097924-52102941	chr5	52097924	52102941	5017	52099389
chr5:52215420-52218600	chr5	52215420	52218600	3180	52217985
chr5:52246715-52250302	chr5	52246715	52250302	3587	52249307
chr5:52609769-52612745	chr5	52609769	52612745	2976	52610594
chr5:52965793-52970667	chr5	52965793	52970667	4874	52968354
chr5:52970664-52974650	chr5	52970664	52974650	3986	52973242
chr5:53185033-53188883	chr5	53185033	53188883	3850	53187617
chr5:53224204-53230281	chr5	53224204	53230281	6077	53226792
chr5:53305180-53309761	chr5	53305180	53309761	4581	53307714
chr5:53625889-53632164	chr5	53625889	53632164	6275	53628469
chr5:53660005-53665971	chr5	53660005	53665971	5966	53662583
chr5:53700185-53706313	chr5	53700185	53706313	6128	53702771
chr5:53848381-53851681	chr5	53848381	53851681	3300	53850946
chr5:54484726-54486596	chr5	54484726	54486596	1870	54486572
chr5:54787731-54790853	chr5	54787731	54790853	3122	54790325
chr5:55075360-55081502	chr5	55075360	55081502	6142	55077940
chr5:55587535-55590383	chr5	55587535	55590383	2848	55590127
chr5:55752186-55754991	chr5	55752186	55754991	2805	55754761
chr5:55803330-55809463	chr5	55803330	55809463	6133	55805912
chr5:56776314-56782435	chr5	56776314	56782435	6121	56778898
chr5:57351496-57357526	chr5	57351496	57357526	6030	57354085
chr5:57377676-57379416	chr5	57377676	57379416	1740	57378870
chr5:57471563-57475609	chr5	57471563	57475609	4046	57474179
chr5:57543690-57546636	chr5	57543690	57546636	2946	57546220
chr5:57865362-57869394	chr5	57865362	57869394	4032	57867950
chr5:57943345-57946574	chr5	57943345	57946574	3229	57945940
chr5:57966585-57972749	chr5	57966585	57972749	6164	57969212
chr5:58102606-58105694	chr5	58102606	58105694	3088	58102727
chr5:58371581-58376482	chr5	58371581	58376482	4901	58374168
chr5:58536154-58542290	chr5	58536154	58542290	6136	58538743
chr5:58552269-58558283	chr5	58552269	58558283	6014	58554855
chr5:58693939-58700099	chr5	58693939	58700099	6160	58696509
chr5:60044367-60050391	chr5	60044367	60050391	6024	60046955
chr5:60301068-60302821	chr5	60301068	60302821	1753	60302256
chr5:60314486-60320627	chr5	60314486	60320627	6141	60317075
chr5:60570768-60576107	chr5	60570768	60576107	5339	60572544
chr5:60875888-60882002	chr5	60875888	60882002	6114	60878459
chr5:60911230-60914482	chr5	60911230	60914482	3252	60913180
chr5:60982396-60985725	chr5	60982396	60985725	3329	60984982
chr5:61889856-61892520	chr5	61889856	61892520	2664	61892444
chr5:62022955-62026838	chr5	62022955	62026838	3883	62023854
chr5:62031675-62038116	chr5	62031675	62038116	6441	62034251
chr5:62225347-62230833	chr5	62225347	62230833	5486	62227919
chr5:62481217-62482506	chr5	62481217	62482506	1289	62481877
chr5:62543244-62544058	chr5	62543244	62544058	814	62543273
chr5:62672799-62678950	chr5	62672799	62678950	6151	62675392
chr5:62798974-62804997	chr5	62798974	62804997	6023	62801558
chr5:62890855-62897295	chr5	62890855	62897295	6440	62893466
chr5:62950303-62954640	chr5	62950303	62954640	4337	62952894
chr5:63676984-63681900	chr5	63676984	63681900	4916	63679565
chr5:63974918-63981037	chr5	63974918	63981037	6119	63977489
chr5:64105830-64107251	chr5	64105830	64107251	1421	64107180
chr5:64129091-64135124	chr5	64129091	64135124	6033	64131683
chr5:64349435-64352647	chr5	64349435	64352647	3212	64351989
chr5:64464920-64470915	chr5	64464920	64470915	5995	64467348
chr5:64709034-64715065	chr5	64709034	64715065	6031	64711626
chr5:65846889-65853068	chr5	65846889	65853068	6179	65849475
chr5:66057553-66063686	chr5	66057553	66063686	6133	66060126
chr5:66216787-66223348	chr5	66216787	66223348	6561	66219486
chr5:66256816-66263007	chr5	66256816	66263007	6191	66259441
chr5:66382748-66388765	chr5	66382748	66388765	6017	66385331
chr5:66399539-66405811	chr5	66399539	66405811	6272	66402105
chr5:66444246-66450370	chr5	66444246	66450370	6124	66446865
chr5:67224749-67227407	chr5	67224749	67227407	2658	67227309
chr5:67564816-67567797	chr5	67564816	67567797	2981	67567402
chr5:67598336-67604471	chr5	67598336	67604471	6135	67600914
chr5:67660874-67666963	chr5	67660874	67666963	6089	67663407
chr5:67736897-67742931	chr5	67736897	67742931	6034	67739491
chr5:67866012-67869439	chr5	67866012	67869439	3427	67868571
chr5:68622800-68624309	chr5	68622800	68624309	1509	68623048
chr5:68701898-68705052	chr5	68701898	68705052	3154	68704500
chr5:70080498-70083356	chr5	70080498	70083356	2858	70082451
chr5:70955952-70958810	chr5	70955952	70958810	2858	70957905
chr5:71604580-71610593	chr5	71604580	71610593	6013	71607164
chr5:71795308-71798320	chr5	71795308	71798320	3012	71797236
chr5:72970699-72975028	chr5	72970699	72975028	4329	72973290
chr5:72976629-72979378	chr5	72976629	72979378	2749	72979199
chr5:73874410-73880569	chr5	73874410	73880569	6159	73877009
chr5:74345124-74351235	chr5	74345124	74351235	6111	74347687
chr5:74435638-74436095	chr5	74435638	74436095	457	74435945
chr5:75098286-75103059	chr5	75098286	75103059	4773	75099519
chr5:75249989-75256139	chr5	75249989	75256139	6150	75252573
chr5:75288171-75291517	chr5	75288171	75291517	3346	75289233
chr5:75560520-75563126	chr5	75560520	75563126	2606	75563099
chr5:75769521-75775344	chr5	75769521	75775344	5823	75772136
chr5:75792629-75796668	chr5	75792629	75796668	4039	75795209
chr5:75896065-75902234	chr5	75896065	75902234	6169	75898656
chr5:76032249-76038204	chr5	76032249	76038204	5955	76034837
chr5:76259439-76263260	chr5	76259439	76263260	3821	76262032
chr5:77382435-77385795	chr5	77382435	77385795	3360	77385061
chr5:78169733-78173661	chr5	78169733	78173661	3928	78172328
chr5:78435233-78441339	chr5	78435233	78441339	6106	78437802
chr5:78452185-78458210	chr5	78452185	78458210	6025	78454771
chr5:78579341-78584995	chr5	78579341	78584995	5654	78581878
chr5:78848085-78854204	chr5	78848085	78854204	6119	78850647
chr5:78939282-78945425	chr5	78939282	78945425	6143	78941870
chr5:79095899-79101910	chr5	79095899	79101910	6011	79098479
chr5:79335756-79341114	chr5	79335756	79341114	5358	79338316
chr5:79766398-79770734	chr5	79766398	79770734	4336	79766893
chr5:79778884-79784938	chr5	79778884	79784938	6054	79781504
chr5:80391144-80397265	chr5	80391144	80397265	6121	80393713
chr5:80840909-80847049	chr5	80840909	80847049	6140	80843492
chr5:81053125-81057281	chr5	81053125	81057281	4156	81055718
chr5:82079374-82081993	chr5	82079374	82081993	2619	82081946
chr5:82124301-82130808	chr5	82124301	82130808	6507	82126869
chr5:82132250-82138679	chr5	82132250	82138679	6429	82134812
chr5:82369248-82372017	chr5	82369248	82372017	2769	82371840
chr5:82429400-82435423	chr5	82429400	82435423	6023	82431992
chr5:82451240-82454560	chr5	82451240	82454560	3320	82453829
chr5:82502598-82506596	chr5	82502598	82506596	3998	82505174
chr5:82843967-82848168	chr5	82843967	82848168	4201	82844653
chr5:82866880-82872788	chr5	82866880	82872788	5908	82869464
chr5:83127982-83133776	chr5	83127982	83133776	5794	83130557
chr5:83457799-83463817	chr5	83457799	83463817	6018	83460391
chr5:83793611-83799642	chr5	83793611	83799642	6031	83796201
chr5:85582241-85588699	chr5	85582241	85588699	6458	85584824
chr5:85657593-85663641	chr5	85657593	85663641	6048	85660185
chr5:85729199-85731480	chr5	85729199	85731480	2281	85731103
chr5:85790912-85793529	chr5	85790912	85793529	2617	85793478
chr5:86080091-86082555	chr5	86080091	86082555	2464	86080206
chr5:86433684-86435024	chr5	86433684	86435024	1340	86434624
chr5:86725833-86731962	chr5	86725833	86731962	6129	86728425
chr5:86752291-86755547	chr5	86752291	86755547	3256	86754884
chr5:86772323-86778600	chr5	86772323	86778600	6277	86774905
chr5:86936399-86940881	chr5	86936399	86940881	4482	86938938
chr5:87037051-87043152	chr5	87037051	87043152	6101	87039625
chr5:87199133-87204262	chr5	87199133	87204262	5129	87201784
chr5:87562371-87566289	chr5	87562371	87566289	3918	87565226
chr5:87697275-87698756	chr5	87697275	87698756	1481	87697335
chr5:87882580-87885607	chr5	87882580	87885607	3027	87885168
chr5:88009454-88015622	chr5	88009454	88015622	6168	88012058
chr5:88310429-88314147	chr5	88310429	88314147	3718	88310590
chr5:88617452-88623600	chr5	88617452	88623600	6148	88620036
chr5:88793656-88797455	chr5	88793656	88797455	3799	88796227
chr5:88988527-88992691	chr5	88988527	88992691	4164	88990008
chr5:89610227-89613105	chr5	89610227	89613105	2878	89612812
chr5:89630172-89636079	chr5	89630172	89636079	5907	89632513
chr5:89736484-89738890	chr5	89736484	89738890	2406	89737296
chr5:89741232-89744189	chr5	89741232	89744189	2957	89743800
chr5:90039559-90045658	chr5	90039559	90045658	6099	90042146
chr5:90576124-90581792	chr5	90576124	90581792	5668	90578700
chr5:90662588-90668637	chr5	90662588	90668637	6049	90665201
chr5:90817162-90822442	chr5	90817162	90822442	5280	90819003
chr5:90923630-90929658	chr5	90923630	90929658	6028	90926220
chr5:92193473-92199495	chr5	92193473	92199495	6022	92196057
chr5:92296968-92302985	chr5	92296968	92302985	6017	92299556
chr5:93166559-93172690	chr5	93166559	93172690	6131	93169137
chr5:93851455-93855784	chr5	93851455	93855784	4329	93854045
chr5:94290145-94294445	chr5	94290145	94294445	4300	94292703
chr5:94822066-94825884	chr5	94822066	94825884	3818	94824625
chr5:95166917-95172450	chr5	95166917	95172450	5533	95169484
chr5:95246746-95247965	chr5	95246746	95247965	1219	95246979
chr5:96103200-96109249	chr5	96103200	96109249	6049	96105823
chr5:96303464-96309906	chr5	96303464	96309906	6442	96306035
chr5:96355999-96361794	chr5	96355999	96361794	5795	96357918
chr5:97211457-97213930	chr5	97211457	97213930	2473	97213866
chr5:97218484-97221376	chr5	97218484	97221376	2892	97221059
chr5:97234257-97240422	chr5	97234257	97240422	6165	97236852
chr5:97302295-97307097	chr5	97302295	97307097	4802	97303563
chr5:97513923-97519943	chr5	97513923	97519943	6020	97516503
chr5:97679268-97684840	chr5	97679268	97684840	5572	97681856
chr5:97700509-97705482	chr5	97700509	97705482	4973	97702866
chr5:97717792-97723895	chr5	97717792	97723895	6103	97720377
chr5:97766617-97772629	chr5	97766617	97772629	6012	97769205
chr5:97809921-97815940	chr5	97809921	97815940	6019	97812502
chr5:97897158-97903296	chr5	97897158	97903296	6138	97899741
chr5:98234677-98238451	chr5	98234677	98238451	3774	98237274
chr5:99339615-99345764	chr5	99339615	99345764	6149	99342203
chr5:99557743-99563900	chr5	99557743	99563900	6157	99560332
chr5:99708398-99711378	chr5	99708398	99711378	2980	99710984
chr5:99757941-99761943	chr5	99757941	99761943	4002	99760489
chr5:99828959-99831869	chr5	99828959	99831869	2910	99831545
chr5:99958914-99962664	chr5	99958914	99962664	3750	99961503
chr5:100458104-100464295	chr5	100458104	100464295	6191	100460686
chr5:100554930-100560235	chr5	100554930	100560235	5305	100557524
chr5:100659808-100660940	chr5	100659808	100660940	1132	100660608
chr5:100930088-100936228	chr5	100930088	100936228	6140	100932676
chr5:101055759-101061397	chr5	101055759	101061397	5638	101058348
chr5:101108449-101112425	chr5	101108449	101112425	3976	101111041
chr5:101524745-101528899	chr5	101524745	101528899	4154	101527340
chr5:101710268-101716405	chr5	101710268	101716405	6137	101712838
chr5:102110843-102113512	chr5	102110843	102113512	2669	102113422
chr5:102206800-102207229	chr5	102206800	102207229	429	102207067
chr5:102468763-102470645	chr5	102468763	102470645	1882	102470247
chr5:102683119-102687423	chr5	102683119	102687423	4304	102685695
chr5:103075805-103080440	chr5	103075805	103080440	4635	103076671
chr5:103309105-103311721	chr5	103309105	103311721	2616	103311691
chr5:103379842-103382726	chr5	103379842	103382726	2884	103382453
chr5:104074362-104080381	chr5	104074362	104080381	6019	104076949
chr5:104446375-104452406	chr5	104446375	104452406	6031	104448966
chr5:105000570-105003750	chr5	105000570	105003750	3180	105003153
chr5:105160272-105161100	chr5	105160272	105161100	828	105160777
chr5:105184655-105186777	chr5	105184655	105186777	2122	105186111
chr5:105513236-105519274	chr5	105513236	105519274	6038	105515823
chr5:105999548-106002847	chr5	105999548	106002847	3299	106001631
chr5:106425382-106431381	chr5	106425382	106431381	5999	106427972
chr5:106622805-106628811	chr5	106622805	106628811	6006	106625369
chr5:106713866-106719888	chr5	106713866	106719888	6022	106716455
chr5:106770980-106776867	chr5	106770980	106776867	5887	106773568
chr5:106898992-106905188	chr5	106898992	106905188	6196	106901579
chr5:106994323-107000285	chr5	106994323	107000285	5962	106996869
chr5:108207331-108213751	chr5	108207331	108213751	6420	108209898
chr5:109117543-109119708	chr5	109117543	109119708	2165	109118594
chr5:109208508-109214655	chr5	109208508	109214655	6147	109211065
chr5:109441620-109447643	chr5	109441620	109447643	6023	109444205
chr5:109621793-109627145	chr5	109621793	109627145	5352	109624198
chr5:109731360-109735683	chr5	109731360	109735683	4323	109733950
chr5:110040205-110043866	chr5	110040205	110043866	3661	110042629
chr5:110068207-110073398	chr5	110068207	110073398	5191	110069541
chr5:110278636-110284796	chr5	110278636	110284796	6160	110281241
chr5:110797930-110800144	chr5	110797930	110800144	2214	110799729
chr5:110904544-110906162	chr5	110904544	110906162	1618	110905049
chr5:111084879-111090908	chr5	111084879	111090908	6029	111087471
chr5:111565588-111570207	chr5	111565588	111570207	4619	111568178
chr5:111575512-111580844	chr5	111575512	111580844	5332	111578102
chr5:111711195-111717241	chr5	111711195	111717241	6046	111713787
chr5:111986003-111992116	chr5	111986003	111992116	6113	111988567
chr5:112132168-112134994	chr5	112132168	112134994	2826	112134788
chr5:112425644-112428502	chr5	112425644	112428502	2858	112428231
chr5:112460747-112466882	chr5	112460747	112466882	6135	112463328
chr5:113411696-113416103	chr5	113411696	113416103	4407	113413359
chr5:113466185-113472299	chr5	113466185	113472299	6114	113468770
chr5:113724603-113728704	chr5	113724603	113728704	4101	113726839
chr5:113929244-113932685	chr5	113929244	113932685	3441	113931831
chr5:114157007-114163149	chr5	114157007	114163149	6142	114159591
chr5:114272880-114279003	chr5	114272880	114279003	6123	114275422
chr5:114291191-114295043	chr5	114291191	114295043	3852	114293780
chr5:114530663-114536795	chr5	114530663	114536795	6132	114533240
chr5:114891256-114895798	chr5	114891256	114895798	4542	114893834
chr5:114914687-114919563	chr5	114914687	114919563	4876	114917254
chr5:115877197-115883667	chr5	115877197	115883667	6470	115879792
chr5:116104918-116107049	chr5	116104918	116107049	2131	116105546
chr5:116120982-116125820	chr5	116120982	116125820	4838	116123657
chr5:116148846-116152272	chr5	116148846	116152272	3426	116151447
chr5:116251266-116255538	chr5	116251266	116255538	4272	116253885
chr5:117111796-117117923	chr5	117111796	117117923	6127	117114383
chr5:117338253-117344286	chr5	117338253	117344286	6033	117340843
chr5:117527598-117533625	chr5	117527598	117533625	6027	117530187
chr5:117906150-117907779	chr5	117906150	117907779	1629	117907499
chr5:117916116-117918285	chr5	117916116	117918285	2169	117917158
chr5:118131761-118134129	chr5	118131761	118134129	2368	118131882
chr5:118497849-118502912	chr5	118497849	118502912	5063	118499357
chr5:118991926-118994657	chr5	118991926	118994657	2731	118994521
chr5:119024948-119026857	chr5	119024948	119026857	1909	119026723
chr5:119294044-119300263	chr5	119294044	119300263	6219	119296714
chr5:119684785-119690814	chr5	119684785	119690814	6029	119687378
chr5:119776586-119780799	chr5	119776586	119780799	4213	119777352
chr5:119987772-119992292	chr5	119987772	119992292	4520	119988742
chr5:120126861-120133028	chr5	120126861	120133028	6167	120129458
chr5:120176046-120182173	chr5	120176046	120182173	6127	120178623
chr5:120310130-120313217	chr5	120310130	120313217	3087	120312716
chr5:120421208-120427233	chr5	120421208	120427233	6025	120423800
chr5:120485648-120491196	chr5	120485648	120491196	5548	120488236
chr5:120664456-120668907	chr5	120664456	120668907	4451	120667047
chr5:121040747-121043627	chr5	121040747	121043627	2880	121043340
chr5:121081145-121085606	chr5	121081145	121085606	4461	121083731
chr5:121678606-121679155	chr5	121678606	121679155	549	121679065
chr5:121720368-121724686	chr5	121720368	121724686	4318	121722960
chr5:121808082-121811839	chr5	121808082	121811839	3757	121810614
chr5:122046051-122049149	chr5	122046051	122049149	3098	122048633
chr5:122246836-122252781	chr5	122246836	122252781	5945	122249371
chr5:122377544-122383563	chr5	122377544	122383563	6019	122380128
chr5:122509616-122515639	chr5	122509616	122515639	6023	122512205
chr5:122592542-122598662	chr5	122592542	122598662	6120	122595119
chr5:122630891-122636933	chr5	122630891	122636933	6042	122633379
chr5:122914151-122914851	chr5	122914151	122914851	700	122914484
chr5:123236611-123242616	chr5	123236611	123242616	6005	123239200
chr5:123250932-123257062	chr5	123250932	123257062	6130	123253504
chr5:123674576-123680705	chr5	123674576	123680705	6129	123677147
chr5:123766732-123769060	chr5	123766732	123769060	2328	123767343
chr5:123930154-123933974	chr5	123930154	123933974	3820	123932732
chr5:123983064-123989124	chr5	123983064	123989124	6060	123985213
chr5:125359000-125365032	chr5	125359000	125365032	6032	125361593
chr5:125624226-125624791	chr5	125624226	125624791	565	125624645
chr5:125630749-125632340	chr5	125630749	125632340	1591	125631520
chr5:125737055-125740553	chr5	125737055	125740553	3498	125737442
chr5:125849323-125850300	chr5	125849323	125850300	977	125850217
chr5:125918412-125924564	chr5	125918412	125924564	6152	125921004
chr5:126149803-126155946	chr5	126149803	126155946	6143	126152386
chr5:126246498-126248290	chr5	126246498	126248290	1792	126247065
chr5:126890286-126896333	chr5	126890286	126896333	6047	126892877
chr5:126903810-126909817	chr5	126903810	126909817	6007	126906405
chr5:127103103-127109254	chr5	127103103	127109254	6151	127105691
chr5:127264921-127268512	chr5	127264921	127268512	3591	127267510
chr5:127540900-127542948	chr5	127540900	127542948	2048	127541462
chr5:127733931-127739952	chr5	127733931	127739952	6021	127736517
chr5:127747107-127753135	chr5	127747107	127753135	6028	127749701
chr5:128293846-128299849	chr5	128293846	128299849	6003	128296425
chr5:128604797-128607555	chr5	128604797	128607555	2758	128607404
chr5:128649998-128656430	chr5	128649998	128656430	6432	128652555
chr5:128937637-128943755	chr5	128937637	128943755	6118	128940191
chr5:128943724-128946231	chr5	128943724	128946231	2507	128945673
chr5:128956713-128962493	chr5	128956713	128962493	5780	128959295
chr5:128967765-128973907	chr5	128967765	128973907	6142	128970347
chr5:129147182-129150945	chr5	129147182	129150945	3763	129149746
chr5:129181088-129186797	chr5	129181088	129186797	5709	129183675
chr5:129233541-129236389	chr5	129233541	129236389	2848	129236130
chr5:129285246-129291357	chr5	129285246	129291357	6111	129287817
chr5:129578464-129582559	chr5	129578464	129582559	4095	129581022
chr5:129800068-129801762	chr5	129800068	129801762	1694	129800286
chr5:129889874-129892031	chr5	129889874	129892031	2157	129891002
chr5:129894126-129897347	chr5	129894126	129897347	3221	129896705
chr5:130246013-130248650	chr5	130246013	130248650	2637	130248568
chr5:130264311-130267583	chr5	130264311	130267583	3272	130266892
chr5:131028721-131034857	chr5	131028721	131034857	6136	131031304
chr5:131116862-131121136	chr5	131116862	131121136	4274	131119431
chr5:131132925-131139009	chr5	131132925	131139009	6084	131135516
chr5:131308075-131312967	chr5	131308075	131312967	4892	131309534
chr5:131331966-131338103	chr5	131331966	131338103	6137	131334553
chr5:131723716-131729576	chr5	131723716	131729576	5860	131726282
chr5:131732387-131734413	chr5	131732387	131734413	2026	131733917
chr5:131887710-131893738	chr5	131887710	131893738	6028	131890288
chr5:131893739-131899064	chr5	131893739	131899064	5325	131895476
chr5:132123446-132129852	chr5	132123446	132129852	6406	132126009
chr5:132153327-132157791	chr5	132153327	132157791	4464	132154014
chr5:132346225-132349908	chr5	132346225	132349908	3683	132346354
chr5:133133112-133137636	chr5	133133112	133137636	4524	133135703
chr5:133165945-133171361	chr5	133165945	133171361	5416	133167793
chr5:133180711-133186159	chr5	133180711	133186159	5448	133183309
chr5:134331307-134337485	chr5	134331307	134337485	6178	134333898
chr5:134997924-135004096	chr5	134997924	135004096	6172	135000508
chr5:135982496-135985133	chr5	135982496	135985133	2637	135985102
chr5:136751356-136754164	chr5	136751356	136754164	2808	136753918
chr5:136782799-136788829	chr5	136782799	136788829	6030	136785390
chr5:136823028-136829150	chr5	136823028	136829150	6122	136825604
chr5:136848376-136853602	chr5	136848376	136853602	5226	136850298
chr5:136898139-136901936	chr5	136898139	136901936	3797	136900685
chr5:136930787-136932135	chr5	136930787	136932135	1348	136930902
chr5:136942481-136947578	chr5	136942481	136947578	5097	136944017
chr5:136947577-136951586	chr5	136947577	136951586	4009	136949774
chr5:137044642-137050656	chr5	137044642	137050656	6014	137047227
chr5:137417803-137423919	chr5	137417803	137423919	6116	137420384
chr5:138678673-138684827	chr5	138678673	138684827	6154	138681266
chr5:139005454-139011486	chr5	139005454	139011486	6032	139008049
chr5:140897193-140899801	chr5	140897193	140899801	2608	140899768
chr5:140955650-140956819	chr5	140955650	140956819	1169	140956734
chr5:141111371-141114525	chr5	141111371	141114525	3154	141113926
chr5:142985516-142991590	chr5	142985516	142991590	6074	142988082
chr5:144049945-144056062	chr5	144049945	144056062	6117	144052505
chr5:144342045-144343912	chr5	144342045	144343912	1867	144343166
chr5:144495230-144499048	chr5	144495230	144499048	3818	144497822
chr5:144513436-144517515	chr5	144513436	144517515	4079	144515131
chr5:144588442-144591765	chr5	144588442	144591765	3323	144591032
chr5:144623814-144629701	chr5	144623814	144629701	5887	144626403
chr5:144823346-144828257	chr5	144823346	144828257	4911	144825933
chr5:144930791-144932299	chr5	144930791	144932299	1508	144931252
chr5:144985666-144987078	chr5	144985666	144987078	1412	144986026
chr5:145369163-145372890	chr5	145369163	145372890	3727	145371699
chr5:145418732-145424748	chr5	145418732	145424748	6016	145421321
chr5:145641511-145645338	chr5	145641511	145645338	3827	145644101
chr5:146009878-146012591	chr5	146009878	146012591	2713	146012451
chr5:147011529-147012954	chr5	147011529	147012954	1425	147012166
chr5:147137213-147140560	chr5	147137213	147140560	3347	147138555
chr5:147605506-147611640	chr5	147605506	147611640	6134	147607762
chr5:147652701-147656997	chr5	147652701	147656997	4296	147655289
chr5:147715845-147721872	chr5	147715845	147721872	6027	147718435
chr5:147941118-147947133	chr5	147941118	147947133	6015	147943698
chr5:148275960-148279091	chr5	148275960	148279091	3131	148277861
chr5:148326515-148330862	chr5	148326515	148330862	4347	148329092
chr5:148668218-148674344	chr5	148668218	148674344	6126	148670785
chr5:150856934-150859891	chr5	150856934	150859891	2957	150859515
chr5:152020678-152025608	chr5	152020678	152025608	4930	152023254
chr5:152033315-152039761	chr5	152033315	152039761	6446	152035925
chr5:152154318-152160759	chr5	152154318	152160759	6441	152156881
chr5:152340020-152346052	chr5	152340020	152346052	6032	152342612
chr5:152653965-152659898	chr5	152653965	152659898	5933	152656555
chr5:152762660-152768698	chr5	152762660	152768698	6038	152765251
chr5:152886441-152892473	chr5	152886441	152892473	6032	152889046
chr5:152913678-152919818	chr5	152913678	152919818	6140	152916264
chr5:153070982-153077008	chr5	153070982	153077008	6026	153073574
chr5:153290652-153295390	chr5	153290652	153295390	4738	153293235
chr5:153300443-153306573	chr5	153300443	153306573	6130	153303025
chr5:154245808-154248779	chr5	154245808	154248779	2971	154248399
chr5:155157594-155163743	chr5	155157594	155163743	6149	155160184
chr5:155375230-155377967	chr5	155375230	155377967	2737	155377802
chr5:155713949-155720091	chr5	155713949	155720091	6142	155716526
chr5:156061919-156067966	chr5	156061919	156067966	6047	156064523
chr5:156068099-156073114	chr5	156068099	156073114	5015	156070719
chr5:156575932-156582059	chr5	156575932	156582059	6127	156578502
chr5:156605055-156611189	chr5	156605055	156611189	6134	156607634
chr5:158438800-158444948	chr5	158438800	158444948	6148	158441383
chr5:159291255-159292640	chr5	159291255	159292640	1385	159292493
chr5:159684086-159688275	chr5	159684086	159688275	4189	159686671
chr5:160578202-160584505	chr5	160578202	160584505	6303	160580746
chr5:160709608-160715639	chr5	160709608	160715639	6031	160712201
chr5:161606050-161612084	chr5	161606050	161612084	6034	161608643
chr5:161902853-161905285	chr5	161902853	161905285	2432	161904624
chr5:162030925-162036952	chr5	162030925	162036952	6027	162033515
chr5:162461903-162465664	chr5	162461903	162465664	3761	162464493
chr5:162690774-162696913	chr5	162690774	162696913	6139	162693353
chr5:163116856-163122978	chr5	163116856	163122978	6122	163119426
chr5:163776634-163780787	chr5	163776634	163780787	4153	163779223
chr5:163851098-163853644	chr5	163851098	163853644	2546	163852237
chr5:164490323-164493625	chr5	164490323	164493625	3302	164492899
chr5:164547005-164549916	chr5	164547005	164549916	2911	164549522
chr5:165687434-165693867	chr5	165687434	165693867	6433	165689986
chr5:165965208-165968437	chr5	165965208	165968437	3229	165967908
chr5:165968430-165974114	chr5	165968430	165974114	5684	165970257
chr5:166099813-166103541	chr5	166099813	166103541	3728	166099993
chr5:166141191-166145692	chr5	166141191	166145692	4501	166142271
chr5:166444535-166448595	chr5	166444535	166448595	4060	166447112
chr5:166966760-166972815	chr5	166966760	166972815	6055	166969371
chr5:168077428-168083578	chr5	168077428	168083578	6150	168080018
chr5:168592555-168597020	chr5	168592555	168597020	4465	168595139
chr5:170239776-170245795	chr5	170239776	170245795	6019	170242366
chr5:170873209-170876156	chr5	170873209	170876156	2947	170873435
chr5:170898236-170903530	chr5	170898236	170903530	5294	170900104
chr5:170930427-170936408	chr5	170930427	170936408	5981	170932999
chr5:171016772-171023237	chr5	171016772	171023237	6465	171019345
chr5:171058163-171064490	chr5	171058163	171064490	6327	171060751
chr5:171083963-171089973	chr5	171083963	171089973	6010	171086551
chr5:171097654-171104023	chr5	171097654	171104023	6369	171100192
chr5:171214888-171220359	chr5	171214888	171220359	5471	171217498
chr5:173402796-173408828	chr5	173402796	173408828	6032	173405388
chr5:174015711-174017620	chr5	174015711	174017620	1909	174016646
chr5:174031048-174035959	chr5	174031048	174035959	4911	174032174
chr5:174296767-174299447	chr5	174296767	174299447	2680	174299346
chr5:176078156-176084318	chr5	176078156	176084318	6162	176080761
chr5:176273510-176276462	chr5	176273510	176276462	2952	176276060
chr5:176276446-176282584	chr5	176276446	176282584	6138	176279038
chr5:177635731-177639675	chr5	177635731	177639675	3944	177636145
chr5:177786198-177792316	chr5	177786198	177792316	6118	177788768
chr5:178023806-178029948	chr5	178023806	178029948	6142	178026391
chr5:180445689-180448582	chr5	180445689	180448582	2893	180448264
chr5:180756676-180762812	chr5	180756676	180762812	6136	180759264
chr5:180880406-180886552	chr5	180880406	180886552	6146	180882987
chr5:180902521-180908537	chr5	180902521	180908537	6016	180905114
chr5:181371607-181378029	chr5	181371607	181378029	6422	181374152
chr5_GL000208v1_random:29880-35902	chr5_GL000208v1_random	29880	35902	6022	32468
chr5_GL000208v1_random:57442-63461	chr5_GL000208v1_random	57442	63461	6019	60034
chr5_GL339449v2_alt:1603065-1609078	chr5_GL339449v2_alt	1603065	1609078	6013	1605649
chr5_GL383530v1_alt:56090-59184	chr5_GL383530v1_alt	56090	59184	3094	58683
chr5_GL383531v1_alt:67497-69132	chr5_GL383531v1_alt	67497	69132	1635	69039
chr5_GL949742v1_alt:158986-163642	chr5_GL949742v1_alt	158986	163642	4656	161558
chr5_KI270796v1_alt:79535-85567	chr5_KI270796v1_alt	79535	85567	6032	82128
chr5_KI270897v1_alt:305836-308694	chr5_KI270897v1_alt	305836	308694	2858	307789
chr5_KI270897v1_alt:504348-507206	chr5_KI270897v1_alt	504348	507206	2858	506301
chr5_KI270897v1_alt:1134555-1140568	chr5_KI270897v1_alt	1134555	1140568	6013	1137139
chr6:481503-483081	chr6	481503	483081	1578	482095
chr6:823946-826617	chr6	823946	826617	2671	826552
chr6:985030-987924	chr6	985030	987924	2894	987633
chr6:1428614-1434750	chr6	1428614	1434750	6136	1431193
chr6:2417774-2423803	chr6	2417774	2423803	6029	2420363
chr6:3672187-3678310	chr6	3672187	3678310	6123	3674797
chr6:4198512-4204633	chr6	4198512	4204633	6121	4201104
chr6:4328754-4334759	chr6	4328754	4334759	6005	4331328
chr6:4831172-4836230	chr6	4831172	4836230	5058	4832664
chr6:5686200-5692336	chr6	5686200	5692336	6136	5688789
chr6:5886159-5891926	chr6	5886159	5891926	5767	5888743
chr6:5911949-5918311	chr6	5911949	5918311	6362	5914444
chr6:6068946-6069478	chr6	6068946	6069478	532	6068999
chr6:6114208-6118694	chr6	6114208	6118694	4486	6116776
chr6:6140932-6143586	chr6	6140932	6143586	2654	6143516
chr6:6185129-6191251	chr6	6185129	6191251	6122	6187811
chr6:6294743-6300768	chr6	6294743	6300768	6025	6297335
chr6:7943195-7949299	chr6	7943195	7949299	6104	7945764
chr6:8614592-8620258	chr6	8614592	8620258	5666	8617161
chr6:8770471-8776512	chr6	8770471	8776512	6041	8773083
chr6:9966044-9972049	chr6	9966044	9972049	6005	9968623
chr6:10984360-10987619	chr6	10984360	10987619	3259	10986937
chr6:15805586-15808541	chr6	15805586	15808541	2955	15808170
chr6:16010534-16016561	chr6	16010534	16016561	6027	16013125
chr6:18353782-18359333	chr6	18353782	18359333	5551	18356357
chr6:18546693-18548474	chr6	18546693	18548474	1781	18548115
chr6:21056156-21058726	chr6	21056156	21058726	2570	21057109
chr6:22166353-22172476	chr6	22166353	22172476	6123	22168957
chr6:22174840-22180874	chr6	22174840	22180874	6034	22177444
chr6:22384026-22390396	chr6	22384026	22390396	6370	22386566
chr6:22459721-22464554	chr6	22459721	22464554	4833	22462333
chr6:22988474-22994141	chr6	22988474	22994141	5667	22990388
chr6:23254284-23260419	chr6	23254284	23260419	6135	23256865
chr6:23358988-23365117	chr6	23358988	23365117	6129	23361568
chr6:23814163-23815002	chr6	23814163	23815002	839	23814894
chr6:24811657-24817706	chr6	24811657	24817706	6049	24814267
chr6:25182629-25186121	chr6	25182629	25186121	3492	25182677
chr6:26842853-26843807	chr6	26842853	26843807	954	26843742
chr6:29176613-29180613	chr6	29176613	29180613	4000	29179178
chr6:29281342-29282175	chr6	29281342	29282175	833	29281662
chr6:30080599-30086625	chr6	30080599	30086625	6026	30083191
chr6:31254851-31260632	chr6	31254851	31260632	5781	31257068
chr6:32257110-32261754	chr6	32257110	32261754	4644	32259683
chr6:32467600-32470756	chr6	32467600	32470756	3156	32470187
chr6:38292262-38293141	chr6	38292262	38293141	879	38292404
chr6:38298861-38302023	chr6	38298861	38302023	3162	38301448
chr6:44584172-44590313	chr6	44584172	44590313	6141	44586755
chr6:44754479-44760501	chr6	44754479	44760501	6022	44757071
chr6:44762804-44766579	chr6	44762804	44766579	3775	44765379
chr6:45016314-45019487	chr6	45016314	45019487	3173	45018935
chr6:45669375-45675401	chr6	45669375	45675401	6026	45671964
chr6:45847121-45850077	chr6	45847121	45850077	2956	45849707
chr6:46224788-46230892	chr6	46224788	46230892	6104	46227373
chr6:47556647-47559250	chr6	47556647	47559250	2603	47558911
chr6:47635647-47641166	chr6	47635647	47641166	5519	47638215
chr6:48010595-48013257	chr6	48010595	48013257	2662	48013162
chr6:49145020-49151409	chr6	49145020	49151409	6389	49147693
chr6:49791502-49797511	chr6	49791502	49797511	6009	49794070
chr6:50223304-50229465	chr6	50223304	50229465	6161	50225893
chr6:50915848-50921983	chr6	50915848	50921983	6135	50918423
chr6:51031394-51037505	chr6	51031394	51037505	6111	51033980
chr6:51082478-51084079	chr6	51082478	51084079	1601	51082758
chr6:51101197-51103353	chr6	51101197	51103353	2156	51102782
chr6:51130369-51136901	chr6	51130369	51136901	6532	51132969
chr6:51187669-51193819	chr6	51187669	51193819	6150	51190255
chr6:51343302-51349763	chr6	51343302	51349763	6461	51345865
chr6:51480367-51486547	chr6	51480367	51486547	6180	51482956
chr6:51666557-51671971	chr6	51666557	51671971	5414	51669134
chr6:51794214-51796817	chr6	51794214	51796817	2603	51796095
chr6:51848918-51855371	chr6	51848918	51855371	6453	51851485
chr6:51918198-51921272	chr6	51918198	51921272	3074	51920710
chr6:52090943-52097103	chr6	52090943	52097103	6160	52093534
chr6:52442298-52445301	chr6	52442298	52445301	3003	52444877
chr6:52771227-52777614	chr6	52771227	52777614	6387	52773817
chr6:52851045-52855068	chr6	52851045	52855068	4023	52853613
chr6:53400050-53406226	chr6	53400050	53406226	6176	53402657
chr6:54405823-54408982	chr6	54405823	54408982	3159	54408411
chr6:54455444-54458527	chr6	54455444	54458527	3083	54456116
chr6:54499670-54502486	chr6	54499670	54502486	2816	54502240
chr6:54820265-54823378	chr6	54820265	54823378	3113	54821251
chr6:55120803-55122619	chr6	55120803	55122619	1816	55122051
chr6:55308398-55311913	chr6	55308398	55311913	3515	55308697
chr6:55363436-55369467	chr6	55363436	55369467	6031	55366028
chr6:55805404-55807879	chr6	55805404	55807879	2475	55807648
chr6:56301711-56307870	chr6	56301711	56307870	6159	56304320
chr6:56565417-56565589	chr6	56565417	56565589	172	56565478
chr6:56582601-56586586	chr6	56582601	56586586	3985	56585182
chr6:56779724-56785868	chr6	56779724	56785868	6144	56782311
chr6:57268635-57274780	chr6	57268635	57274780	6145	57271216
chr6:57451781-57457923	chr6	57451781	57457923	6142	57454375
chr6:57884518-57885477	chr6	57884518	57885477	959	57885412
chr6:58226623-58232747	chr6	58226623	58232747	6124	58229184
chr6:58311330-58313277	chr6	58311330	58313277	1947	58312343
chr6:60344718-60350882	chr6	60344718	60350882	6164	60347332
chr6:60455343-60461373	chr6	60455343	60461373	6030	60457931
chr6:60616507-60622518	chr6	60616507	60622518	6011	60619085
chr6:60629792-60635918	chr6	60629792	60635918	6126	60632374
chr6:60651936-60654986	chr6	60651936	60654986	3050	60654548
chr6:60803489-60806801	chr6	60803489	60806801	3312	60806073
chr6:61128036-61134432	chr6	61128036	61134432	6396	61130609
chr6:61163741-61166488	chr6	61163741	61166488	2747	61165553
chr6:61247800-61250813	chr6	61247800	61250813	3013	61249651
chr6:61259929-61264079	chr6	61259929	61264079	4150	61262509
chr6:61891288-61891576	chr6	61891288	61891576	288	61891521
chr6:62070338-62073097	chr6	62070338	62073097	2759	62072929
chr6:62225526-62228814	chr6	62225526	62228814	3288	62228111
chr6:62382438-62385284	chr6	62382438	62385284	2846	62385030
chr6:62826695-62829860	chr6	62826695	62829860	3165	62829274
chr6:63039532-63043347	chr6	63039532	63043347	3815	63042108
chr6:63070278-63076424	chr6	63070278	63076424	6146	63072850
chr6:63356837-63359849	chr6	63356837	63359849	3012	63359421
chr6:63736094-63737742	chr6	63736094	63737742	1648	63737676
chr6:63746087-63748167	chr6	63746087	63748167	2080	63746513
chr6:63779748-63782889	chr6	63779748	63782889	3141	63782338
chr6:63873003-63879092	chr6	63873003	63879092	6089	63875559
chr6:64091754-64097759	chr6	64091754	64097759	6005	64094343
chr6:64238757-64241657	chr6	64238757	64241657	2900	64241332
chr6:64634871-64636033	chr6	64634871	64636033	1162	64635911
chr6:64687392-64688842	chr6	64687392	64688842	1450	64687808
chr6:65617555-65621820	chr6	65617555	65621820	4265	65620142
chr6:66651865-66654694	chr6	66651865	66654694	2829	66654439
chr6:66869781-66875408	chr6	66869781	66875408	5627	66872345
chr6:67261250-67263238	chr6	67261250	67263238	1988	67263193
chr6:67295505-67301096	chr6	67295505	67301096	5591	67297256
chr6:67485408-67486685	chr6	67485408	67486685	1277	67485568
chr6:67552358-67558796	chr6	67552358	67558796	6438	67554947
chr6:67728589-67735011	chr6	67728589	67735011	6422	67731181
chr6:67947160-67950360	chr6	67947160	67950360	3200	67949705
chr6:68450616-68453959	chr6	68450616	68453959	3343	68452840
chr6:68785158-68790168	chr6	68785158	68790168	5010	68787742
chr6:69254708-69257516	chr6	69254708	69257516	2808	69257291
chr6:69439539-69445568	chr6	69439539	69445568	6029	69442126
chr6:69999882-70004834	chr6	69999882	70004834	4952	70002443
chr6:70496257-70501915	chr6	70496257	70501915	5658	70498062
chr6:70744173-70746865	chr6	70744173	70746865	2692	70746760
chr6:70765747-70771897	chr6	70765747	70771897	6150	70768338
chr6:70800519-70806617	chr6	70800519	70806617	6098	70803094
chr6:71826715-71832734	chr6	71826715	71832734	6019	71829302
chr6:72427356-72430132	chr6	72427356	72430132	2776	72429266
chr6:72491403-72492725	chr6	72491403	72492725	1322	72492473
chr6:72800170-72802399	chr6	72800170	72802399	2229	72800217
chr6:72978683-72984846	chr6	72978683	72984846	6163	72981246
chr6:72988654-72994686	chr6	72988654	72994686	6032	72991246
chr6:73310507-73312783	chr6	73310507	73312783	2276	73311284
chr6:73835382-73841425	chr6	73835382	73841425	6043	73837970
chr6:73957915-73961503	chr6	73957915	73961503	3588	73960509
chr6:74007167-74013006	chr6	74007167	74013006	5839	74009759
chr6:74027577-74030817	chr6	74027577	74030817	3240	74029406
chr6:74080946-74084883	chr6	74080946	74084883	3937	74081628
chr6:74097012-74099837	chr6	74097012	74099837	2825	74099590
chr6:74217198-74223445	chr6	74217198	74223445	6247	74219878
chr6:74337744-74343920	chr6	74337744	74343920	6176	74340370
chr6:74373058-74379082	chr6	74373058	74379082	6024	74375631
chr6:74404786-74405555	chr6	74404786	74405555	769	74405525
chr6:74785941-74789099	chr6	74785941	74789099	3158	74788557
chr6:74883283-74889425	chr6	74883283	74889425	6142	74885872
chr6:75682405-75688529	chr6	75682405	75688529	6124	75684986
chr6:75899741-75905745	chr6	75899741	75905745	6004	75902313
chr6:75953623-75956912	chr6	75953623	75956912	3289	75956185
chr6:76105618-76111641	chr6	76105618	76111641	6023	76108202
chr6:76114035-76118914	chr6	76114035	76118914	4879	76115364
chr6:76137899-76143882	chr6	76137899	76143882	5983	76140374
chr6:76293544-76299676	chr6	76293544	76299676	6132	76296127
chr6:76369432-76375591	chr6	76369432	76375591	6159	76372014
chr6:76625209-76629278	chr6	76625209	76629278	4069	76625727
chr6:76745649-76751142	chr6	76745649	76751142	5493	76748240
chr6:76824416-76825120	chr6	76824416	76825120	704	76824838
chr6:76844485-76848874	chr6	76844485	76848874	4389	76847067
chr6:76900222-76906229	chr6	76900222	76906229	6007	76902798
chr6:76978791-76980731	chr6	76978791	76980731	1940	76979884
chr6:77049415-77049994	chr6	77049415	77049994	579	77049865
chr6:77082477-77088496	chr6	77082477	77088496	6019	77085063
chr6:77694264-77699172	chr6	77694264	77699172	4908	77696853
chr6:77730626-77736661	chr6	77730626	77736661	6035	77733215
chr6:77798491-77804602	chr6	77798491	77804602	6111	77801080
chr6:77991081-77997193	chr6	77991081	77997193	6112	77993677
chr6:78357363-78358779	chr6	78357363	78358779	1416	78358525
chr6:78644412-78646743	chr6	78644412	78646743	2331	78646264
chr6:78737870-78740811	chr6	78737870	78740811	2941	78740451
chr6:78802650-78805683	chr6	78802650	78805683	3033	78804181
chr6:79251345-79257431	chr6	79251345	79257431	6086	79253887
chr6:79319638-79325774	chr6	79319638	79325774	6136	79322240
chr6:79363357-79369020	chr6	79363357	79369020	5663	79365484
chr6:79456852-79460152	chr6	79456852	79460152	3300	79459429
chr6:79658145-79664304	chr6	79658145	79664304	6159	79660727
chr6:79955939-79958076	chr6	79955939	79958076	2137	79956346
chr6:80048090-80051061	chr6	80048090	80051061	2971	80050670
chr6:80138292-80141272	chr6	80138292	80141272	2980	80140892
chr6:80427678-80433627	chr6	80427678	80433627	5949	80430451
chr6:80492276-80498296	chr6	80492276	80498296	6020	80494860
chr6:80567938-80573945	chr6	80567938	80573945	6007	80570507
chr6:80596683-80598171	chr6	80596683	80598171	1488	80597898
chr6:81012094-81018211	chr6	81012094	81018211	6117	81014655
chr6:81112065-81118183	chr6	81112065	81118183	6118	81114637
chr6:81283941-81285435	chr6	81283941	81285435	1494	81284583
chr6:81505903-81509084	chr6	81505903	81509084	3181	81508467
chr6:81953035-81959176	chr6	81953035	81959176	6141	81955625
chr6:82124188-82129156	chr6	82124188	82129156	4968	82126772
chr6:82279064-82284649	chr6	82279064	82284649	5585	82280986
chr6:82496468-82502582	chr6	82496468	82502582	6114	82499029
chr6:82543763-82547319	chr6	82543763	82547319	3556	82545591
chr6:82547320-82547645	chr6	82547320	82547645	325	82547568
chr6:82754731-82757829	chr6	82754731	82757829	3098	82755180
chr6:83287157-83293277	chr6	83287157	83293277	6120	83289720
chr6:83439693-83441655	chr6	83439693	83441655	1962	83440363
chr6:83532470-83533129	chr6	83532470	83533129	659	83532477
chr6:83541428-83544591	chr6	83541428	83544591	3163	83543995
chr6:83797742-83803770	chr6	83797742	83803770	6028	83800333
chr6:83896911-83901677	chr6	83896911	83901677	4766	83899553
chr6:84117322-84117612	chr6	84117322	84117612	290	84117461
chr6:84129751-84131882	chr6	84129751	84131882	2131	84130445
chr6:84364564-84369591	chr6	84364564	84369591	5027	84367124
chr6:84817603-84823009	chr6	84817603	84823009	5406	84820159
chr6:84826429-84832562	chr6	84826429	84832562	6133	84829017
chr6:85145616-85150076	chr6	85145616	85150076	4460	85148191
chr6:85208738-85213637	chr6	85208738	85213637	4899	85209737
chr6:85302229-85307040	chr6	85302229	85307040	4811	85304805
chr6:85694799-85700883	chr6	85694799	85700883	6084	85697373
chr6:85757313-85762711	chr6	85757313	85762711	5398	85759897
chr6:85782835-85788228	chr6	85782835	85788228	5393	85784670
chr6:85829377-85835517	chr6	85829377	85835517	6140	85831963
chr6:85847892-85854366	chr6	85847892	85854366	6474	85850477
chr6:85857293-85863437	chr6	85857293	85863437	6144	85859880
chr6:85903035-85909164	chr6	85903035	85909164	6129	85905613
chr6:85930759-85936589	chr6	85930759	85936589	5830	85933027
chr6:85952904-85959050	chr6	85952904	85959050	6146	85955491
chr6:85999046-86005073	chr6	85999046	86005073	6027	86001634
chr6:86021488-86027515	chr6	86021488	86027515	6027	86024077
chr6:86051815-86057959	chr6	86051815	86057959	6144	86054406
chr6:86059818-86066251	chr6	86059818	86066251	6433	86062379
chr6:86099326-86102585	chr6	86099326	86102585	3259	86101524
chr6:86266537-86272653	chr6	86266537	86272653	6116	86269123
chr6:86278158-86284001	chr6	86278158	86284001	5843	86280731
chr6:86300077-86303737	chr6	86300077	86303737	3660	86302637
chr6:86665208-86669252	chr6	86665208	86669252	4044	86667798
chr6:86689388-86695521	chr6	86689388	86695521	6133	86691969
chr6:86701091-86705385	chr6	86701091	86705385	4294	86703681
chr6:86804753-86806652	chr6	86804753	86806652	1899	86806159
chr6:86806663-86812682	chr6	86806663	86812682	6019	86809252
chr6:86842511-86846099	chr6	86842511	86846099	3588	86845103
chr6:87034251-87039334	chr6	87034251	87039334	5083	87035780
chr6:87323278-87329278	chr6	87323278	87329278	6000	87325854
chr6:87445214-87447956	chr6	87445214	87447956	2742	87447766
chr6:88521207-88527351	chr6	88521207	88527351	6144	88523795
chr6:89225263-89231287	chr6	89225263	89231287	6024	89227852
chr6:90733744-90740207	chr6	90733744	90740207	6463	90736332
chr6:91047151-91053161	chr6	91047151	91053161	6010	91049735
chr6:91186276-91191341	chr6	91186276	91191341	5065	91188804
chr6:91338278-91339393	chr6	91338278	91339393	1115	91338752
chr6:91371398-91374669	chr6	91371398	91374669	3271	91373818
chr6:91723993-91726719	chr6	91723993	91726719	2726	91726575
chr6:91791137-91794356	chr6	91791137	91794356	3219	91793730
chr6:92651157-92656207	chr6	92651157	92656207	5050	92653732
chr6:93631588-93637609	chr6	93631588	93637609	6021	93634176
chr6:93865738-93871783	chr6	93865738	93871783	6045	93868344
chr6:94197995-94204060	chr6	94197995	94204060	6065	94200618
chr6:94869039-94874443	chr6	94869039	94874443	5404	94870871
chr6:95298737-95302557	chr6	95298737	95302557	3820	95301317
chr6:96270691-96273867	chr6	96270691	96273867	3176	96273270
chr6:96472078-96475459	chr6	96472078	96475459	3381	96474662
chr6:96494374-96500444	chr6	96494374	96500444	6070	96496941
chr6:96982567-96987020	chr6	96982567	96987020	4453	96983468
chr6:97155320-97159310	chr6	97155320	97159310	3990	97157907
chr6:97376538-97382707	chr6	97376538	97382707	6169	97379119
chr6:97767051-97769960	chr6	97767051	97769960	2909	97769644
chr6:98008132-98011038	chr6	98008132	98011038	2906	98010724
chr6:98059455-98062982	chr6	98059455	98062982	3527	98062033
chr6:98083035-98089205	chr6	98083035	98089205	6170	98085630
chr6:98151439-98155477	chr6	98151439	98155477	4038	98154059
chr6:98520267-98522397	chr6	98520267	98522397	2130	98521902
chr6:99042467-99044557	chr6	99042467	99044557	2090	99042599
chr6:99198430-99203842	chr6	99198430	99203842	5412	99200968
chr6:99670803-99676939	chr6	99670803	99676939	6136	99673379
chr6:99773917-99778289	chr6	99773917	99778289	4372	99776579
chr6:99925836-99931990	chr6	99925836	99931990	6154	99928425
chr6:99969576-99975717	chr6	99969576	99975717	6141	99972149
chr6:100580586-100586736	chr6	100580586	100586736	6150	100583174
chr6:100737233-100743383	chr6	100737233	100743383	6150	100739524
chr6:100908125-100912189	chr6	100908125	100912189	4064	100910709
chr6:101048507-101054605	chr6	101048507	101054605	6098	101050752
chr6:101152252-101158269	chr6	101152252	101158269	6017	101154834
chr6:101245976-101248888	chr6	101245976	101248888	2912	101248562
chr6:101788209-101794361	chr6	101788209	101794361	6152	101790795
chr6:102097420-102100458	chr6	102097420	102100458	3038	102099976
chr6:102165162-102166697	chr6	102165162	102166697	1535	102165424
chr6:102752889-102758907	chr6	102752889	102758907	6018	102755477
chr6:102803420-102809584	chr6	102803420	102809584	6164	102805996
chr6:103012508-103018955	chr6	103012508	103018955	6447	103015102
chr6:103491167-103497188	chr6	103491167	103497188	6021	103493756
chr6:103589391-103592053	chr6	103589391	103592053	2662	103591967
chr6:104000640-104001944	chr6	104000640	104001944	1304	104001615
chr6:104061664-104062127	chr6	104061664	104062127	463	104062028
chr6:104872526-104873267	chr6	104872526	104873267	741	104873105
chr6:105046019-105050320	chr6	105046019	105050320	4301	105048604
chr6:105228554-105231247	chr6	105228554	105231247	2693	105231133
chr6:107166663-107170611	chr6	107166663	107170611	3948	107167065
chr6:107854715-107860748	chr6	107854715	107860748	6033	107857307
chr6:107887759-107892287	chr6	107887759	107892287	4528	107889178
chr6:108975006-108980794	chr6	108975006	108980794	5788	108977586
chr6:109109551-109113218	chr6	109109551	109113218	3667	109112111
chr6:109245218-109251251	chr6	109245218	109251251	6033	109247810
chr6:109534604-109540728	chr6	109534604	109540728	6124	109537192
chr6:109598086-109604210	chr6	109598086	109604210	6124	109600666
chr6:109751295-109751814	chr6	109751295	109751814	519	109751502
chr6:109753255-109756992	chr6	109753255	109756992	3737	109754528
chr6:110155536-110158535	chr6	110155536	110158535	2999	110158144
chr6:111902999-111909020	chr6	111902999	111909020	6021	111905583
chr6:112532297-112535640	chr6	112532297	112535640	3343	112534883
chr6:112628882-112632716	chr6	112628882	112632716	3834	112629780
chr6:112914365-112920318	chr6	112914365	112920318	5953	112916956
chr6:113212383-113215611	chr6	113212383	113215611	3228	113214950
chr6:114628020-114634115	chr6	114628020	114634115	6095	114630591
chr6:114720722-114726752	chr6	114720722	114726752	6030	114723312
chr6:114799879-114806049	chr6	114799879	114806049	6170	114802497
chr6:114914635-114917799	chr6	114914635	114917799	3164	114917224
chr6:114923181-114929341	chr6	114923181	114929341	6160	114925786
chr6:114970386-114976401	chr6	114970386	114976401	6015	114972953
chr6:115297581-115298802	chr6	115297581	115298802	1221	115298471
chr6:115475035-115481215	chr6	115475035	115481215	6180	115477627
chr6:116774806-116777383	chr6	116774806	116777383	2577	116777338
chr6:117037875-117040617	chr6	117037875	117040617	2742	117040355
chr6:117095268-117101409	chr6	117095268	117101409	6141	117097855
chr6:117798681-117802733	chr6	117798681	117802733	4052	117801269
chr6:117805090-117811441	chr6	117805090	117811441	6351	117807561
chr6:117851684-117854799	chr6	117851684	117854799	3115	117854276
chr6:118338046-118343011	chr6	118338046	118343011	4965	118339133
chr6:118515753-118519097	chr6	118515753	118519097	3344	118518318
chr6:118817122-118823550	chr6	118817122	118823550	6428	118819708
chr6:118833884-118838156	chr6	118833884	118838156	4272	118836433
chr6:119373604-119376410	chr6	119373604	119376410	2806	119375041
chr6:120154699-120156202	chr6	120154699	120156202	1503	120155991
chr6:120263391-120268890	chr6	120263391	120268890	5499	120265980
chr6:120292727-120297060	chr6	120292727	120297060	4333	120295130
chr6:120519376-120522331	chr6	120519376	120522331	2955	120521964
chr6:120637494-120643647	chr6	120637494	120643647	6153	120640079
chr6:120812670-120813223	chr6	120812670	120813223	553	120813175
chr6:121148879-121154449	chr6	121148879	121154449	5570	121150591
chr6:121566042-121571330	chr6	121566042	121571330	5288	121568628
chr6:122227324-122231225	chr6	122227324	122231225	3901	122229921
chr6:122377229-122381327	chr6	122377229	122381327	4098	122379814
chr6:122429618-122430385	chr6	122429618	122430385	767	122430095
chr6:122537169-122543352	chr6	122537169	122543352	6183	122539769
chr6:122879305-122884202	chr6	122879305	122884202	4897	122881893
chr6:122927079-122931086	chr6	122927079	122931086	4007	122927194
chr6:122939356-122945550	chr6	122939356	122945550	6194	122941992
chr6:123257276-123259262	chr6	123257276	123259262	1986	123258724
chr6:123443656-123445260	chr6	123443656	123445260	1604	123445108
chr6:124342848-124348613	chr6	124342848	124348613	5765	124345422
chr6:124407195-124413266	chr6	124407195	124413266	6071	124409781
chr6:124706843-124712830	chr6	124706843	124712830	5987	124709427
chr6:126161091-126164996	chr6	126161091	126164996	3905	126163640
chr6:126593829-126599355	chr6	126593829	126599355	5526	126596416
chr6:126861519-126864870	chr6	126861519	126864870	3351	126864115
chr6:127406621-127410219	chr6	127406621	127410219	3598	127409185
chr6:127667429-127672947	chr6	127667429	127672947	5518	127670011
chr6:128774138-128780383	chr6	128774138	128780383	6245	128776802
chr6:128905633-128911663	chr6	128905633	128911663	6030	128908223
chr6:129167160-129173198	chr6	129167160	129173198	6038	129169750
chr6:129222349-129228452	chr6	129222349	129228452	6103	129224921
chr6:129807049-129811774	chr6	129807049	129811774	4725	129809609
chr6:131234906-131241067	chr6	131234906	131241067	6161	131237494
chr6:131526505-131529990	chr6	131526505	131529990	3485	131528753
chr6:132981097-132986061	chr6	132981097	132986061	4964	132983668
chr6:133020691-133026746	chr6	133020691	133026746	6055	133023307
chr6:133117658-133123774	chr6	133117658	133123774	6116	133120240
chr6:133142073-133148104	chr6	133142073	133148104	6031	133144661
chr6:133150821-133155110	chr6	133150821	133155110	4289	133151657
chr6:133469892-133472969	chr6	133469892	133472969	3077	133471680
chr6:135150351-135156798	chr6	135150351	135156798	6447	135152940
chr6:135765469-135771509	chr6	135765469	135771509	6040	135768073
chr6:135978719-135979619	chr6	135978719	135979619	900	135979465
chr6:136098776-136101594	chr6	136098776	136101594	2818	136101352
chr6:136138968-136143196	chr6	136138968	136143196	4228	136141554
chr6:136846341-136850531	chr6	136846341	136850531	4190	136848939
chr6:137885691-137891444	chr6	137885691	137891444	5753	137887952
chr6:137984177-137989733	chr6	137984177	137989733	5556	137986752
chr6:138705937-138712050	chr6	138705937	138712050	6113	138708503
chr6:139084431-139090562	chr6	139084431	139090562	6131	139087008
chr6:139121058-139124504	chr6	139121058	139124504	3446	139123647
chr6:140161514-140162393	chr6	140161514	140162393	879	140161763
chr6:140970832-140973119	chr6	140970832	140973119	2287	140970886
chr6:141619175-141620320	chr6	141619175	141620320	1145	141620072
chr6:142093154-142097369	chr6	142093154	142097369	4215	142095740
chr6:143029245-143033053	chr6	143029245	143033053	3808	143031811
chr6:143302225-143308357	chr6	143302225	143308357	6132	143304814
chr6:143665875-143670919	chr6	143665875	143670919	5044	143668462
chr6:143796418-143800252	chr6	143796418	143800252	3834	143798974
chr6:143851576-143857071	chr6	143851576	143857071	5495	143854039
chr6:144041197-144047335	chr6	144041197	144047335	6138	144043765
chr6:144971717-144977868	chr6	144971717	144977868	6151	144974312
chr6:145297587-145302378	chr6	145297587	145302378	4791	145300178
chr6:145852473-145854370	chr6	145852473	145854370	1897	145853285
chr6:146082744-146084912	chr6	146082744	146084912	2168	146083821
chr6:146118440-146122098	chr6	146118440	146122098	3658	146121025
chr6:146938981-146942369	chr6	146938981	146942369	3388	146941521
chr6:147795064-147800622	chr6	147795064	147800622	5558	147797656
chr6:148159413-148163186	chr6	148159413	148163186	3773	148161988
chr6:151711520-151717313	chr6	151711520	151717313	5793	151713426
chr6:152708860-152712430	chr6	152708860	152712430	3570	152711450
chr6:152966492-152969683	chr6	152966492	152969683	3191	152968928
chr6:153691047-153694637	chr6	153691047	153694637	3590	153693623
chr6:156324980-156331010	chr6	156324980	156331010	6030	156327570
chr6:157736138-157738632	chr6	157736138	157738632	2494	157737239
chr6:158178477-158184036	chr6	158178477	158184036	5559	158180458
chr6:158614489-158619515	chr6	158614489	158619515	5026	158617071
chr6:159284524-159290996	chr6	159284524	159290996	6472	159287094
chr6:160208728-160214880	chr6	160208728	160214880	6152	160211308
chr6:160679719-160685751	chr6	160679719	160685751	6032	160682310
chr6:160867097-160870043	chr6	160867097	160870043	2946	160869240
chr6:161172644-161178755	chr6	161172644	161178755	6111	161175236
chr6:162838592-162844620	chr6	162838592	162844620	6028	162841183
chr6:162989737-162995762	chr6	162989737	162995762	6025	162992328
chr6:164472363-164473287	chr6	164472363	164473287	924	164472792
chr6:164485582-164491400	chr6	164485582	164491400	5818	164487539
chr6:164702727-164708899	chr6	164702727	164708899	6172	164705340
chr6:164781960-164787983	chr6	164781960	164787983	6023	164784547
chr6:164947565-164948938	chr6	164947565	164948938	1373	164948407
chr6:167080930-167086907	chr6	167080930	167086907	5977	167083525
chr6:167332442-167334509	chr6	167332442	167334509	2067	167333530
chr6:169347911-169354318	chr6	169347911	169354318	6407	169350465
chr6:170335039-170339506	chr6	170335039	170339506	4467	170337618
chr6:170643922-170650346	chr6	170643922	170650346	6424	170646467
chr6_GL000250v2_alt:546975-547808	chr6_GL000250v2_alt	546975	547808	833	547295
chr6_GL000250v2_alt:1338691-1344717	chr6_GL000250v2_alt	1338691	1344717	6026	1341283
chr6_GL000250v2_alt:3799845-3803000	chr6_GL000250v2_alt	3799845	3803000	3155	3802431
chr6_GL000251v2_alt:663176-667175	chr6_GL000251v2_alt	663176	667175	3999	665741
chr6_GL000251v2_alt:767910-768743	chr6_GL000251v2_alt	767910	768743	833	768230
chr6_GL000251v2_alt:1560370-1566396	chr6_GL000251v2_alt	1560370	1566396	6026	1562962
chr6_GL000251v2_alt:2735761-2741542	chr6_GL000251v2_alt	2735761	2741542	5781	2737977
chr6_GL000251v2_alt:3695521-3700168	chr6_GL000251v2_alt	3695521	3700168	4647	3698096
chr6_GL000251v2_alt:3905698-3908854	chr6_GL000251v2_alt	3905698	3908854	3156	3908285
chr6_GL000252v2_alt:442228-446228	chr6_GL000252v2_alt	442228	446228	4000	444793
chr6_GL000252v2_alt:546952-547785	chr6_GL000252v2_alt	546952	547785	833	547272
chr6_GL000252v2_alt:1338534-1342542	chr6_GL000252v2_alt	1338534	1342542	4008	1339108
chr6_GL000252v2_alt:2512635-2518416	chr6_GL000252v2_alt	2512635	2518416	5781	2514851
chr6_GL000252v2_alt:3498531-3503178	chr6_GL000252v2_alt	3498531	3503178	4647	3501106
chr6_GL000252v2_alt:3707890-3711020	chr6_GL000252v2_alt	3707890	3711020	3130	3710450
chr6_GL000253v2_alt:442188-446188	chr6_GL000253v2_alt	442188	446188	4000	444753
chr6_GL000253v2_alt:546915-547748	chr6_GL000253v2_alt	546915	547748	833	547235
chr6_GL000253v2_alt:1341349-1347375	chr6_GL000253v2_alt	1341349	1347375	6026	1343941
chr6_GL000253v2_alt:2563891-2569670	chr6_GL000253v2_alt	2563891	2569670	5779	2566104
chr6_GL000253v2_alt:3562122-3566767	chr6_GL000253v2_alt	3562122	3566767	4645	3564696
chr6_GL000253v2_alt:3771854-3774984	chr6_GL000253v2_alt	3771854	3774984	3130	3774414
chr6_GL000253v2_alt:3880142-3884425	chr6_GL000253v2_alt	3880142	3884425	4283	3882928
chr6_GL000254v2_alt:442354-446354	chr6_GL000254v2_alt	442354	446354	4000	444919
chr6_GL000254v2_alt:1424689-1430715	chr6_GL000254v2_alt	1424689	1430715	6026	1427281
chr6_GL000254v2_alt:2597568-2603351	chr6_GL000254v2_alt	2597568	2603351	5783	2599785
chr6_GL000254v2_alt:3808485-3811615	chr6_GL000254v2_alt	3808485	3811615	3130	3811045
chr6_GL000255v2_alt:442211-446211	chr6_GL000255v2_alt	442211	446211	4000	444776
chr6_GL000255v2_alt:1335751-1341783	chr6_GL000255v2_alt	1335751	1341783	6032	1338342
chr6_GL000255v2_alt:3480475-3485121	chr6_GL000255v2_alt	3480475	3485121	4646	3483049
chr6_GL000255v2_alt:3690692-3693847	chr6_GL000255v2_alt	3690692	3693847	3155	3693278
chr6_GL000256v2_alt:485997-489997	chr6_GL000256v2_alt	485997	489997	4000	488562
chr6_GL000256v2_alt:590742-591575	chr6_GL000256v2_alt	590742	591575	833	591062
chr6_GL000256v2_alt:1379518-1385544	chr6_GL000256v2_alt	1379518	1385544	6026	1382110
chr6_GL000256v2_alt:3573391-3578036	chr6_GL000256v2_alt	3573391	3578036	4645	3575965
chr6_GL000256v2_alt:3782884-3786014	chr6_GL000256v2_alt	3782884	3786014	3130	3785444
chr6_GL000256v2_alt:3890845-3895126	chr6_GL000256v2_alt	3890845	3895126	4281	3893629
chr6_GL383533v1_alt:121810-124736	chr6_GL383533v1_alt	121810	124736	2926	124407
chr6_KI270798v1_alt:62277-66744	chr6_KI270798v1_alt	62277	66744	4467	64856
chr6_KI270801v1_alt:12627-18145	chr6_KI270801v1_alt	12627	18145	5518	15209
chr7:3601677-3604313	chr7	3601677	3604313	2636	3604271
chr7:6969982-6974313	chr7	6969982	6974313	4331	6972565
chr7:7005804-7011948	chr7	7005804	7011948	6144	7008384
chr7:7139613-7145747	chr7	7139613	7145747	6134	7142172
chr7:7196064-7202373	chr7	7196064	7202373	6309	7198622
chr7:7388029-7394394	chr7	7388029	7394394	6365	7390580
chr7:7656316-7662777	chr7	7656316	7662777	6461	7658893
chr7:8298113-8304140	chr7	8298113	8304140	6027	8300701
chr7:8726340-8732368	chr7	8726340	8732368	6028	8728927
chr7:9066715-9068807	chr7	9066715	9068807	2092	9067464
chr7:9163396-9169854	chr7	9163396	9169854	6458	9165958
chr7:9398757-9404781	chr7	9398757	9404781	6024	9401350
chr7:9426888-9427978	chr7	9426888	9427978	1090	9427569
chr7:9827089-9827912	chr7	9827089	9827912	823	9827708
chr7:10805898-10812050	chr7	10805898	10812050	6152	10808489
chr7:10960101-10966227	chr7	10960101	10966227	6126	10962665
chr7:11347723-11352432	chr7	11347723	11352432	4709	11350287
chr7:12427746-12432489	chr7	12427746	12432489	4743	12428928
chr7:12935641-12940227	chr7	12935641	12940227	4586	12936655
chr7:12996737-13001967	chr7	12996737	13001967	5230	12999299
chr7:13084755-13088345	chr7	13084755	13088345	3590	13087344
chr7:13268694-13274829	chr7	13268694	13274829	6135	13271277
chr7:13668087-13674469	chr7	13668087	13674469	6382	13670654
chr7:14355263-14356352	chr7	14355263	14356352	1089	14355865
chr7:14659307-14660657	chr7	14659307	14660657	1350	14660321
chr7:16100544-16101613	chr7	16100544	16101613	1069	16101241
chr7:16252494-16253645	chr7	16252494	16253645	1151	16252693
chr7:16378112-16384140	chr7	16378112	16384140	6028	16380578
chr7:16896990-16900197	chr7	16896990	16900197	3207	16897548
chr7:17349343-17354805	chr7	17349343	17354805	5462	17351050
chr7:17566032-17571676	chr7	17566032	17571676	5644	17568123
chr7:18007773-18013291	chr7	18007773	18013291	5518	18009521
chr7:18135301-18138283	chr7	18135301	18138283	2982	18137893
chr7:18169457-18175596	chr7	18169457	18175596	6139	18172032
chr7:18734266-18738328	chr7	18734266	18738328	4062	18736822
chr7:18985072-18991069	chr7	18985072	18991069	5997	18987655
chr7:19189041-19195047	chr7	19189041	19195047	6006	19191635
chr7:19542287-19548702	chr7	19542287	19548702	6415	19544850
chr7:19634978-19635626	chr7	19634978	19635626	648	19635182
chr7:19683373-19687327	chr7	19683373	19687327	3954	19685957
chr7:19788718-19790110	chr7	19788718	19790110	1392	19789490
chr7:19877681-19883794	chr7	19877681	19883794	6113	19880235
chr7:19883968-19890109	chr7	19883968	19890109	6141	19886552
chr7:19900578-19906684	chr7	19900578	19906684	6106	19903140
chr7:19948720-19954835	chr7	19948720	19954835	6115	19951305
chr7:20883426-20888173	chr7	20883426	20888173	4747	20886007
chr7:20922358-20926917	chr7	20922358	20926917	4559	20924941
chr7:21176660-21182175	chr7	21176660	21182175	5515	21179235
chr7:21232058-21236010	chr7	21232058	21236010	3952	21234612
chr7:21339343-21345513	chr7	21339343	21345513	6170	21341932
chr7:22751978-22755018	chr7	22751978	22755018	3040	22753949
chr7:23619589-23622468	chr7	23619589	23622468	2879	23622169
chr7:23822602-23828742	chr7	23822602	23828742	6140	23825186
chr7:24001422-24005385	chr7	24001422	24005385	3963	24004014
chr7:24272980-24279128	chr7	24272980	24279128	6148	24275569
chr7:24996271-25002413	chr7	24996271	25002413	6142	24998842
chr7:25041860-25047891	chr7	25041860	25047891	6031	25044451
chr7:25700903-25702202	chr7	25700903	25702202	1299	25701880
chr7:27002454-27008595	chr7	27002454	27008595	6141	27005030
chr7:27291101-27294742	chr7	27291101	27294742	3641	27293678
chr7:27502193-27508194	chr7	27502193	27508194	6001	27504764
chr7:30414475-30420503	chr7	30414475	30420503	6028	30417065
chr7:30636808-30642830	chr7	30636808	30642830	6022	30639399
chr7:31501202-31507228	chr7	31501202	31507228	6026	31503789
chr7:32350594-32353501	chr7	32350594	32353501	2907	32353186
chr7:32682678-32688715	chr7	32682678	32688715	6037	32685282
chr7:32697653-32703545	chr7	32697653	32703545	5892	32700121
chr7:33161125-33167012	chr7	33161125	33167012	5887	33163418
chr7:33404047-33406380	chr7	33404047	33406380	2333	33405432
chr7:33521747-33527773	chr7	33521747	33527773	6026	33524337
chr7:33988619-33994636	chr7	33988619	33994636	6017	33991204
chr7:34200242-34206277	chr7	34200242	34206277	6035	34202825
chr7:34629582-34631892	chr7	34629582	34631892	2310	34629715
chr7:35659882-35664948	chr7	35659882	35664948	5066	35662462
chr7:35739212-35744635	chr7	35739212	35744635	5423	35741783
chr7:36375312-36379233	chr7	36375312	36379233	3921	36375676
chr7:36552968-36559126	chr7	36552968	36559126	6158	36555573
chr7:37163342-37169491	chr7	37163342	37169491	6149	37165925
chr7:37298304-37301137	chr7	37298304	37301137	2833	37300856
chr7:37612053-37618072	chr7	37612053	37618072	6019	37614644
chr7:37806535-37807960	chr7	37806535	37807960	1425	37806984
chr7:38667261-38668913	chr7	38667261	38668913	1652	38668455
chr7:39007527-39013552	chr7	39007527	39013552	6025	39010111
chr7:39023959-39025292	chr7	39023959	39025292	1333	39025093
chr7:39961635-39967144	chr7	39961635	39967144	5509	39964207
chr7:40333760-40339892	chr7	40333760	40339892	6132	40336336
chr7:40818763-40822562	chr7	40818763	40822562	3799	40821352
chr7:40949205-40954590	chr7	40949205	40954590	5385	40951047
chr7:40954596-40957447	chr7	40954596	40957447	2851	40956215
chr7:41549601-41552215	chr7	41549601	41552215	2614	41552170
chr7:42580573-42586752	chr7	42580573	42586752	6179	42583162
chr7:42859165-42862929	chr7	42859165	42862929	3764	42861700
chr7:43773137-43779287	chr7	43773137	43779287	6150	43775728
chr7:45377507-45383528	chr7	45377507	45383528	6021	45380087
chr7:45462439-45468640	chr7	45462439	45468640	6201	45465083
chr7:45489478-45495748	chr7	45489478	45495748	6270	45492051
chr7:45666136-45669629	chr7	45666136	45669629	3493	45668718
chr7:45693153-45693654	chr7	45693153	45693654	501	45693422
chr7:45947419-45953420	chr7	45947419	45953420	6001	45949987
chr7:48601227-48607497	chr7	48601227	48607497	6270	48603817
chr7:49003616-49007591	chr7	49003616	49007591	3975	49006193
chr7:49114952-49117735	chr7	49114952	49117735	2783	49116557
chr7:49662687-49665887	chr7	49662687	49665887	3200	49665281
chr7:49680245-49686300	chr7	49680245	49686300	6055	49682862
chr7:50231440-50234077	chr7	50231440	50234077	2637	50234028
chr7:50570841-50576976	chr7	50570841	50576976	6135	50573421
chr7:51533170-51537242	chr7	51533170	51537242	4072	51533402
chr7:51552137-51558291	chr7	51552137	51558291	6154	51554720
chr7:51594010-51600147	chr7	51594010	51600147	6137	51596586
chr7:51833472-51839489	chr7	51833472	51839489	6017	51836052
chr7:52892584-52894061	chr7	52892584	52894061	1477	52893876
chr7:53026321-53032336	chr7	53026321	53032336	6015	53028908
chr7:53282438-53288471	chr7	53282438	53288471	6033	53284913
chr7:54041299-54047468	chr7	54041299	54047468	6169	54043882
chr7:54135415-54138307	chr7	54135415	54138307	2892	54138004
chr7:54306031-54309914	chr7	54306031	54309914	3883	54308616
chr7:54319615-54324273	chr7	54319615	54324273	4658	54320733
chr7:54498732-54504884	chr7	54498732	54504884	6152	54501321
chr7:54735417-54736305	chr7	54735417	54736305	888	54735726
chr7:54849701-54852994	chr7	54849701	54852994	3293	54852263
chr7:55289650-55295270	chr7	55289650	55295270	5620	55291514
chr7:55316546-55319376	chr7	55316546	55319376	2830	55319113
chr7:55577188-55583313	chr7	55577188	55583313	6125	55579764
chr7:56308552-56314680	chr7	56308552	56314680	6128	56311137
chr7:56506419-56512558	chr7	56506419	56512558	6139	56509021
chr7:56838414-56844525	chr7	56838414	56844525	6111	56840994
chr7:57942148-57945061	chr7	57942148	57945061	2913	57943343
chr7:57962301-57966625	chr7	57962301	57966625	4324	57964889
chr7:61307961-61311395	chr7	61307961	61311395	3434	61310551
chr7:61654184-61657617	chr7	61654184	61657617	3433	61656773
chr7:61782345-61787094	chr7	61782345	61787094	4749	61783789
chr7:61837998-61844054	chr7	61837998	61844054	6056	61840613
chr7:62083010-62086441	chr7	62083010	62086441	3431	62085597
chr7:62194561-62199312	chr7	62194561	62199312	4751	62196006
chr7:62265730-62270682	chr7	62265730	62270682	4952	62268318
chr7:62549634-62551829	chr7	62549634	62551829	2195	62549988
chr7:62736799-62742911	chr7	62736799	62742911	6112	62739367
chr7:62908880-62914986	chr7	62908880	62914986	6106	62911468
chr7:62993212-62999344	chr7	62993212	62999344	6132	62995793
chr7:63148831-63154859	chr7	63148831	63154859	6028	63151419
chr7:63335608-63340555	chr7	63335608	63340555	4947	63336669
chr7:63435660-63435896	chr7	63435660	63435896	236	63435771
chr7:63534282-63540307	chr7	63534282	63540307	6025	63536870
chr7:64007260-64012544	chr7	64007260	64012544	5284	64009830
chr7:64153980-64157098	chr7	64153980	64157098	3118	64156567
chr7:64198532-64198766	chr7	64198532	64198766	234	64198640
chr7:64645015-64648565	chr7	64645015	64648565	3550	64647595
chr7:65464481-65470584	chr7	65464481	65470584	6103	65467080
chr7:66286853-66292884	chr7	66286853	66292884	6031	66289444
chr7:70330959-70331575	chr7	70330959	70331575	616	70331136
chr7:76561201-76567355	chr7	76561201	76567355	6154	76563785
chr7:77084513-77090684	chr7	77084513	77090684	6171	77087097
chr7:77142463-77148558	chr7	77142463	77148558	6095	77145006
chr7:78268792-78275399	chr7	78268792	78275399	6607	78271542
chr7:78855267-78861359	chr7	78855267	78861359	6092	78857841
chr7:79065562-79070479	chr7	79065562	79070479	4917	79068192
chr7:79229794-79235811	chr7	79229794	79235811	6017	79232381
chr7:79928467-79933889	chr7	79928467	79933889	5422	79931023
chr7:79941091-79947236	chr7	79941091	79947236	6145	79943677
chr7:81421524-81424871	chr7	81421524	81424871	3347	81424114
chr7:82579702-82584304	chr7	82579702	82584304	4602	82582238
chr7:83711426-83717524	chr7	83711426	83717524	6098	83713989
chr7:83743742-83749311	chr7	83743742	83749311	5569	83746340
chr7:83890225-83894315	chr7	83890225	83894315	4090	83892812
chr7:83989325-83995342	chr7	83989325	83995342	6017	83991908
chr7:84049711-84055730	chr7	84049711	84055730	6019	84052299
chr7:84357136-84360527	chr7	84357136	84360527	3391	84359726
chr7:84421459-84422816	chr7	84421459	84422816	1357	84422104
chr7:84954239-84955223	chr7	84954239	84955223	984	84954442
chr7:84987440-84993591	chr7	84987440	84993591	6151	84990028
chr7:85329687-85335739	chr7	85329687	85335739	6052	85332307
chr7:85538311-85542698	chr7	85538311	85542698	4387	85539732
chr7:85989809-85990800	chr7	85989809	85990800	991	85990169
chr7:86457049-86459819	chr7	86457049	86459819	2770	86459623
chr7:86805756-86808394	chr7	86805756	86808394	2638	86808334
chr7:87022081-87024729	chr7	87022081	87024729	2648	87024652
chr7:87062407-87066379	chr7	87062407	87066379	3972	87065000
chr7:87749850-87753641	chr7	87749850	87753641	3791	87752463
chr7:87950137-87956279	chr7	87950137	87956279	6142	87952730
chr7:88551035-88557060	chr7	88551035	88557060	6025	88553626
chr7:88944932-88946837	chr7	88944932	88946837	1905	88946690
chr7:89269063-89271936	chr7	89269063	89271936	2873	89271657
chr7:89405918-89408631	chr7	89405918	89408631	2713	89408507
chr7:89459006-89461768	chr7	89459006	89461768	2762	89461582
chr7:89521961-89523759	chr7	89521961	89523759	1798	89522070
chr7:89668961-89673259	chr7	89668961	89673259	4298	89671534
chr7:89788985-89792627	chr7	89788985	89792627	3642	89791577
chr7:89896920-89902307	chr7	89896920	89902307	5387	89899479
chr7:90359889-90365278	chr7	90359889	90365278	5389	90361718
chr7:90365675-90369954	chr7	90365675	90369954	4279	90366365
chr7:90545415-90549920	chr7	90545415	90549920	4505	90547982
chr7:90634134-90640272	chr7	90634134	90640272	6138	90636722
chr7:90729874-90736281	chr7	90729874	90736281	6407	90732428
chr7:91056410-91062550	chr7	91056410	91062550	6140	91058992
chr7:91252743-91257629	chr7	91252743	91257629	4886	91255312
chr7:91389493-91395509	chr7	91389493	91395509	6016	91392067
chr7:91476684-91482819	chr7	91476684	91482819	6135	91479261
chr7:91497127-91499960	chr7	91497127	91499960	2833	91499718
chr7:91903682-91909706	chr7	91903682	91909706	6024	91906269
chr7:91985946-91986179	chr7	91985946	91986179	233	91986004
chr7:92183756-92189878	chr7	92183756	92189878	6122	92186332
chr7:92884777-92887052	chr7	92884777	92887052	2275	92886894
chr7:92919234-92923256	chr7	92919234	92923256	4022	92921806
chr7:93067497-93070815	chr7	93067497	93070815	3318	93070083
chr7:93166604-93170864	chr7	93166604	93170864	4260	93167026
chr7:93586902-93591767	chr7	93586902	93591767	4865	93588331
chr7:93787624-93793679	chr7	93787624	93793679	6055	93790239
chr7:94714545-94720320	chr7	94714545	94720320	5775	94716695
chr7:94751614-94756921	chr7	94751614	94756921	5307	94754194
chr7:94815817-94819341	chr7	94815817	94819341	3524	94818425
chr7:95020461-95023552	chr7	95020461	95023552	3091	95023066
chr7:95214969-95219602	chr7	95214969	95219602	4633	95217558
chr7:95831968-95837992	chr7	95831968	95837992	6024	95834559
chr7:96552195-96558214	chr7	96552195	96558214	6019	96554784
chr7:96579968-96585972	chr7	96579968	96585972	6004	96582560
chr7:96846650-96852680	chr7	96846650	96852680	6030	96849242
chr7:97258074-97264217	chr7	97258074	97264217	6143	97260649
chr7:99654085-99660201	chr7	99654085	99660201	6116	99656669
chr7:99799759-99803753	chr7	99799759	99803753	3994	99800217
chr7:103399570-103402393	chr7	103399570	103402393	2823	103402148
chr7:103449114-103452137	chr7	103449114	103452137	3023	103450942
chr7:103454071-103457773	chr7	103454071	103457773	3702	103454119
chr7:103457779-103463221	chr7	103457779	103463221	5442	103459340
chr7:104244397-104248291	chr7	104244397	104248291	3894	104246999
chr7:104390188-104392980	chr7	104390188	104392980	2792	104392774
chr7:104519992-104521450	chr7	104519992	104521450	1458	104520535
chr7:104557650-104563706	chr7	104557650	104563706	6056	104560268
chr7:104587127-104592971	chr7	104587127	104592971	5844	104589700
chr7:104729752-104735841	chr7	104729752	104735841	6089	104732312
chr7:106244616-106246923	chr7	106244616	106246923	2307	106246132
chr7:106436479-106440165	chr7	106436479	106440165	3686	106439052
chr7:106554533-106560578	chr7	106554533	106560578	6045	106557050
chr7:106684390-106690518	chr7	106684390	106690518	6128	106686963
chr7:107093512-107099628	chr7	107093512	107099628	6116	107096091
chr7:107646332-107652477	chr7	107646332	107652477	6145	107648918
chr7:108213786-108215212	chr7	108213786	108215212	1426	108214184
chr7:108272748-108278897	chr7	108272748	108278897	6149	108275326
chr7:108387569-108393732	chr7	108387569	108393732	6163	108390141
chr7:108937532-108943685	chr7	108937532	108943685	6153	108940124
chr7:109095676-109096741	chr7	109095676	109096741	1065	109096618
chr7:109209498-109212522	chr7	109209498	109212522	3024	109212040
chr7:109415756-109420053	chr7	109415756	109420053	4297	109418347
chr7:109649425-109652277	chr7	109649425	109652277	2852	109652003
chr7:109687136-109693273	chr7	109687136	109693273	6137	109689717
chr7:109906015-109907516	chr7	109906015	109907516	1501	109907469
chr7:109919039-109925231	chr7	109919039	109925231	6192	109921624
chr7:110030129-110036289	chr7	110030129	110036289	6160	110032721
chr7:110351579-110354589	chr7	110351579	110354589	3010	110353367
chr7:110366709-110367899	chr7	110366709	110367899	1190	110367598
chr7:110557531-110563563	chr7	110557531	110563563	6032	110560116
chr7:110655135-110661233	chr7	110655135	110661233	6098	110657716
chr7:110707004-110713024	chr7	110707004	110713024	6020	110709596
chr7:110815060-110817081	chr7	110815060	110817081	2021	110815554
chr7:111243515-111249546	chr7	111243515	111249546	6031	111246107
chr7:111699948-111702887	chr7	111699948	111702887	2939	111702525
chr7:112684067-112690619	chr7	112684067	112690619	6552	112686641
chr7:112716268-112719752	chr7	112716268	112719752	3484	112718856
chr7:113006165-113008857	chr7	113006165	113008857	2692	113008745
chr7:113049063-113054683	chr7	113049063	113054683	5620	113051656
chr7:113257696-113263724	chr7	113257696	113263724	6028	113260289
chr7:113513674-113518488	chr7	113513674	113518488	4814	113516267
chr7:113738580-113740818	chr7	113738580	113740818	2238	113739994
chr7:113776122-113782152	chr7	113776122	113782152	6030	113778714
chr7:114249798-114255939	chr7	114249798	114255939	6141	114252380
chr7:114491675-114493362	chr7	114491675	114493362	1687	114491999
chr7:114891996-114895138	chr7	114891996	114895138	3142	114894576
chr7:115025114-115031115	chr7	115025114	115031115	6001	115027675
chr7:115167768-115173789	chr7	115167768	115173789	6021	115170354
chr7:115261240-115264211	chr7	115261240	115264211	2971	115263815
chr7:115780924-115781106	chr7	115780924	115781106	182	115781056
chr7:116718497-116724489	chr7	116718497	116724489	5992	116721074
chr7:120234832-120240975	chr7	120234832	120240975	6143	120237417
chr7:121708976-121711525	chr7	121708976	121711525	2549	121710048
chr7:122278915-122284945	chr7	122278915	122284945	6030	122281504
chr7:123079343-123085436	chr7	123079343	123085436	6093	123081916
chr7:123445190-123451212	chr7	123445190	123451212	6022	123447776
chr7:123522710-123527047	chr7	123522710	123527047	4337	123525289
chr7:123851247-123857641	chr7	123851247	123857641	6394	123853815
chr7:124094093-124100210	chr7	124094093	124100210	6117	124096676
chr7:124171708-124174752	chr7	124171708	124174752	3044	124174293
chr7:124462727-124468867	chr7	124462727	124468867	6140	124465313
chr7:124578518-124581752	chr7	124578518	124581752	3234	124581136
chr7:124974555-124977871	chr7	124974555	124977871	3316	124977022
chr7:124979441-124985490	chr7	124979441	124985490	6049	124982054
chr7:126825719-126831835	chr7	126825719	126831835	6116	126828300
chr7:127963253-127966211	chr7	127963253	127966211	2958	127965844
chr7:128281160-128281258	chr7	128281160	128281258	98	128281185
chr7:130249390-130255183	chr7	130249390	130255183	5793	130251610
chr7:130764467-130767222	chr7	130764467	130767222	2755	130767016
chr7:130796311-130800622	chr7	130796311	130800622	4311	130798911
chr7:131978362-131984483	chr7	131978362	131984483	6121	131980925
chr7:133321974-133327357	chr7	133321974	133327357	5383	133323798
chr7:133889425-133895455	chr7	133889425	133895455	6030	133892013
chr7:136094205-136098388	chr7	136094205	136098388	4183	136096793
chr7:136108924-136114722	chr7	136108924	136114722	5798	136111450
chr7:136414180-136420210	chr7	136414180	136420210	6030	136416773
chr7:136561138-136562714	chr7	136561138	136562714	1576	136561471
chr7:136774756-136780783	chr7	136774756	136780783	6027	136777347
chr7:136813699-136816254	chr7	136813699	136816254	2555	136815268
chr7:138485353-138490458	chr7	138485353	138490458	5105	138487932
chr7:138531292-138537368	chr7	138531292	138537368	6076	138533803
chr7:139213370-139216959	chr7	139213370	139216959	3589	139215944
chr7:140103318-140109396	chr7	140103318	140109396	6078	140105877
chr7:140708616-140714133	chr7	140708616	140714133	5517	140711200
chr7:141062014-141068042	chr7	141062014	141068042	6028	141064606
chr7:141173961-141178274	chr7	141173961	141178274	4313	141176546
chr7:141769961-141776086	chr7	141769961	141776086	6125	141772530
chr7:141920659-141926712	chr7	141920659	141926712	6053	141923273
chr7:141980085-141986114	chr7	141980085	141986114	6029	141982673
chr7:143160218-143166355	chr7	143160218	143166355	6137	143162802
chr7:143576707-143580796	chr7	143576707	143580796	4089	143577168
chr7:144750815-144754321	chr7	144750815	144754321	3506	144752716
chr7:145110102-145112744	chr7	145110102	145112744	2642	145112634
chr7:145213160-145216399	chr7	145213160	145216399	3239	145215740
chr7:145235542-145239952	chr7	145235542	145239952	4410	145238140
chr7:145412976-145419111	chr7	145412976	145419111	6135	145415556
chr7:145611986-145612797	chr7	145611986	145612797	811	145612061
chr7:146013558-146019592	chr7	146013558	146019592	6034	146016151
chr7:146036958-146041505	chr7	146036958	146041505	4547	146039549
chr7:146132430-146135052	chr7	146132430	146135052	2622	146134999
chr7:146967331-146969707	chr7	146967331	146969707	2376	146968398
chr7:147322492-147323679	chr7	147322492	147323679	1187	147322663
chr7:147732040-147738166	chr7	147732040	147738166	6126	147734604
chr7:147842591-147848623	chr7	147842591	147848623	6032	147845183
chr7:147862933-147869109	chr7	147862933	147869109	6176	147865515
chr7:149573819-149579948	chr7	149573819	149579948	6129	149576391
chr7:150151935-150153077	chr7	150151935	150153077	1142	150152727
chr7:150574480-150580621	chr7	150574480	150580621	6141	150577060
chr7:150634646-150639406	chr7	150634646	150639406	4760	150637252
chr7:152060477-152066587	chr7	152060477	152066587	6110	152063053
chr7:152626998-152631002	chr7	152626998	152631002	4004	152629445
chr7:153117031-153122557	chr7	153117031	153122557	5526	153119615
chr7:153269486-153270152	chr7	153269486	153270152	666	153269909
chr7:153310341-153313990	chr7	153310341	153313990	3649	153312933
chr7:153865655-153871799	chr7	153865655	153871799	6144	153868239
chr7:153977557-153984005	chr7	153977557	153984005	6448	153980132
chr7:155686479-155691439	chr7	155686479	155691439	4960	155689060
chr7:156909394-156915542	chr7	156909394	156915542	6148	156911976
chr7:157099858-157104542	chr7	157099858	157104542	4684	157102439
chr7:157448419-157454545	chr7	157448419	157454545	6126	157450999
chr7_KI270806v1_alt:131965-136289	chr7_KI270806v1_alt	131965	136289	4324	134585
chr7_KI270809v1_alt:48033-54190	chr7_KI270809v1_alt	48033	54190	6157	50620
chr8:366567-372720	chr8	366567	372720	6153	369156
chr8:773346-779366	chr8	773346	779366	6020	775938
chr8:1167884-1174028	chr8	1167884	1174028	6144	1170471
chr8:1445085-1448609	chr8	1445085	1448609	3524	1447674
chr8:1595874-1601580	chr8	1595874	1601580	5706	1598452
chr8:2301964-2307993	chr8	2301964	2307993	6029	2304552
chr8:2317683-2323739	chr8	2317683	2323739	6056	2320274
chr8:3250062-3253704	chr8	3250062	3253704	3642	3252649
chr8:3270927-3276332	chr8	3270927	3276332	5405	3273520
chr8:3285835-3288783	chr8	3285835	3288783	2948	3288387
chr8:3450312-3456444	chr8	3450312	3456444	6132	3452905
chr8:5460846-5464333	chr8	5460846	5464333	3487	5463434
chr8:6085774-6091899	chr8	6085774	6091899	6125	6088360
chr8:6845083-6850140	chr8	6845083	6850140	5057	6847671
chr8:9441307-9447455	chr8	9441307	9447455	6148	9443897
chr8:9736452-9738999	chr8	9736452	9738999	2547	9737991
chr8:10490988-10493996	chr8	10490988	10493996	3008	10493926
chr8:10932425-10938427	chr8	10932425	10938427	6002	10934987
chr8:11118264-11119739	chr8	11118264	11119739	1475	11118396
chr8:11402887-11408108	chr8	11402887	11408108	5221	11404644
chr8:11814868-11821002	chr8	11814868	11821002	6134	11817453
chr8:12504803-12508690	chr8	12504803	12508690	3887	12507384
chr8:13181310-13185276	chr8	13181310	13185276	3966	13183903
chr8:13417213-13420228	chr8	13417213	13420228	3015	13419801
chr8:13643803-13644617	chr8	13643803	13644617	814	13644441
chr8:14094147-14097922	chr8	14094147	14097922	3775	14096692
chr8:15555981-15562028	chr8	15555981	15562028	6047	15558594
chr8:15576322-15582323	chr8	15576322	15582323	6001	15578904
chr8:16029232-16032513	chr8	16029232	16032513	3281	16031824
chr8:16335638-16338854	chr8	16335638	16338854	3216	16338215
chr8:16428780-16430362	chr8	16428780	16430362	1582	16430069
chr8:16973855-16980270	chr8	16973855	16980270	6415	16976432
chr8:17288222-17291009	chr8	17288222	17291009	2787	17290766
chr8:19906697-19910047	chr8	19906697	19910047	3350	19908795
chr8:19910039-19916128	chr8	19910039	19916128	6089	19912591
chr8:20035330-20041455	chr8	20035330	20041455	6125	20037907
chr8:20611819-20614853	chr8	20611819	20614853	3034	20614407
chr8:20682123-20686046	chr8	20682123	20686046	3923	20684752
chr8:23373954-23380077	chr8	23373954	23380077	6123	23376527
chr8:23645193-23651219	chr8	23645193	23651219	6026	23647780
chr8:24254557-24258149	chr8	24254557	24258149	3592	24257144
chr8:24448685-24454809	chr8	24448685	24454809	6124	24451238
chr8:25609371-25615474	chr8	25609371	25615474	6103	25611954
chr8:25654942-25660944	chr8	25654942	25660944	6002	25657524
chr8:25730343-25736354	chr8	25730343	25736354	6011	25732928
chr8:26934941-26941087	chr8	26934941	26941087	6146	26937525
chr8:27057852-27063983	chr8	27057852	27063983	6131	27060432
chr8:27549392-27555435	chr8	27549392	27555435	6043	27551989
chr8:28816155-28820642	chr8	28816155	28820642	4487	28818740
chr8:31231264-31237418	chr8	31231264	31237418	6154	31233851
chr8:31484123-31489673	chr8	31484123	31489673	5550	31486687
chr8:31514145-31520256	chr8	31514145	31520256	6111	31516723
chr8:31851611-31857633	chr8	31851611	31857633	6022	31854200
chr8:31916211-31919260	chr8	31916211	31919260	3049	31918790
chr8:32251927-32256495	chr8	32251927	32256495	4568	32253779
chr8:33247046-33253383	chr8	33247046	33253383	6337	33249641
chr8:33698197-33703070	chr8	33698197	33703070	4873	33700792
chr8:33897061-33901735	chr8	33897061	33901735	4674	33899633
chr8:33961486-33967943	chr8	33961486	33967943	6457	33964319
chr8:35171472-35177508	chr8	35171472	35177508	6036	35174069
chr8:35528045-35534071	chr8	35528045	35534071	6026	35530634
chr8:35599801-35602724	chr8	35599801	35602724	2923	35602387
chr8:35985867-35990308	chr8	35985867	35990308	4441	35986886
chr8:36195257-36201393	chr8	36195257	36201393	6136	36197845
chr8:36388573-36394608	chr8	36388573	36394608	6035	36391173
chr8:36478478-36479661	chr8	36478478	36479661	1183	36479295
chr8:36484640-36490531	chr8	36484640	36490531	5891	36487227
chr8:36666344-36672533	chr8	36666344	36672533	6189	36668971
chr8:39138176-39144356	chr8	39138176	39144356	6180	39140741
chr8:40016397-40022547	chr8	40016397	40022547	6150	40018986
chr8:40138223-40144344	chr8	40138223	40144344	6121	40140803
chr8:40506100-40510457	chr8	40506100	40510457	4357	40508654
chr8:41351951-41358031	chr8	41351951	41358031	6080	41354531
chr8:42934394-42938690	chr8	42934394	42938690	4296	42936978
chr8:43183648-43189742	chr8	43183648	43189742	6094	43186226
chr8:43260607-43266588	chr8	43260607	43266588	5981	43263168
chr8:43307287-43313276	chr8	43307287	43313276	5989	43309875
chr8:43320522-43326578	chr8	43320522	43326578	6056	43323034
chr8:43328242-43331320	chr8	43328242	43331320	3078	43329565
chr8:43344443-43350570	chr8	43344443	43350570	6127	43347024
chr8:43391074-43397080	chr8	43391074	43397080	6006	43393645
chr8:43412342-43417825	chr8	43412342	43417825	5483	43414931
chr8:43453896-43460051	chr8	43453896	43460051	6155	43456506
chr8:43864897-43867225	chr8	43864897	43867225	2328	43865318
chr8:45980037-45986146	chr8	45980037	45986146	6109	45982622
chr8:46348625-46351511	chr8	46348625	46351511	2886	46351186
chr8:46601725-46603723	chr8	46601725	46603723	1998	46603366
chr8:46629429-46632285	chr8	46629429	46632285	2856	46630294
chr8:46699216-46705380	chr8	46699216	46705380	6164	46701851
chr8:46739889-46746029	chr8	46739889	46746029	6140	46742473
chr8:46752144-46758255	chr8	46752144	46758255	6111	46754692
chr8:47095089-47100980	chr8	47095089	47100980	5891	47097553
chr8:47297457-47303592	chr8	47297457	47303592	6135	47300039
chr8:47343968-47350103	chr8	47343968	47350103	6135	47346555
chr8:47416624-47422756	chr8	47416624	47422756	6132	47419206
chr8:47499641-47505742	chr8	47499641	47505742	6101	47502229
chr8:47755064-47756879	chr8	47755064	47756879	1815	47756541
chr8:48163384-48169848	chr8	48163384	48169848	6464	48165952
chr8:48181838-48183213	chr8	48181838	48183213	1375	48182550
chr8:48334021-48340013	chr8	48334021	48340013	5992	48336532
chr8:48457210-48463369	chr8	48457210	48463369	6159	48459801
chr8:48793905-48799930	chr8	48793905	48799930	6025	48796497
chr8:48939082-48943565	chr8	48939082	48943565	4483	48941680
chr8:48953910-48960023	chr8	48953910	48960023	6113	48956488
chr8:48993912-48997631	chr8	48993912	48997631	3719	48996480
chr8:49003171-49006154	chr8	49003171	49006154	2983	49004121
chr8:49271327-49272350	chr8	49271327	49272350	1023	49271509
chr8:49528511-49532689	chr8	49528511	49532689	4178	49531086
chr8:49875273-49881266	chr8	49875273	49881266	5993	49877706
chr8:50101560-50104813	chr8	50101560	50104813	3253	50104149
chr8:50204576-50208781	chr8	50204576	50208781	4205	50207154
chr8:50389493-50391819	chr8	50389493	50391819	2326	50391659
chr8:50507917-50514060	chr8	50507917	50514060	6143	50510503
chr8:50672212-50676591	chr8	50672212	50676591	4379	50674263
chr8:50687853-50693402	chr8	50687853	50693402	5549	50689836
chr8:50777704-50783844	chr8	50777704	50783844	6140	50780291
chr8:50986486-50992606	chr8	50986486	50992606	6120	50989073
chr8:52041342-52047484	chr8	52041342	52047484	6142	52043931
chr8:52846716-52853098	chr8	52846716	52853098	6382	52849264
chr8:53043168-53049291	chr8	53043168	53049291	6123	53045759
chr8:53106480-53112945	chr8	53106480	53112945	6465	53109069
chr8:53695162-53700952	chr8	53695162	53700952	5790	53697746
chr8:53780543-53786672	chr8	53780543	53786672	6129	53783130
chr8:54581004-54587142	chr8	54581004	54587142	6138	54583588
chr8:54602039-54608180	chr8	54602039	54608180	6141	54604626
chr8:54691818-54695236	chr8	54691818	54695236	3418	54694407
chr8:55300995-55304886	chr8	55300995	55304886	3891	55303585
chr8:55650164-55653481	chr8	55650164	55653481	3317	55652753
chr8:56146152-56152289	chr8	56146152	56152289	6137	56148731
chr8:56260404-56266456	chr8	56260404	56266456	6052	56262972
chr8:56351203-56357347	chr8	56351203	56357347	6144	56353778
chr8:56630389-56633257	chr8	56630389	56633257	2868	56632973
chr8:56806573-56812725	chr8	56806573	56812725	6152	56809165
chr8:56852264-56854978	chr8	56852264	56854978	2714	56854850
chr8:57158641-57164655	chr8	57158641	57164655	6014	57161219
chr8:57268478-57273302	chr8	57268478	57273302	4824	57270169
chr8:57290928-57294290	chr8	57290928	57294290	3362	57293513
chr8:57320948-57327013	chr8	57320948	57327013	6065	57323533
chr8:57643501-57647436	chr8	57643501	57647436	3935	57643562
chr8:57662466-57665611	chr8	57662466	57665611	3145	57665051
chr8:58092250-58096185	chr8	58092250	58096185	3935	58094837
chr8:58286957-58290442	chr8	58286957	58290442	3485	58289547
chr8:59168655-59174679	chr8	59168655	59174679	6024	59171245
chr8:59456834-59462972	chr8	59456834	59462972	6138	59459416
chr8:59489149-59495546	chr8	59489149	59495546	6397	59491722
chr8:59869799-59875822	chr8	59869799	59875822	6023	59872390
chr8:60124672-60130799	chr8	60124672	60130799	6127	60127247
chr8:60438625-60441949	chr8	60438625	60441949	3324	60441216
chr8:61115375-61121394	chr8	61115375	61121394	6019	61117960
chr8:61248919-61255054	chr8	61248919	61255054	6135	61251501
chr8:61268015-61274014	chr8	61268015	61274014	5999	61270602
chr8:61474796-61480731	chr8	61474796	61480731	5935	61477387
chr8:61844996-61851156	chr8	61844996	61851156	6160	61847586
chr8:61964302-61968425	chr8	61964302	61968425	4123	61966905
chr8:62238911-62242689	chr8	62238911	62242689	3778	62240255
chr8:62278382-62281717	chr8	62278382	62281717	3335	62280962
chr8:62288241-62294345	chr8	62288241	62294345	6104	62290826
chr8:62316286-62322474	chr8	62316286	62322474	6188	62318921
chr8:62849450-62853452	chr8	62849450	62853452	4002	62852043
chr8:63484306-63490336	chr8	63484306	63490336	6030	63486897
chr8:63504768-63510892	chr8	63504768	63510892	6124	63507336
chr8:63755068-63762163	chr8	63755068	63762163	7095	63757649
chr8:63774183-63778250	chr8	63774183	63778250	4067	63776771
chr8:63797384-63803439	chr8	63797384	63803439	6055	63800000
chr8:64399840-64406035	chr8	64399840	64406035	6195	64402453
chr8:64911144-64911722	chr8	64911144	64911722	578	64911700
chr8:64925328-64931691	chr8	64925328	64931691	6363	64928029
chr8:66949103-66955119	chr8	66949103	66955119	6016	66951682
chr8:67352933-67359075	chr8	67352933	67359075	6142	67355525
chr8:67589906-67596036	chr8	67589906	67596036	6130	67592475
chr8:67651749-67654633	chr8	67651749	67654633	2884	67654332
chr8:68613296-68618003	chr8	68613296	68618003	4707	68615878
chr8:69351385-69357434	chr8	69351385	69357434	6049	69353979
chr8:70460249-70466169	chr8	70460249	70466169	5920	70462801
chr8:70626673-70630427	chr8	70626673	70630427	3754	70629246
chr8:70695179-70701331	chr8	70695179	70701331	6152	70697772
chr8:70718304-70723887	chr8	70718304	70723887	5583	70720888
chr8:70735467-70741179	chr8	70735467	70741179	5712	70738057
chr8:70764602-70767487	chr8	70764602	70767487	2885	70767187
chr8:70776969-70780101	chr8	70776969	70780101	3132	70779542
chr8:70900662-70906283	chr8	70900662	70906283	5621	70903228
chr8:71741518-71746521	chr8	71741518	71746521	5003	71744099
chr8:71875780-71878638	chr8	71875780	71878638	2858	71876669
chr8:72147447-72153464	chr8	72147447	72153464	6017	72150034
chr8:72841390-72846312	chr8	72841390	72846312	4922	72842522
chr8:72875538-72881588	chr8	72875538	72881588	6050	72878148
chr8:73218539-73221751	chr8	73218539	73221751	3212	73221122
chr8:74371774-74374363	chr8	74371774	74374363	2589	74374345
chr8:74396360-74402706	chr8	74396360	74402706	6346	74399137
chr8:74537441-74539070	chr8	74537441	74539070	1629	74538202
chr8:74594235-74600252	chr8	74594235	74600252	6017	74596817
chr8:74942652-74948678	chr8	74942652	74948678	6026	74945241
chr8:75202314-75208798	chr8	75202314	75208798	6484	75204912
chr8:75356296-75359980	chr8	75356296	75359980	3684	75356429
chr8:75621331-75627355	chr8	75621331	75627355	6024	75623916
chr8:75634456-75637979	chr8	75634456	75637979	3523	75637024
chr8:75766559-75769978	chr8	75766559	75769978	3419	75769150
chr8:75872202-75876459	chr8	75872202	75876459	4257	75872964
chr8:76282771-76286346	chr8	76282771	76286346	3575	76285167
chr8:76436430-76442570	chr8	76436430	76442570	6140	76439008
chr8:76896098-76902231	chr8	76896098	76902231	6133	76898669
chr8:77274706-77278343	chr8	77274706	77278343	3637	77277295
chr8:77973755-77979860	chr8	77973755	77979860	6105	77976328
chr8:78778481-78783551	chr8	78778481	78783551	5070	78779825
chr8:78874061-78877491	chr8	78874061	78877491	3430	78874177
chr8:79531525-79537908	chr8	79531525	79537908	6383	79534062
chr8:79556399-79558459	chr8	79556399	79558459	2060	79557216
chr8:81325854-81331880	chr8	81325854	81331880	6026	81328442
chr8:81985084-81991244	chr8	81985084	81991244	6160	81987668
chr8:82143405-82147012	chr8	82143405	82147012	3607	82145958
chr8:83114701-83117887	chr8	83114701	83117887	3186	83117293
chr8:83230492-83233267	chr8	83230492	83233267	2775	83233081
chr8:83617303-83623455	chr8	83617303	83623455	6152	83619883
chr8:83831747-83833057	chr8	83831747	83833057	1310	83832925
chr8:83875623-83881203	chr8	83875623	83881203	5580	83878208
chr8:83904474-83909074	chr8	83904474	83909074	4600	83907063
chr8:84014870-84020865	chr8	84014870	84020865	5995	84017460
chr8:84387851-84390710	chr8	84387851	84390710	2859	84390430
chr8:84403554-84404861	chr8	84403554	84404861	1307	84404759
chr8:84419545-84425573	chr8	84419545	84425573	6028	84422136
chr8:84464142-84470166	chr8	84464142	84470166	6024	84466731
chr8:84615570-84621623	chr8	84615570	84621623	6053	84618181
chr8:85418850-85424991	chr8	85418850	85424991	6141	85421433
chr8:85650405-85654067	chr8	85650405	85654067	3662	85653001
chr8:85742399-85743923	chr8	85742399	85743923	1524	85742857
chr8:85758628-85762290	chr8	85758628	85762290	3662	85761224
chr8:85770822-85774484	chr8	85770822	85774484	3662	85773418
chr8:85786097-85789759	chr8	85786097	85789759	3662	85788693
chr8:85798290-85801952	chr8	85798290	85801952	3662	85800886
chr8:85810484-85814146	chr8	85810484	85814146	3662	85813080
chr8:85822671-85826333	chr8	85822671	85826333	3662	85825267
chr8:85868285-85874403	chr8	85868285	85874403	6118	85870869
chr8:86168476-86174519	chr8	86168476	86174519	6043	86171066
chr8:86586338-86592366	chr8	86586338	86592366	6028	86588926
chr8:86954833-86960030	chr8	86954833	86960030	5197	86957417
chr8:87223230-87229276	chr8	87223230	87229276	6046	87225828
chr8:87321803-87327829	chr8	87321803	87327829	6026	87324391
chr8:87421273-87424639	chr8	87421273	87424639	3366	87423864
chr8:87462295-87464306	chr8	87462295	87464306	2011	87463674
chr8:87553262-87557095	chr8	87553262	87557095	3833	87555845
chr8:88160433-88162027	chr8	88160433	88162027	1594	88161135
chr8:88854640-88860785	chr8	88854640	88860785	6145	88857217
chr8:89389391-89389764	chr8	89389391	89389764	373	89389635
chr8:89552310-89558068	chr8	89552310	89558068	5758	89554928
chr8:89819374-89822131	chr8	89819374	89822131	2757	89821948
chr8:90023719-90027759	chr8	90023719	90027759	4040	90026311
chr8:90393386-90399530	chr8	90393386	90399530	6144	90395973
chr8:90485963-90492169	chr8	90485963	90492169	6206	90488594
chr8:90728799-90734517	chr8	90728799	90734517	5718	90731345
chr8:90743595-90748680	chr8	90743595	90748680	5085	90746154
chr8:91148096-91151511	chr8	91148096	91151511	3415	91150673
chr8:91191844-91197868	chr8	91191844	91197868	6024	91194435
chr8:91495077-91500266	chr8	91495077	91500266	5189	91496939
chr8:91522091-91528121	chr8	91522091	91528121	6030	91524683
chr8:91580647-91586031	chr8	91580647	91586031	5384	91583221
chr8:92216065-92222189	chr8	92216065	92222189	6124	92218654
chr8:92308358-92314301	chr8	92308358	92314301	5943	92310946
chr8:92330610-92333767	chr8	92330610	92333767	3157	92332107
chr8:92364192-92370208	chr8	92364192	92370208	6016	92366779
chr8:92381464-92384348	chr8	92381464	92384348	2884	92384011
chr8:92557034-92562973	chr8	92557034	92562973	5939	92559411
chr8:93043870-93049976	chr8	93043870	93049976	6106	93046111
chr8:93199695-93205863	chr8	93199695	93205863	6168	93202285
chr8:93774362-93780507	chr8	93774362	93780507	6145	93776939
chr8:93948528-93952097	chr8	93948528	93952097	3569	93949537
chr8:93963827-93969969	chr8	93963827	93969969	6142	93966416
chr8:94003622-94009766	chr8	94003622	94009766	6144	94006217
chr8:94121318-94127083	chr8	94121318	94127083	5765	94123924
chr8:94131685-94137616	chr8	94131685	94137616	5931	94134242
chr8:95371358-95375735	chr8	95371358	95375735	4377	95372293
chr8:95409432-95410606	chr8	95409432	95410606	1174	95410003
chr8:95552232-95558265	chr8	95552232	95558265	6033	95554824
chr8:95588021-95593849	chr8	95588021	95593849	5828	95590603
chr8:95795606-95799304	chr8	95795606	95799304	3698	95797814
chr8:95927889-95934039	chr8	95927889	95934039	6150	95930474
chr8:96033131-96039250	chr8	96033131	96039250	6119	96035700
chr8:96738431-96744503	chr8	96738431	96744503	6072	96741062
chr8:97039488-97045633	chr8	97039488	97045633	6145	97042073
chr8:97329196-97335596	chr8	97329196	97335596	6400	97331734
chr8:97482112-97485938	chr8	97482112	97485938	3826	97484697
chr8:97523398-97529161	chr8	97523398	97529161	5763	97525611
chr8:97589585-97595726	chr8	97589585	97595726	6141	97592169
chr8:98500370-98506518	chr8	98500370	98506518	6148	98502991
chr8:98584097-98590122	chr8	98584097	98590122	6025	98586685
chr8:98694365-98700518	chr8	98694365	98700518	6153	98696945
chr8:99050038-99053115	chr8	99050038	99053115	3077	99052619
chr8:99081430-99087603	chr8	99081430	99087603	6173	99084045
chr8:99308181-99314316	chr8	99308181	99314316	6135	99310775
chr8:99410576-99416881	chr8	99410576	99416881	6305	99413146
chr8:99488742-99491224	chr8	99488742	99491224	2482	99490489
chr8:99824595-99828394	chr8	99824595	99828394	3799	99827158
chr8:103365814-103369610	chr8	103365814	103369610	3796	103368373
chr8:103602996-103609018	chr8	103602996	103609018	6022	103605588
chr8:103751167-103756353	chr8	103751167	103756353	5186	103753525
chr8:103783269-103789263	chr8	103783269	103789263	5994	103785858
chr8:104057570-104061396	chr8	104057570	104061396	3826	104060158
chr8:104739851-104745873	chr8	104739851	104745873	6022	104742440
chr8:104911240-104916464	chr8	104911240	104916464	5224	104913784
chr8:104959062-104964830	chr8	104959062	104964830	5768	104961284
chr8:105647377-105650923	chr8	105647377	105650923	3546	105649969
chr8:105789089-105795234	chr8	105789089	105795234	6145	105791678
chr8:105843166-105846222	chr8	105843166	105846222	3056	105843256
chr8:106368421-106371752	chr8	106368421	106371752	3331	106370985
chr8:106441026-106443753	chr8	106441026	106443753	2727	106442503
chr8:106962571-106965453	chr8	106962571	106965453	2882	106965144
chr8:107059695-107063116	chr8	107059695	107063116	3421	107062270
chr8:107648820-107654381	chr8	107648820	107654381	5561	107650783
chr8:107711966-107718092	chr8	107711966	107718092	6126	107714516
chr8:107889880-107895907	chr8	107889880	107895907	6027	107892469
chr8:108157020-108158966	chr8	108157020	108158966	1946	108158609
chr8:108374359-108377300	chr8	108374359	108377300	2941	108376928
chr8:108500299-108506445	chr8	108500299	108506445	6146	108502884
chr8:108980628-108987019	chr8	108980628	108987019	6391	108983202
chr8:109115110-109116701	chr8	109115110	109116701	1591	109116390
chr8:109214406-109219470	chr8	109214406	109219470	5064	109215615
chr8:109770927-109777095	chr8	109770927	109777095	6168	109773519
chr8:110388096-110390415	chr8	110388096	110390415	2319	110388776
chr8:111179689-111183654	chr8	111179689	111183654	3965	111182273
chr8:111486485-111488154	chr8	111486485	111488154	1669	111487277
chr8:111673256-111675901	chr8	111673256	111675901	2645	111675846
chr8:113906314-113911343	chr8	113906314	113911343	5029	113908895
chr8:114000279-114006307	chr8	114000279	114006307	6028	114002876
chr8:114042215-114046456	chr8	114042215	114046456	4241	114044807
chr8:114154537-114155853	chr8	114154537	114155853	1316	114155274
chr8:114580378-114586371	chr8	114580378	114586371	5993	114582934
chr8:114631285-114637315	chr8	114631285	114637315	6030	114633879
chr8:114730981-114731973	chr8	114730981	114731973	992	114731787
chr8:118531003-118536089	chr8	118531003	118536089	5086	118532526
chr8:118717723-118723853	chr8	118717723	118723853	6130	118720305
chr8:118797198-118798931	chr8	118797198	118798931	1733	118797611
chr8:119159398-119165410	chr8	119159398	119165410	6012	119161985
chr8:119284330-119290455	chr8	119284330	119290455	6125	119286906
chr8:119456201-119462359	chr8	119456201	119462359	6158	119458786
chr8:119473864-119479886	chr8	119473864	119479886	6022	119476457
chr8:120190619-120194194	chr8	120190619	120194194	3575	120190632
chr8:120638405-120641024	chr8	120638405	120641024	2619	120640963
chr8:120644161-120650187	chr8	120644161	120650187	6026	120646753
chr8:121121980-121124678	chr8	121121980	121124678	2698	121124550
chr8:121329878-121334807	chr8	121329878	121334807	4929	121331372
chr8:122326670-122332092	chr8	122326670	122332092	5422	122329260
chr8:123859986-123866007	chr8	123859986	123866007	6021	123862567
chr8:124239582-124246002	chr8	124239582	124246002	6420	124242158
chr8:125196203-125202353	chr8	125196203	125202353	6150	125198775
chr8:125738691-125742485	chr8	125738691	125742485	3794	125741280
chr8:126313241-126319040	chr8	126313241	126319040	5799	126315832
chr8:126799617-126805646	chr8	126799617	126805646	6029	126802207
chr8:126980501-126986031	chr8	126980501	126986031	5530	126983090
chr8:127769170-127771922	chr8	127769170	127771922	2752	127771720
chr8:128453002-128459020	chr8	128453002	128459020	6018	128455581
chr8:128707441-128712490	chr8	128707441	128712490	5049	128709662
chr8:128891488-128897521	chr8	128891488	128897521	6033	128894079
chr8:129152124-129158150	chr8	129152124	129158150	6026	129154714
chr8:130722901-130726210	chr8	130722901	130726210	3309	130725493
chr8:131062980-131065990	chr8	131062980	131065990	3010	131065568
chr8:131231615-131237785	chr8	131231615	131237785	6170	131234197
chr8:131321044-131323615	chr8	131321044	131323615	2571	131321666
chr8:131546846-131549737	chr8	131546846	131549737	2891	131548028
chr8:131877699-131883893	chr8	131877699	131883893	6194	131880287
chr8:134070756-134076773	chr8	134070756	134076773	6017	134073335
chr8:134307515-134311293	chr8	134307515	134311293	3778	134310099
chr8:135151607-135157149	chr8	135151607	135157149	5542	135154192
chr8:135784901-135791284	chr8	135784901	135791284	6383	135787422
chr8:135847335-135853524	chr8	135847335	135853524	6189	135849922
chr8:135974942-135975295	chr8	135974942	135975295	353	135975161
chr8:135977292-135978927	chr8	135977292	135978927	1635	135978577
chr8:136190201-136196222	chr8	136190201	136196222	6021	136192788
chr8:136438074-136444105	chr8	136438074	136444105	6031	136440665
chr8:136856416-136858622	chr8	136856416	136858622	2206	136856954
chr8:137034961-137041121	chr8	137034961	137041121	6160	137037552
chr8:137558584-137564612	chr8	137558584	137564612	6028	137561169
chr8:137741578-137742890	chr8	137741578	137742890	1312	137742214
chr8:138042576-138048582	chr8	138042576	138048582	6006	138045161
chr8:139159490-139163142	chr8	139159490	139163142	3652	139162044
chr8:140902959-140905176	chr8	140902959	140905176	2217	140904585
chr8:145013841-145019963	chr8	145013841	145019963	6122	145016421
chr8:145077214-145078636	chr8	145077214	145078636	1422	145077537
chr8_KI270810v1_alt:152719-157766	chr8_KI270810v1_alt	152719	157766	5047	154940
chr8_KI270810v1_alt:340163-346196	chr8_KI270810v1_alt	340163	346196	6033	342754
chr8_KI270811v1_alt:150617-154141	chr8_KI270811v1_alt	150617	154141	3524	153206
chr8_KI270814v1_alt:106892-111716	chr8_KI270814v1_alt	106892	111716	4824	108583
chr8_KI270814v1_alt:129342-132704	chr8_KI270814v1_alt	129342	132704	3362	131927
chr8_KI270818v1_alt:54937-60957	chr8_KI270818v1_alt	54937	60957	6020	57529
chr8_KI270821v1_alt:483229-489258	chr8_KI270821v1_alt	483229	489258	6029	485817
chr8_KI270821v1_alt:498945-504997	chr8_KI270821v1_alt	498945	504997	6052	501536
chr8_KI270821v1_alt:532623-535853	chr8_KI270821v1_alt	532623	535853	3230	535212
chr8_KI270822v1_alt:43859-50039	chr8_KI270822v1_alt	43859	50039	6180	46424
chr8_KI270822v1_alt:105306-111458	chr8_KI270822v1_alt	105306	111458	6152	107906
chr8_KI270900v1_alt:55446-58970	chr8_KI270900v1_alt	55446	58970	3524	58035
chr8_KI270900v1_alt:205490-211196	chr8_KI270900v1_alt	205490	211196	5706	208068
chr8_KI270901v1_alt:26438-32582	chr8_KI270901v1_alt	26438	32582	6144	29025
chr8_KI270926v1_alt:8972-14672	chr8_KI270926v1_alt	8972	14672	5700	11547
chr9:229903-236050	chr9	229903	236050	6147	232484
chr9:1066161-1069058	chr9	1066161	1069058	2897	1068742
chr9:1189807-1192766	chr9	1189807	1192766	2959	1192398
chr9:1408430-1410353	chr9	1408430	1410353	1923	1410232
chr9:1569017-1575045	chr9	1569017	1575045	6028	1571608
chr9:1583448-1589502	chr9	1583448	1589502	6054	1586007
chr9:1778472-1783616	chr9	1778472	1783616	5144	1781061
chr9:1931099-1936804	chr9	1931099	1936804	5705	1933661
chr9:2515633-2521964	chr9	2515633	2521964	6331	2518179
chr9:2893009-2897300	chr9	2893009	2897300	4291	2895591
chr9:3141943-3147076	chr9	3141943	3147076	5133	3144506
chr9:3536725-3540949	chr9	3536725	3540949	4224	3539332
chr9:3556886-3563337	chr9	3556886	3563337	6451	3559453
chr9:3614034-3617317	chr9	3614034	3617317	3283	3616612
chr9:3618348-3622375	chr9	3618348	3622375	4027	3620922
chr9:4186004-4189898	chr9	4186004	4189898	3894	4188584
chr9:4896084-4902542	chr9	4896084	4902542	6458	4898664
chr9:4915073-4921190	chr9	4915073	4921190	6117	4917656
chr9:4947716-4953848	chr9	4947716	4953848	6132	4950297
chr9:5471814-5477960	chr9	5471814	5477960	6146	5474400
chr9:5660603-5664127	chr9	5660603	5664127	3524	5662419
chr9:5677852-5680815	chr9	5677852	5680815	2963	5680429
chr9:5722562-5728670	chr9	5722562	5728670	6108	5725145
chr9:6058415-6063780	chr9	6058415	6063780	5365	6060239
chr9:6177205-6183226	chr9	6177205	6183226	6021	6179798
chr9:6258030-6262329	chr9	6258030	6262329	4299	6260604
chr9:6387413-6390624	chr9	6387413	6390624	3211	6389998
chr9:6456001-6458575	chr9	6456001	6458575	2574	6458096
chr9:7155359-7161460	chr9	7155359	7161460	6101	7157943
chr9:7277685-7283833	chr9	7277685	7283833	6148	7280273
chr9:7574389-7577405	chr9	7574389	7577405	3016	7577005
chr9:7863204-7867520	chr9	7863204	7867520	4316	7864734
chr9:8002150-8009240	chr9	8002150	8009240	7090	8004955
chr9:8079466-8085615	chr9	8079466	8085615	6149	8082044
chr9:8102729-8106151	chr9	8102729	8106151	3422	8105316
chr9:8199009-8204502	chr9	8199009	8204502	5493	8201561
chr9:8324107-8330317	chr9	8324107	8330317	6210	8326657
chr9:8931643-8932465	chr9	8931643	8932465	822	8931752
chr9:9369191-9372891	chr9	9369191	9372891	3700	9371200
chr9:10849183-10851765	chr9	10849183	10851765	2582	10851005
chr9:11479758-11486093	chr9	11479758	11486093	6335	11482339
chr9:11633960-11636616	chr9	11633960	11636616	2656	11636536
chr9:11636981-11640328	chr9	11636981	11640328	3347	11639262
chr9:11665271-11669580	chr9	11665271	11669580	4309	11667849
chr9:11718677-11723115	chr9	11718677	11723115	4438	11721265
chr9:11853172-11855831	chr9	11853172	11855831	2659	11855792
chr9:12209240-12212623	chr9	12209240	12212623	3383	12211836
chr9:12864823-12869781	chr9	12864823	12869781	4958	12867404
chr9:13301497-13306687	chr9	13301497	13306687	5190	13304071
chr9:13340146-13343528	chr9	13340146	13343528	3382	13342713
chr9:14569290-14570772	chr9	14569290	14570772	1482	14569766
chr9:14708159-14708567	chr9	14708159	14708567	408	14708491
chr9:14870656-14876831	chr9	14870656	14876831	6175	14873257
chr9:15555685-15561029	chr9	15555685	15561029	5344	15558325
chr9:15595149-15601277	chr9	15595149	15601277	6128	15597733
chr9:15624320-15627960	chr9	15624320	15627960	3640	15626904
chr9:15671347-15676439	chr9	15671347	15676439	5092	15673936
chr9:17149816-17154593	chr9	17149816	17154593	4777	17151748
chr9:17199509-17203546	chr9	17199509	17203546	4037	17201422
chr9:17210063-17216201	chr9	17210063	17216201	6138	17212643
chr9:17256975-17260453	chr9	17256975	17260453	3478	17259563
chr9:17263044-17269181	chr9	17263044	17269181	6137	17265626
chr9:17285003-17291034	chr9	17285003	17291034	6031	17287595
chr9:17641444-17645151	chr9	17641444	17645151	3707	17643920
chr9:17677643-17681074	chr9	17677643	17681074	3431	17680217
chr9:17923041-17924474	chr9	17923041	17924474	1433	17924213
chr9:18558024-18564479	chr9	18558024	18564479	6455	18560598
chr9:18644386-18650544	chr9	18644386	18650544	6158	18646977
chr9:18839036-18845184	chr9	18839036	18845184	6148	18841625
chr9:18962578-18968207	chr9	18962578	18968207	5629	18964359
chr9:19499153-19505515	chr9	19499153	19505515	6362	19501716
chr9:19536200-19542230	chr9	19536200	19542230	6030	19538792
chr9:19542232-19545628	chr9	19542232	19545628	3396	19543024
chr9:19762113-19767761	chr9	19762113	19767761	5648	19763900
chr9:20229735-20235873	chr9	20229735	20235873	6138	20232323
chr9:20795835-20801175	chr9	20795835	20801175	5340	20798435
chr9:21270433-21272336	chr9	21270433	21272336	1903	21272213
chr9:21297268-21300618	chr9	21297268	21300618	3350	21299857
chr9:21424092-21428437	chr9	21424092	21428437	4345	21426198
chr9:21645807-21652282	chr9	21645807	21652282	6475	21648397
chr9:21819140-21825252	chr9	21819140	21825252	6112	21821713
chr9:22089830-22095306	chr9	22089830	22095306	5476	22092411
chr9:22220338-22226485	chr9	22220338	22226485	6147	22222915
chr9:22348829-22354859	chr9	22348829	22354859	6030	22351423
chr9:22492889-22496582	chr9	22492889	22496582	3693	22493025
chr9:22502880-22509012	chr9	22502880	22509012	6132	22505465
chr9:22565937-22569616	chr9	22565937	22569616	3679	22568573
chr9:22700582-22703677	chr9	22700582	22703677	3095	22703176
chr9:22734790-22739599	chr9	22734790	22739599	4809	22737376
chr9:22758947-22760810	chr9	22758947	22760810	1863	22760113
chr9:22884580-22885789	chr9	22884580	22885789	1209	22885663
chr9:23860610-23867055	chr9	23860610	23867055	6445	23863191
chr9:23935981-23937367	chr9	23935981	23937367	1386	23936565
chr9:23962747-23967119	chr9	23962747	23967119	4372	23963289
chr9:24106048-24108879	chr9	24106048	24108879	2831	24108636
chr9:24172491-24174311	chr9	24172491	24174311	1820	24174182
chr9:24224676-24230670	chr9	24224676	24230670	5994	24227239
chr9:24387080-24391942	chr9	24387080	24391942	4862	24388061
chr9:24523015-24525499	chr9	24523015	24525499	2484	24523651
chr9:24574536-24580564	chr9	24574536	24580564	6028	24577127
chr9:24638738-24642790	chr9	24638738	24642790	4052	24641317
chr9:24662836-24669016	chr9	24662836	24669016	6180	24665423
chr9:24750424-24753584	chr9	24750424	24753584	3160	24753011
chr9:25019567-25026321	chr9	25019567	25026321	6754	25022220
chr9:25039971-25046101	chr9	25039971	25046101	6130	25042558
chr9:25070956-25076968	chr9	25070956	25076968	6012	25073529
chr9:25165469-25168447	chr9	25165469	25168447	2978	25168048
chr9:25929295-25933093	chr9	25929295	25933093	3798	25931883
chr9:26729614-26736024	chr9	26729614	26736024	6410	26732186
chr9:27320225-27322132	chr9	27320225	27322132	1907	27320900
chr9:27780845-27785650	chr9	27780845	27785650	4805	27781805
chr9:28111895-28117865	chr9	28111895	28117865	5970	28114500
chr9:28635824-28641042	chr9	28635824	28641042	5218	28638407
chr9:30338617-30339318	chr9	30338617	30339318	701	30339258
chr9:30440505-30443683	chr9	30440505	30443683	3178	30443069
chr9:30785049-30791209	chr9	30785049	30791209	6160	30787641
chr9:30998938-31002330	chr9	30998938	31002330	3392	31001553
chr9:31056094-31062222	chr9	31056094	31062222	6128	31058655
chr9:31154957-31161085	chr9	31154957	31161085	6128	31157535
chr9:31224956-31230636	chr9	31224956	31230636	5680	31227100
chr9:31514236-31519822	chr9	31514236	31519822	5586	31515963
chr9:31932203-31938375	chr9	31932203	31938375	6172	31934807
chr9:32049882-32053566	chr9	32049882	32053566	3684	32052476
chr9:32211828-32217979	chr9	32211828	32217979	6151	32214417
chr9:32225047-32231059	chr9	32225047	32231059	6012	32227632
chr9:32444664-32448809	chr9	32444664	32448809	4145	32445200
chr9:34526550-34532701	chr9	34526550	34532701	6151	34529132
chr9:34761698-34767854	chr9	34761698	34767854	6156	34764286
chr9:34845598-34851753	chr9	34845598	34851753	6155	34848188
chr9:35198860-35202793	chr9	35198860	35202793	3933	35201423
chr9:35245351-35249878	chr9	35245351	35249878	4527	35247942
chr9:40436113-40437311	chr9	40436113	40437311	1198	40436201
chr9:40675718-40681825	chr9	40675718	40681825	6107	40678301
chr9:40732609-40735235	chr9	40732609	40735235	2626	40735178
chr9:41002301-41007189	chr9	41002301	41007189	4888	41004886
chr9:43062225-43063559	chr9	43062225	43063559	1334	43062313
chr9:61339074-61344636	chr9	61339074	61344636	5562	61341682
chr9:63152189-63157615	chr9	63152189	63157615	5426	63154443
chr9:63271631-63272829	chr9	63271631	63272829	1198	63271719
chr9:63475119-63481223	chr9	63475119	63481223	6104	63477702
chr9:64576181-64577379	chr9	64576181	64577379	1198	64576269
chr9:64799270-64805376	chr9	64799270	64805376	6106	64801853
chr9:64856215-64858845	chr9	64856215	64858845	2630	64858788
chr9:65709351-65715424	chr9	65709351	65715424	6073	65711942
chr9:65904037-65907495	chr9	65904037	65907495	3458	65905795
chr9:67066571-67072091	chr9	67066571	67072091	5520	67069329
chr9:67145222-67150172	chr9	67145222	67150172	4950	67147800
chr9:67579208-67585330	chr9	67579208	67585330	6122	67581798
chr9:68275326-68281363	chr9	68275326	68281363	6037	68277894
chr9:68587180-68592336	chr9	68587180	68592336	5156	68589774
chr9:68936905-68938655	chr9	68936905	68938655	1750	68937198
chr9:69413730-69419790	chr9	69413730	69419790	6060	69416356
chr9:69434794-69440931	chr9	69434794	69440931	6137	69437365
chr9:69836742-69839447	chr9	69836742	69839447	2705	69839322
chr9:70179873-70186005	chr9	70179873	70186005	6132	70182443
chr9:70199056-70205081	chr9	70199056	70205081	6025	70201641
chr9:70206629-70212755	chr9	70206629	70212755	6126	70209218
chr9:71196871-71202418	chr9	71196871	71202418	5547	71199461
chr9:74619736-74620853	chr9	74619736	74620853	1117	74620130
chr9:75202628-75208655	chr9	75202628	75208655	6027	75205219
chr9:75253706-75259824	chr9	75253706	75259824	6118	75256278
chr9:75701100-75707247	chr9	75701100	75707247	6147	75703685
chr9:75759233-75762430	chr9	75759233	75762430	3197	75761809
chr9:75765963-75772338	chr9	75765963	75772338	6375	75768526
chr9:76981523-76984721	chr9	76981523	76984721	3198	76981609
chr9:77263406-77266463	chr9	77263406	77266463	3057	77265384
chr9:77478030-77483700	chr9	77478030	77483700	5670	77480636
chr9:77684768-77687677	chr9	77684768	77687677	2909	77687351
chr9:78650549-78652651	chr9	78650549	78652651	2102	78651711
chr9:79074033-79075408	chr9	79074033	79075408	1375	79075223
chr9:79097851-79103879	chr9	79097851	79103879	6028	79100438
chr9:79177278-79183283	chr9	79177278	79183283	6005	79179864
chr9:79494547-79500580	chr9	79494547	79500580	6033	79497142
chr9:80475448-80479368	chr9	80475448	80479368	3920	80478035
chr9:80513438-80518583	chr9	80513438	80518583	5145	80516020
chr9:80654116-80660135	chr9	80654116	80660135	6019	80656705
chr9:80660135-80664330	chr9	80660135	80664330	4195	80660765
chr9:80741662-80747689	chr9	80741662	80747689	6027	80744253
chr9:82386178-82391672	chr9	82386178	82391672	5494	82388759
chr9:82751810-82757866	chr9	82751810	82757866	6056	82754429
chr9:82769369-82775374	chr9	82769369	82775374	6005	82771956
chr9:83049539-83055571	chr9	83049539	83055571	6032	83052132
chr9:83222905-83228949	chr9	83222905	83228949	6044	83225521
chr9:83861197-83865082	chr9	83861197	83865082	3885	83863764
chr9:84037159-84040254	chr9	84037159	84040254	3095	84039019
chr9:84530122-84534813	chr9	84530122	84534813	4691	84532725
chr9:85071665-85077678	chr9	85071665	85077678	6013	85074252
chr9:85252170-85258610	chr9	85252170	85258610	6440	85254734
chr9:85717679-85723818	chr9	85717679	85723818	6139	85720249
chr9:86085481-86088419	chr9	86085481	86088419	2938	86088027
chr9:86377466-86383626	chr9	86377466	86383626	6160	86380056
chr9:86477081-86481159	chr9	86477081	86481159	4078	86477767
chr9:86606053-86612054	chr9	86606053	86612054	6001	86608622
chr9:91225551-91231568	chr9	91225551	91231568	6017	91228141
chr9:91670601-91673439	chr9	91670601	91673439	2838	91671137
chr9:92082239-92088398	chr9	92082239	92088398	6159	92084829
chr9:92450099-92453613	chr9	92450099	92453613	3514	92452687
chr9:92568071-92574214	chr9	92568071	92574214	6143	92570666
chr9:92577782-92581156	chr9	92577782	92581156	3374	92580390
chr9:92900099-92906066	chr9	92900099	92906066	5967	92902515
chr9:92993466-92999588	chr9	92993466	92999588	6122	92996065
chr9:94020341-94026495	chr9	94020341	94026495	6154	94022928
chr9:94089082-94095103	chr9	94089082	94095103	6021	94091671
chr9:94113535-94119565	chr9	94113535	94119565	6030	94116127
chr9:97335183-97340369	chr9	97335183	97340369	5186	97337751
chr9:97580993-97587031	chr9	97580993	97587031	6038	97583589
chr9:100231359-100237810	chr9	100231359	100237810	6451	100233958
chr9:100253415-100259550	chr9	100253415	100259550	6135	100256002
chr9:100634343-100636211	chr9	100634343	100636211	1868	100634477
chr9:100704488-100710574	chr9	100704488	100710574	6086	100707070
chr9:100745539-100749580	chr9	100745539	100749580	4041	100746058
chr9:100983201-100985104	chr9	100983201	100985104	1903	100983876
chr9:101102144-101108174	chr9	101102144	101108174	6030	101104736
chr9:101153882-101154545	chr9	101153882	101154545	663	101154298
chr9:101935414-101941555	chr9	101935414	101941555	6141	101937995
chr9:102061552-102067315	chr9	102061552	102067315	5763	102064132
chr9:102126825-102130904	chr9	102126825	102130904	4079	102129407
chr9:102147744-102153764	chr9	102147744	102153764	6020	102150332
chr9:102217909-102223924	chr9	102217909	102223924	6015	102220496
chr9:102594879-102600967	chr9	102594879	102600967	6088	102597454
chr9:102694150-102694611	chr9	102694150	102694611	461	102694279
chr9:103044628-103047382	chr9	103044628	103047382	2754	103047217
chr9:103433595-103439674	chr9	103433595	103439674	6079	103436177
chr9:103453362-103454754	chr9	103453362	103454754	1392	103454172
chr9:103606282-103612435	chr9	103606282	103612435	6153	103608867
chr9:104015023-104015678	chr9	104015023	104015678	655	104015385
chr9:104215182-104219320	chr9	104215182	104219320	4138	104217765
chr9:105084712-105087642	chr9	105084712	105087642	2930	105087286
chr9:105489506-105495647	chr9	105489506	105495647	6141	105492086
chr9:105576167-105582192	chr9	105576167	105582192	6025	105578758
chr9:105744558-105747908	chr9	105744558	105747908	3350	105747164
chr9:105777060-105783078	chr9	105777060	105783078	6018	105779642
chr9:105785075-105791210	chr9	105785075	105791210	6135	105787659
chr9:105894748-105897376	chr9	105894748	105897376	2628	105897020
chr9:106087335-106090064	chr9	106087335	106090064	2729	106088888
chr9:106181588-106187641	chr9	106181588	106187641	6053	106184209
chr9:106198351-106204491	chr9	106198351	106204491	6140	106201016
chr9:106537767-106542062	chr9	106537767	106542062	4295	106540352
chr9:108026592-108032734	chr9	108026592	108032734	6142	108029175
chr9:109660207-109666322	chr9	109660207	109666322	6115	109662756
chr9:110000010-110006173	chr9	110000010	110006173	6163	110002619
chr9:110229429-110235911	chr9	110229429	110235911	6482	110232005
chr9:112798107-112804159	chr9	112798107	112804159	6052	112800719
chr9:113437560-113443590	chr9	113437560	113443590	6030	113440154
chr9:114974259-114975263	chr9	114974259	114975263	1004	114975108
chr9:115706364-115707604	chr9	115706364	115707604	1240	115707163
chr9:115800528-115802466	chr9	115800528	115802466	1938	115801622
chr9:115958906-115962960	chr9	115958906	115962960	4054	115959421
chr9:116509015-116515133	chr9	116509015	116515133	6118	116511591
chr9:116531372-116537204	chr9	116531372	116537204	5832	116533949
chr9:117066017-117072036	chr9	117066017	117072036	6019	117068596
chr9:118123170-118125820	chr9	118123170	118125820	2650	118125759
chr9:118495583-118501652	chr9	118495583	118501652	6069	118498070
chr9:119063401-119068176	chr9	119063401	119068176	4775	119066005
chr9:119133020-119133674	chr9	119133020	119133674	654	119133383
chr9:119621304-119627350	chr9	119621304	119627350	6046	119623916
chr9:120271967-120273866	chr9	120271967	120273866	1899	120272642
chr9:121127656-121133788	chr9	121127656	121133788	6132	121130218
chr9:121415089-121420091	chr9	121415089	121420091	5002	121417679
chr9:122408633-122414773	chr9	122408633	122414773	6140	122411216
chr9:122590144-122596170	chr9	122590144	122596170	6026	122592733
chr9:124608142-124610916	chr9	124608142	124610916	2774	124610688
chr9:131339061-131341946	chr9	131339061	131341946	2885	131341636
chr9:134506262-134508872	chr9	134506262	134508872	2610	134508836
chr9:138324214-138330637	chr9	138324214	138330637	6423	138326759
chr9_GL383539v1_alt:160208-162987	chr9_GL383539v1_alt	160208	162987	2779	162824
chr9_GL383540v1_alt:8238-14243	chr9_GL383540v1_alt	8238	14243	6005	10809
chr9_GL383540v1_alt:29248-35385	chr9_GL383540v1_alt	29248	35385	6137	31819
chr9_GL383541v1_alt:138400-144439	chr9_GL383541v1_alt	138400	144439	6039	140992
chr9_GL383541v1_alt:161841-167973	chr9_GL383541v1_alt	161841	167973	6132	164411
chr9_KI270720v1_random:11613-14799	chr9_KI270720v1_random	11613	14799	3186	14186
chr9_KI270823v1_alt:34404-36307	chr9_KI270823v1_alt	34404	36307	1903	35079
chr9_KI270823v1_alt:153347-159377	chr9_KI270823v1_alt	153347	159377	6030	155939
chr9_KI270823v1_alt:205085-205748	chr9_KI270823v1_alt	205085	205748	663	205501
chrUn_GL000195v1:6060-9053	chrUn_GL000195v1	6060	9053	2993	8628
chrUn_GL000195v1:160258-163303	chrUn_GL000195v1	160258	163303	3045	162719
chrUn_GL000213v1:19407-23688	chrUn_GL000213v1	19407	23688	4281	20178
chrUn_GL000214v1:39518-45655	chrUn_GL000214v1	39518	45655	6137	42084
chrUn_GL000216v2:133195-136465	chrUn_GL000216v2	133195	136465	3270	135787
chrUn_GL000218v1:105690-110879	chrUn_GL000218v1	105690	110879	5189	108260
chrUn_GL000218v1:150390-156523	chrUn_GL000218v1	150390	156523	6133	152977
chrUn_GL000219v1:5265-9525	chrUn_GL000219v1	5265	9525	4260	5966
chrUn_GL000219v1:18739-20956	chrUn_GL000219v1	18739	20956	2217	20110
chrUn_GL000219v1:65375-69477	chrUn_GL000219v1	65375	69477	4102	67950
chrUn_GL000220v1:64095-66956	chrUn_GL000220v1	64095	66956	2861	66687
chrUn_GL000224v1:43482-43968	chrUn_GL000224v1	43482	43968	486	43528
chrUn_GL000224v1:110990-117087	chrUn_GL000224v1	110990	117087	6097	113573
chrUn_KI270435v1:3190-8432	chrUn_KI270435v1	3190	8432	5242	5777
chrUn_KI270435v1:14146-15616	chrUn_KI270435v1	14146	15616	1470	14712
chrUn_KI270435v1:74781-75836	chrUn_KI270435v1	74781	75836	1055	75207
chrUn_KI270442v1:189854-190910	chrUn_KI270442v1	189854	190910	1056	190281
chrUn_KI270442v1:343833-349866	chrUn_KI270442v1	343833	349866	6033	346420
chrUn_KI270512v1:9432-15451	chrUn_KI270512v1	9432	15451	6019	12017
chrUn_KI270519v1:122345-123400	chrUn_KI270519v1	122345	123400	1055	122771
chrUn_KI270580v1:0-1551	chrUn_KI270580v1	0	1551	1551	907
chrUn_KI270582v1:4-2748	chrUn_KI270582v1	4	2748	2744	450
chrUn_KI270741v1:52861-58959	chrUn_KI270741v1	52861	58959	6098	55444
chrUn_KI270741v1:123648-126207	chrUn_KI270741v1	123648	126207	2559	124349
chrUn_KI270741v1:137648-139865	chrUn_KI270741v1	137648	139865	2217	139019
chrUn_KI270742v1:118227-123386	chrUn_KI270742v1	118227	123386	5159	120764
chrUn_KI270742v1:163066-169195	chrUn_KI270742v1	163066	169195	6129	165654
chrUn_KI270743v1:76200-82327	chrUn_KI270743v1	76200	82327	6127	78756
chrUn_KI270751v1:82021-87213	chrUn_KI270751v1	82021	87213	5192	84593
chrUn_KI270751v1:126651-132784	chrUn_KI270751v1	126651	132784	6133	129240
chrX:1703771-1709786	chrX	1703771	1709786	6015	1706362
chrX:5711993-5713642	chrX	5711993	5713642	1649	5712556
chrX:6584014-6588885	chrX	6584014	6588885	4871	6586606
chrX:6971723-6976664	chrX	6971723	6976664	4941	6972795
chrX:7587592-7593752	chrX	7587592	7593752	6160	7590183
chrX:8932164-8936101	chrX	8932164	8936101	3937	8934748
chrX:10249730-10252663	chrX	10249730	10252663	2933	10252306
chrX:11017979-11022447	chrX	11017979	11022447	4468	11020558
chrX:11218382-11218900	chrX	11218382	11218900	518	11218550
chrX:11935296-11941314	chrX	11935296	11941314	6018	11937875
chrX:12164045-12167435	chrX	12164045	12167435	3390	12166639
chrX:12833046-12836859	chrX	12833046	12836859	3813	12835618
chrX:12848799-12855203	chrX	12848799	12855203	6404	12851378
chrX:12858306-12864441	chrX	12858306	12864441	6135	12860886
chrX:13132317-13138466	chrX	13132317	13138466	6149	13134908
chrX:14103945-14109975	chrX	14103945	14109975	6030	14106535
chrX:14200701-14205553	chrX	14200701	14205553	4852	14203279
chrX:14286605-14289625	chrX	14286605	14289625	3020	14289196
chrX:14457878-14464003	chrX	14457878	14464003	6125	14460460
chrX:14621365-14625697	chrX	14621365	14625697	4332	14623937
chrX:14683910-14688939	chrX	14683910	14688939	5029	14685404
chrX:14969001-14975122	chrX	14969001	14975122	6121	14971584
chrX:16230649-16236856	chrX	16230649	16236856	6207	16233278
chrX:17230022-17234649	chrX	17230022	17234649	4627	17232607
chrX:17342483-17348512	chrX	17342483	17348512	6029	17345071
chrX:17489785-17492785	chrX	17489785	17492785	3000	17491708
chrX:17568685-17574834	chrX	17568685	17574834	6149	17571257
chrX:17781376-17787389	chrX	17781376	17787389	6013	17783960
chrX:17907837-17911064	chrX	17907837	17911064	3227	17910367
chrX:18067527-18071289	chrX	18067527	18071289	3762	18070119
chrX:18734131-18740262	chrX	18734131	18740262	6131	18736717
chrX:18772463-18772619	chrX	18772463	18772619	156	18772590
chrX:19273369-19279507	chrX	19273369	19279507	6138	19275950
chrX:19940253-19946296	chrX	19940253	19946296	6043	19942861
chrX:20648418-20649308	chrX	20648418	20649308	890	20648693
chrX:20658913-20660430	chrX	20658913	20660430	1517	20659358
chrX:20703007-20705769	chrX	20703007	20705769	2762	20705594
chrX:21098457-21099985	chrX	21098457	21099985	1528	21099217
chrX:21218621-21222739	chrX	21218621	21222739	4118	21221207
chrX:21999443-22005591	chrX	21999443	22005591	6148	22002026
chrX:22230262-22232596	chrX	22230262	22232596	2334	22231359
chrX:23423311-23429445	chrX	23423311	23429445	6134	23425880
chrX:23453718-23457868	chrX	23453718	23457868	4150	23456316
chrX:23472221-23477368	chrX	23472221	23477368	5147	23473575
chrX:23560661-23566793	chrX	23560661	23566793	6132	23563241
chrX:23645908-23651833	chrX	23645908	23651833	5925	23648490
chrX:25117140-25123161	chrX	25117140	25123161	6021	25119722
chrX:25311847-25315278	chrX	25311847	25315278	3431	25314438
chrX:25408765-25414189	chrX	25408765	25414189	5424	25410586
chrX:26176539-26182226	chrX	26176539	26182226	5687	26179126
chrX:26281308-26287417	chrX	26281308	26287417	6109	26283888
chrX:26314417-26320446	chrX	26314417	26320446	6029	26317008
chrX:26686187-26686831	chrX	26686187	26686831	644	26686699
chrX:27523924-27527663	chrX	27523924	27527663	3739	27524117
chrX:27611458-27614897	chrX	27611458	27614897	3439	27614040
chrX:28094366-28097404	chrX	28094366	28097404	3038	28096958
chrX:28146386-28150342	chrX	28146386	28150342	3956	28148975
chrX:28362090-28368221	chrX	28362090	28368221	6131	28364671
chrX:28387955-28389458	chrX	28387955	28389458	1503	28388404
chrX:28720601-28724782	chrX	28720601	28724782	4181	28723181
chrX:28955449-28957156	chrX	28955449	28957156	1707	28956850
chrX:29981730-29987885	chrX	29981730	29987885	6155	29984322
chrX:30322994-30325935	chrX	30322994	30325935	2941	30324783
chrX:30767769-30772632	chrX	30767769	30772632	4863	30770352
chrX:31077316-31083463	chrX	31077316	31083463	6147	31079905
chrX:31465205-31471610	chrX	31465205	31471610	6405	31467753
chrX:32243955-32246821	chrX	32243955	32246821	2866	32246551
chrX:32652140-32655976	chrX	32652140	32655976	3836	32654739
chrX:32800562-32804092	chrX	32800562	32804092	3530	32803055
chrX:34158643-34160448	chrX	34158643	34160448	1805	34159097
chrX:34249185-34253913	chrX	34249185	34253913	4728	34250472
chrX:34694824-34695582	chrX	34694824	34695582	758	34695227
chrX:35630405-35636825	chrX	35630405	35636825	6420	35632992
chrX:36170297-36176324	chrX	36170297	36176324	6027	36172887
chrX:36229612-36235765	chrX	36229612	36235765	6153	36232201
chrX:36465194-36471217	chrX	36465194	36471217	6023	36467776
chrX:36596962-36599264	chrX	36596962	36599264	2302	36598794
chrX:36700198-36706334	chrX	36700198	36706334	6136	36702787
chrX:37304694-37307990	chrX	37304694	37307990	3296	37307264
chrX:37581787-37587934	chrX	37581787	37587934	6147	37584406
chrX:37628446-37634592	chrX	37628446	37634592	6146	37631039
chrX:38534673-38536030	chrX	38534673	38536030	1357	38535545
chrX:39180369-39186499	chrX	39180369	39186499	6130	39182955
chrX:41648694-41650385	chrX	41648694	41650385	1691	41648843
chrX:42202163-42208183	chrX	42202163	42208183	6020	42204751
chrX:42336457-42343834	chrX	42336457	42343834	7377	42339945
chrX:42424860-42430890	chrX	42424860	42430890	6030	42427449
chrX:42720755-42723693	chrX	42720755	42723693	2938	42723339
chrX:42810743-42816960	chrX	42810743	42816960	6217	42813261
chrX:42872138-42875267	chrX	42872138	42875267	3129	42874727
chrX:43306197-43311790	chrX	43306197	43311790	5593	43308791
chrX:43670449-43676596	chrX	43670449	43676596	6147	43673027
chrX:43721689-43727948	chrX	43721689	43727948	6259	43724268
chrX:43921930-43927518	chrX	43921930	43927518	5588	43924484
chrX:44051080-44053800	chrX	44051080	44053800	2720	44053414
chrX:44983414-44989548	chrX	44983414	44989548	6134	44985997
chrX:45998318-46004481	chrX	45998318	46004481	6163	46000909
chrX:46054884-46058449	chrX	46054884	46058449	3565	46054942
chrX:46409894-46416038	chrX	46409894	46416038	6144	46412478
chrX:46482029-46484385	chrX	46482029	46484385	2356	46482640
chrX:47783671-47789697	chrX	47783671	47789697	6026	47786259
chrX:49620062-49626205	chrX	49620062	49626205	6143	49622649
chrX:49778627-49779642	chrX	49778627	49779642	1015	49779390
chrX:50019456-50025505	chrX	50019456	50025505	6049	50022064
chrX:50296102-50302279	chrX	50296102	50302279	6177	50298720
chrX:50488619-50491690	chrX	50488619	50491690	3071	50491209
chrX:51012657-51018802	chrX	51012657	51018802	6145	51015243
chrX:51427448-51433599	chrX	51427448	51433599	6151	51430039
chrX:51512321-51518344	chrX	51512321	51518344	6023	51514908
chrX:51531585-51537594	chrX	51531585	51537594	6009	51534159
chrX:51550372-51556486	chrX	51550372	51556486	6114	51552959
chrX:51591244-51592552	chrX	51591244	51592552	1308	51591607
chrX:51927347-51931176	chrX	51927347	51931176	3829	51929925
chrX:51959365-51965527	chrX	51959365	51965527	6162	51961954
chrX:51973668-51974214	chrX	51973668	51974214	546	51973976
chrX:51991322-51997423	chrX	51991322	51997423	6101	51993888
chrX:52020447-52026584	chrX	52020447	52026584	6137	52023024
chrX:52026592-52029635	chrX	52026592	52029635	3043	52028212
chrX:52092777-52093820	chrX	52092777	52093820	1043	52093215
chrX:52100394-52106749	chrX	52100394	52106749	6355	52103163
chrX:52145326-52151280	chrX	52145326	52151280	5954	52147917
chrX:52843472-52849671	chrX	52843472	52849671	6199	52846069
chrX:53848153-53854569	chrX	53848153	53854569	6416	53851031
chrX:54052552-54052902	chrX	54052552	54052902	350	54052793
chrX:54118685-54124744	chrX	54118685	54124744	6059	54121305
chrX:54664833-54667724	chrX	54664833	54667724	2891	54667417
chrX:54716378-54720801	chrX	54716378	54720801	4423	54718966
chrX:54731465-54735789	chrX	54731465	54735789	4324	54734052
chrX:54765705-54770404	chrX	54765705	54770404	4699	54766977
chrX:54853945-54860101	chrX	54853945	54860101	6156	54856523
chrX:54860101-54862639	chrX	54860101	54862639	2538	54862323
chrX:54878587-54883219	chrX	54878587	54883219	4632	54879650
chrX:54970339-54973841	chrX	54970339	54973841	3502	54972926
chrX:55046934-55052940	chrX	55046934	55052940	6006	55049394
chrX:55067060-55073523	chrX	55067060	55073523	6463	55069631
chrX:55082812-55085056	chrX	55082812	55085056	2244	55083507
chrX:55297654-55301694	chrX	55297654	55301694	4040	55300239
chrX:55317834-55322119	chrX	55317834	55322119	4285	55320418
chrX:55600521-55606939	chrX	55600521	55606939	6418	55603114
chrX:55611885-55613264	chrX	55611885	55613264	1379	55612976
chrX:55668332-55674513	chrX	55668332	55674513	6181	55670915
chrX:55677085-55681177	chrX	55677085	55681177	4092	55679653
chrX:55681153-55685221	chrX	55681153	55685221	4068	55683744
chrX:55768921-55775044	chrX	55768921	55775044	6123	55771494
chrX:55806074-55812182	chrX	55806074	55812182	6108	55808640
chrX:55845760-55851917	chrX	55845760	55851917	6157	55848357
chrX:55885706-55889022	chrX	55885706	55889022	3316	55888281
chrX:55944023-55945482	chrX	55944023	55945482	1459	55944419
chrX:55987200-55990529	chrX	55987200	55990529	3329	55989791
chrX:56047265-56053280	chrX	56047265	56053280	6015	56049855
chrX:56058340-56063913	chrX	56058340	56063913	5573	56060782
chrX:56075957-56081346	chrX	56075957	56081346	5389	56078730
chrX:56103030-56107860	chrX	56103030	56107860	4830	56104301
chrX:56157408-56162917	chrX	56157408	56162917	5509	56159475
chrX:56172114-56178209	chrX	56172114	56178209	6095	56174684
chrX:56178210-56183597	chrX	56178210	56183597	5387	56180079
chrX:56324965-56331139	chrX	56324965	56331139	6174	56327577
chrX:56335647-56339685	chrX	56335647	56339685	4038	56338234
chrX:56352619-56358772	chrX	56352619	56358772	6153	56355208
chrX:56388485-56392677	chrX	56388485	56392677	4192	56391066
chrX:56398121-56400925	chrX	56398121	56400925	2804	56400712
chrX:56424807-56428101	chrX	56424807	56428101	3294	56426648
chrX:56431198-56435268	chrX	56431198	56435268	4070	56433791
chrX:56450032-56451865	chrX	56450032	56451865	1833	56451576
chrX:56455199-56461248	chrX	56455199	56461248	6049	56457790
chrX:56489529-56495584	chrX	56489529	56495584	6055	56492032
chrX:56521365-56524592	chrX	56521365	56524592	3227	56523951
chrX:56581519-56587672	chrX	56581519	56587672	6153	56584109
chrX:56591700-56595359	chrX	56591700	56595359	3659	56594304
chrX:56683889-56685999	chrX	56683889	56685999	2110	56685594
chrX:56805824-56812215	chrX	56805824	56812215	6391	56808345
chrX:56835666-56839282	chrX	56835666	56839282	3616	56838249
chrX:56935419-56937888	chrX	56935419	56937888	2469	56936749
chrX:56937903-56942416	chrX	56937903	56942416	4513	56940476
chrX:56948747-56953110	chrX	56948747	56953110	4363	56951325
chrX:57011664-57014617	chrX	57011664	57014617	2953	57013445
chrX:57053437-57056748	chrX	57053437	57056748	3311	57055337
chrX:57087583-57091137	chrX	57087583	57091137	3554	57087607
chrX:57148049-57152918	chrX	57148049	57152918	4869	57149345
chrX:57157849-57163886	chrX	57157849	57163886	6037	57160428
chrX:57185555-57188774	chrX	57185555	57188774	3219	57188149
chrX:57322808-57328350	chrX	57322808	57328350	5542	57325427
chrX:57412211-57418693	chrX	57412211	57418693	6482	57414804
chrX:57438602-57444722	chrX	57438602	57444722	6120	57441193
chrX:57521844-57525182	chrX	57521844	57525182	3338	57523683
chrX:57805037-57810548	chrX	57805037	57810548	5511	57807620
chrX:57810646-57814096	chrX	57810646	57814096	3450	57812860
chrX:57823950-57827555	chrX	57823950	57827555	3605	57826535
chrX:57946855-57948779	chrX	57946855	57948779	1924	57948416
chrX:57979628-57983220	chrX	57979628	57983220	3592	57982212
chrX:58091681-58092424	chrX	58091681	58092424	743	58092115
chrX:62657511-62661102	chrX	62657511	62661102	3591	62660100
chrX:62867114-62871335	chrX	62867114	62871335	4221	62868024
chrX:62901281-62907115	chrX	62901281	62907115	5834	62903774
chrX:63092250-63097539	chrX	63092250	63097539	5289	63094840
chrX:63261076-63266929	chrX	63261076	63266929	5853	63263662
chrX:63286004-63292073	chrX	63286004	63292073	6069	63288586
chrX:63462532-63466237	chrX	63462532	63466237	3705	63462901
chrX:63597195-63603223	chrX	63597195	63603223	6028	63599784
chrX:63645224-63647914	chrX	63645224	63647914	2690	63647819
chrX:63860383-63866463	chrX	63860383	63866463	6080	63862965
chrX:63969365-63970871	chrX	63969365	63970871	1506	63970532
chrX:64013267-64019286	chrX	64013267	64019286	6019	64015846
chrX:64057503-64063337	chrX	64057503	64063337	5834	64060089
chrX:64078863-64084994	chrX	64078863	64084994	6131	64081450
chrX:64108728-64114190	chrX	64108728	64114190	5462	64111327
chrX:64131878-64137907	chrX	64131878	64137907	6029	64134468
chrX:64252345-64258375	chrX	64252345	64258375	6030	64254935
chrX:64296582-64302591	chrX	64296582	64302591	6009	64299167
chrX:64497209-64503233	chrX	64497209	64503233	6024	64499800
chrX:64543816-64549933	chrX	64543816	64549933	6117	64546405
chrX:64571938-64575124	chrX	64571938	64575124	3186	64573637
chrX:64657667-64658296	chrX	64657667	64658296	629	64657944
chrX:64666493-64670375	chrX	64666493	64670375	3882	64667556
chrX:64689977-64695987	chrX	64689977	64695987	6010	64692555
chrX:64699257-64704763	chrX	64699257	64704763	5506	64701789
chrX:64770032-64774569	chrX	64770032	64774569	4537	64772614
chrX:64798482-64800315	chrX	64798482	64800315	1833	64799938
chrX:65053110-65059224	chrX	65053110	65059224	6114	65055675
chrX:65061148-65067600	chrX	65061148	65067600	6452	65063745
chrX:65118650-65122190	chrX	65118650	65122190	3540	65121238
chrX:65157774-65163922	chrX	65157774	65163922	6148	65160349
chrX:65166045-65172157	chrX	65166045	65172157	6112	65168628
chrX:65188802-65192292	chrX	65188802	65192292	3490	65191387
chrX:65207595-65209676	chrX	65207595	65209676	2081	65208766
chrX:65384860-65389781	chrX	65384860	65389781	4921	65386234
chrX:65393279-65397567	chrX	65393279	65397567	4288	65395774
chrX:65424141-65427339	chrX	65424141	65427339	3198	65426047
chrX:65614680-65620735	chrX	65614680	65620735	6055	65617294
chrX:65760413-65765752	chrX	65760413	65765752	5339	65762010
chrX:65833697-65835485	chrX	65833697	65835485	1788	65835086
chrX:65850696-65856796	chrX	65850696	65856796	6100	65853218
chrX:65888013-65890801	chrX	65888013	65890801	2788	65890597
chrX:66122648-66127677	chrX	66122648	66127677	5029	66123802
chrX:66180696-66186728	chrX	66180696	66186728	6032	66183289
chrX:66332758-66336309	chrX	66332758	66336309	3551	66334789
chrX:66388156-66390936	chrX	66388156	66390936	2780	66390766
chrX:66417791-66424146	chrX	66417791	66424146	6355	66420598
chrX:66585300-66588303	chrX	66585300	66588303	3003	66587863
chrX:66644832-66650353	chrX	66644832	66650353	5521	66647419
chrX:66686993-66693129	chrX	66686993	66693129	6136	66689567
chrX:66740379-66743252	chrX	66740379	66743252	2873	66742964
chrX:66761053-66766956	chrX	66761053	66766956	5903	66763672
chrX:66789046-66795168	chrX	66789046	66795168	6122	66791630
chrX:66924856-66930874	chrX	66924856	66930874	6018	66927441
chrX:66932522-66937600	chrX	66932522	66937600	5078	66935104
chrX:67060006-67066134	chrX	67060006	67066134	6128	67062594
chrX:67146726-67147830	chrX	67146726	67147830	1104	67147621
chrX:67186455-67192574	chrX	67186455	67192574	6119	67189049
chrX:67215674-67217808	chrX	67215674	67217808	2134	67216526
chrX:67219563-67220987	chrX	67219563	67220987	1424	67220446
chrX:67321289-67326763	chrX	67321289	67326763	5474	67323901
chrX:67448618-67449590	chrX	67448618	67449590	972	67449247
chrX:67471182-67473324	chrX	67471182	67473324	2142	67471672
chrX:67626635-67632661	chrX	67626635	67632661	6026	67629225
chrX:67637825-67640740	chrX	67637825	67640740	2915	67640407
chrX:67659222-67665252	chrX	67659222	67665252	6030	67661779
chrX:67703640-67709776	chrX	67703640	67709776	6136	67706234
chrX:67860649-67861339	chrX	67860649	67861339	690	67861005
chrX:68006220-68006489	chrX	68006220	68006489	269	68006340
chrX:68377403-68380860	chrX	68377403	68380860	3457	68380015
chrX:68524521-68530932	chrX	68524521	68530932	6411	68527061
chrX:68559781-68564756	chrX	68559781	68564756	4975	68562365
chrX:68576295-68579696	chrX	68576295	68579696	3401	68578860
chrX:69338764-69341604	chrX	69338764	69341604	2840	69341350
chrX:69458532-69463955	chrX	69458532	69463955	5423	69461130
chrX:69643450-69649211	chrX	69643450	69649211	5761	69645188
chrX:69676829-69682848	chrX	69676829	69682848	6019	69679410
chrX:69709844-69712267	chrX	69709844	69712267	2423	69711581
chrX:69750019-69756180	chrX	69750019	69756180	6161	69752665
chrX:69783286-69789318	chrX	69783286	69789318	6032	69785881
chrX:69822696-69828728	chrX	69822696	69828728	6032	69825286
chrX:69831075-69833800	chrX	69831075	69833800	2725	69833631
chrX:69923164-69927754	chrX	69923164	69927754	4590	69925737
chrX:70210402-70216535	chrX	70210402	70216535	6133	70212990
chrX:70363245-70369397	chrX	70363245	70369397	6152	70365831
chrX:70564406-70570558	chrX	70564406	70570558	6152	70566992
chrX:70710795-70716928	chrX	70710795	70716928	6133	70713379
chrX:70937958-70944111	chrX	70937958	70944111	6153	70940546
chrX:71798457-71801832	chrX	71798457	71801832	3375	71799288
chrX:71837932-71844064	chrX	71837932	71844064	6132	71840513
chrX:71897087-71903211	chrX	71897087	71903211	6124	71899658
chrX:72750161-72753040	chrX	72750161	72753040	2879	72752751
chrX:72811564-72814191	chrX	72811564	72814191	2627	72814107
chrX:72825195-72831405	chrX	72825195	72831405	6210	72827788
chrX:73009294-73010932	chrX	73009294	73010932	1638	73010809
chrX:73031682-73037836	chrX	73031682	73037836	6154	73034271
chrX:73093936-73100083	chrX	73093936	73100083	6147	73096521
chrX:73299635-73305668	chrX	73299635	73305668	6033	73302220
chrX:73428627-73434751	chrX	73428627	73434751	6124	73431215
chrX:73476191-73482637	chrX	73476191	73482637	6446	73478896
chrX:73602245-73607950	chrX	73602245	73607950	5705	73604092
chrX:73671772-73677887	chrX	73671772	73677887	6115	73674321
chrX:73787058-73790073	chrX	73787058	73790073	3015	73788141
chrX:74033943-74040075	chrX	74033943	74040075	6132	74036525
chrX:74040610-74046982	chrX	74040610	74046982	6372	74043170
chrX:74071989-74078510	chrX	74071989	74078510	6521	74074580
chrX:74474478-74480631	chrX	74474478	74480631	6153	74477066
chrX:74687337-74693491	chrX	74687337	74693491	6154	74689922
chrX:74761965-74765743	chrX	74761965	74765743	3778	74764556
chrX:74788952-74795000	chrX	74788952	74795000	6048	74791565
chrX:74872993-74879015	chrX	74872993	74879015	6022	74875582
chrX:74970187-74973277	chrX	74970187	74973277	3090	74972776
chrX:74987557-74988197	chrX	74987557	74988197	640	74988030
chrX:74994033-75000168	chrX	74994033	75000168	6135	74996622
chrX:75183022-75189043	chrX	75183022	75189043	6021	75185609
chrX:75263143-75265882	chrX	75263143	75265882	2739	75263307
chrX:75313521-75317558	chrX	75313521	75317558	4037	75316104
chrX:75555159-75561178	chrX	75555159	75561178	6019	75557749
chrX:75561270-75567303	chrX	75561270	75567303	6033	75563861
chrX:75596508-75602623	chrX	75596508	75602623	6115	75599091
chrX:75690170-75694093	chrX	75690170	75694093	3923	75692746
chrX:75720032-75725003	chrX	75720032	75725003	4971	75721208
chrX:75768939-75771638	chrX	75768939	75771638	2699	75771529
chrX:75804798-75810937	chrX	75804798	75810937	6139	75807393
chrX:75833277-75837328	chrX	75833277	75837328	4051	75835852
chrX:75859583-75863371	chrX	75859583	75863371	3788	75859775
chrX:75875672-75881954	chrX	75875672	75881954	6282	75878242
chrX:75930723-75933807	chrX	75930723	75933807	3084	75932084
chrX:75992975-75998262	chrX	75992975	75998262	5287	75994719
chrX:76034331-76040068	chrX	76034331	76040068	5737	76036201
chrX:76046791-76052939	chrX	76046791	76052939	6148	76049383
chrX:76084466-76086544	chrX	76084466	76086544	2078	76086089
chrX:76178829-76183725	chrX	76178829	76183725	4896	76179879
chrX:76261785-76267352	chrX	76261785	76267352	5567	76264322
chrX:76322785-76328816	chrX	76322785	76328816	6031	76325377
chrX:76373544-76378580	chrX	76373544	76378580	5036	76376137
chrX:76391581-76394598	chrX	76391581	76394598	3017	76394156
chrX:76535186-76538063	chrX	76535186	76538063	2877	76537778
chrX:76574487-76577763	chrX	76574487	76577763	3276	76577039
chrX:76577828-76583982	chrX	76577828	76583982	6154	76580417
chrX:76585554-76591889	chrX	76585554	76591889	6335	76588215
chrX:76597101-76602933	chrX	76597101	76602933	5832	76599676
chrX:76633270-76638620	chrX	76633270	76638620	5350	76635852
chrX:76649356-76649577	chrX	76649356	76649577	221	76649439
chrX:76660277-76666402	chrX	76660277	76666402	6125	76662858
chrX:77027923-77029292	chrX	77027923	77029292	1369	77028361
chrX:77131980-77138133	chrX	77131980	77138133	6153	77134571
chrX:77201973-77205073	chrX	77201973	77205073	3100	77204581
chrX:77205119-77208619	chrX	77205119	77208619	3500	77207698
chrX:77289053-77292608	chrX	77289053	77292608	3555	77291630
chrX:77328510-77331879	chrX	77328510	77331879	3369	77329262
chrX:77405831-77410074	chrX	77405831	77410074	4243	77408368
chrX:77843842-77847573	chrX	77843842	77847573	3731	77844035
chrX:78076378-78081530	chrX	78076378	78081530	5152	78078950
chrX:78152445-78158029	chrX	78152445	78158029	5584	78155033
chrX:78225907-78229778	chrX	78225907	78229778	3871	78228567
chrX:78258649-78261886	chrX	78258649	78261886	3237	78261231
chrX:78445584-78450012	chrX	78445584	78450012	4428	78448174
chrX:78466225-78472391	chrX	78466225	78472391	6166	78468814
chrX:78557649-78564210	chrX	78557649	78564210	6561	78560390
chrX:78627084-78630027	chrX	78627084	78630027	2943	78628885
chrX:78802377-78805155	chrX	78802377	78805155	2778	78804967
chrX:78881338-78883439	chrX	78881338	78883439	2101	78881705
chrX:78975429-78978039	chrX	78975429	78978039	2610	78976557
chrX:79026594-79032726	chrX	79026594	79032726	6132	79029186
chrX:79205683-79211833	chrX	79205683	79211833	6150	79208289
chrX:79215199-79218196	chrX	79215199	79218196	2997	79217075
chrX:79651373-79654230	chrX	79651373	79654230	2857	79652986
chrX:79765605-79771625	chrX	79765605	79771625	6020	79768187
chrX:79985243-79988348	chrX	79985243	79988348	3105	79987825
chrX:80060558-80066695	chrX	80060558	80066695	6137	80063132
chrX:80151302-80157458	chrX	80151302	80157458	6156	80153889
chrX:80346660-80353138	chrX	80346660	80353138	6478	80349246
chrX:80377248-80383131	chrX	80377248	80383131	5883	80379546
chrX:80534203-80536001	chrX	80534203	80536001	1798	80535857
chrX:80596574-80598601	chrX	80596574	80598601	2027	80598585
chrX:80740910-80743713	chrX	80740910	80743713	2803	80743484
chrX:80822206-80828636	chrX	80822206	80828636	6430	80824784
chrX:80958866-80963355	chrX	80958866	80963355	4489	80961453
chrX:80963330-80967445	chrX	80963330	80967445	4115	80965081
chrX:80976869-80982806	chrX	80976869	80982806	5937	80979370
chrX:81339892-81345906	chrX	81339892	81345906	6014	81342466
chrX:81385394-81387210	chrX	81385394	81387210	1816	81386897
chrX:81469490-81475588	chrX	81469490	81475588	6098	81472069
chrX:81590183-81591401	chrX	81590183	81591401	1218	81591120
chrX:81692395-81695852	chrX	81692395	81695852	3457	81694049
chrX:81963582-81965079	chrX	81963582	81965079	1497	81964555
chrX:82003118-82005068	chrX	82003118	82005068	1950	82004816
chrX:82198630-82201826	chrX	82198630	82201826	3196	82200446
chrX:82546512-82552572	chrX	82546512	82552572	6060	82549133
chrX:82576804-82581798	chrX	82576804	82581798	4994	82577904
chrX:82802801-82808940	chrX	82802801	82808940	6139	82805379
chrX:83059584-83065637	chrX	83059584	83065637	6053	83062197
chrX:83280910-83284225	chrX	83280910	83284225	3315	83283497
chrX:83361696-83364833	chrX	83361696	83364833	3137	83364285
chrX:83430378-83431988	chrX	83430378	83431988	1610	83431486
chrX:83648724-83655748	chrX	83648724	83655748	7024	83652156
chrX:83682935-83689351	chrX	83682935	83689351	6416	83685496
chrX:83691903-83695622	chrX	83691903	83695622	3719	83694491
chrX:83817710-83818735	chrX	83817710	83818735	1025	83817825
chrX:84083260-84089908	chrX	84083260	84089908	6648	84085766
chrX:84262694-84265653	chrX	84262694	84265653	2959	84264412
chrX:84809052-84812542	chrX	84809052	84812542	3490	84811629
chrX:85058879-85065603	chrX	85058879	85065603	6724	85063963
chrX:85127653-85133787	chrX	85127653	85133787	6134	85130234
chrX:85311203-85314113	chrX	85311203	85314113	2910	85313763
chrX:85404323-85405553	chrX	85404323	85405553	1230	85404935
chrX:85421834-85427862	chrX	85421834	85427862	6028	85424425
chrX:85555430-85561869	chrX	85555430	85561869	6439	85558007
chrX:85563708-85568167	chrX	85563708	85568167	4459	85566235
chrX:85728521-85733686	chrX	85728521	85733686	5165	85731118
chrX:85751722-85757867	chrX	85751722	85757867	6145	85754307
chrX:85766895-85773034	chrX	85766895	85773034	6139	85769477
chrX:85788748-85792109	chrX	85788748	85792109	3361	85791338
chrX:86113292-86119348	chrX	86113292	86119348	6056	86115909
chrX:86181198-86184211	chrX	86181198	86184211	3013	86183763
chrX:86289420-86295425	chrX	86289420	86295425	6005	86292013
chrX:86333761-86336384	chrX	86333761	86336384	2623	86336336
chrX:86350178-86354023	chrX	86350178	86354023	3845	86351962
chrX:86395389-86401524	chrX	86395389	86401524	6135	86397978
chrX:86446293-86449424	chrX	86446293	86449424	3131	86448885
chrX:86557357-86560507	chrX	86557357	86560507	3150	86558527
chrX:86897914-86900130	chrX	86897914	86900130	2216	86899040
chrX:87443126-87449269	chrX	87443126	87449269	6143	87445705
chrX:87553793-87556174	chrX	87553793	87556174	2381	87555306
chrX:88033195-88036642	chrX	88033195	88036642	3447	88035787
chrX:88110598-88113434	chrX	88110598	88113434	2836	88113162
chrX:88317181-88320770	chrX	88317181	88320770	3589	88319466
chrX:88781409-88787562	chrX	88781409	88787562	6153	88784002
chrX:89934201-89938198	chrX	89934201	89938198	3997	89934391
chrX:90340222-90343315	chrX	90340222	90343315	3093	90342787
chrX:91035263-91040637	chrX	91035263	91040637	5374	91036721
chrX:91294494-91298224	chrX	91294494	91298224	3730	91297101
chrX:91332922-91336075	chrX	91332922	91336075	3153	91334140
chrX:91358198-91359954	chrX	91358198	91359954	1756	91359601
chrX:91673929-91676774	chrX	91673929	91676774	2845	91676438
chrX:91819650-91825702	chrX	91819650	91825702	6052	91822262
chrX:91859077-91861349	chrX	91859077	91861349	2272	91861065
chrX:92577026-92578148	chrX	92577026	92578148	1122	92577132
chrX:93029339-93033240	chrX	93029339	93033240	3901	93031944
chrX:93314562-93317331	chrX	93314562	93317331	2769	93317145
chrX:93883184-93887155	chrX	93883184	93887155	3971	93885742
chrX:94763584-94769113	chrX	94763584	94769113	5529	94766178
chrX:94839205-94845656	chrX	94839205	94845656	6451	94841797
chrX:95115839-95116084	chrX	95115839	95116084	245	95115957
chrX:95543891-95549904	chrX	95543891	95549904	6013	95546478
chrX:95612970-95619412	chrX	95612970	95619412	6442	95615518
chrX:96054743-96057778	chrX	96054743	96057778	3035	96057339
chrX:96057824-96063842	chrX	96057824	96063842	6018	96060403
chrX:96254213-96258374	chrX	96254213	96258374	4161	96256793
chrX:96339251-96343780	chrX	96339251	96343780	4529	96339369
chrX:96345377-96350891	chrX	96345377	96350891	5514	96347953
chrX:96809518-96815659	chrX	96809518	96815659	6141	96812108
chrX:97509510-97515511	chrX	97509510	97515511	6001	97512097
chrX:97578170-97584188	chrX	97578170	97584188	6018	97580757
chrX:97797917-97804030	chrX	97797917	97804030	6113	97800505
chrX:98043393-98049812	chrX	98043393	98049812	6419	98045939
chrX:98125663-98128940	chrX	98125663	98128940	3277	98128248
chrX:98234872-98241308	chrX	98234872	98241308	6436	98237434
chrX:98424325-98430357	chrX	98424325	98430357	6032	98426917
chrX:98560101-98565617	chrX	98560101	98565617	5516	98562686
chrX:98687494-98693514	chrX	98687494	98693514	6020	98690086
chrX:98693515-98699577	chrX	98693515	98699577	6062	98695688
chrX:99510011-99514178	chrX	99510011	99514178	4167	99512596
chrX:99566533-99569905	chrX	99566533	99569905	3372	99569119
chrX:99593966-99598744	chrX	99593966	99598744	4778	99596576
chrX:99643906-99646548	chrX	99643906	99646548	2642	99646498
chrX:99863395-99864359	chrX	99863395	99864359	964	99863638
chrX:100111453-100112460	chrX	100111453	100112460	1007	100112292
chrX:101434652-101438282	chrX	101434652	101438282	3630	101437233
chrX:101577687-101579637	chrX	101577687	101579637	1950	101578434
chrX:101580038-101586192	chrX	101580038	101586192	6154	101582620
chrX:101711073-101717106	chrX	101711073	101717106	6033	101713666
chrX:101805955-101809661	chrX	101805955	101809661	3706	101808547
chrX:101816572-101822976	chrX	101816572	101822976	6404	101819187
chrX:102047324-102051339	chrX	102047324	102051339	4015	102049914
chrX:102189511-102191059	chrX	102189511	102191059	1548	102189560
chrX:102191058-102197200	chrX	102191058	102197200	6142	102193649
chrX:102230478-102236613	chrX	102230478	102236613	6135	102233068
chrX:102417668-102422225	chrX	102417668	102422225	4557	102420258
chrX:102663700-102666566	chrX	102663700	102666566	2866	102666179
chrX:102685887-102692023	chrX	102685887	102692023	6136	102688468
chrX:102777487-102782166	chrX	102777487	102782166	4679	102779704
chrX:102801487-102802783	chrX	102801487	102802783	1296	102801795
chrX:102871176-102877321	chrX	102871176	102877321	6145	102873767
chrX:103020459-103026616	chrX	103020459	103026616	6157	103023051
chrX:103454544-103460671	chrX	103454544	103460671	6127	103457136
chrX:103891506-103897537	chrX	103891506	103897537	6031	103894098
chrX:103897538-103903266	chrX	103897538	103903266	5728	103899706
chrX:103936144-103940710	chrX	103936144	103940710	4566	103937257
chrX:104026871-104032902	chrX	104026871	104032902	6031	104029463
chrX:104360639-104366787	chrX	104360639	104366787	6148	104363228
chrX:104404429-104409366	chrX	104404429	104409366	4937	104405827
chrX:104539523-104542200	chrX	104539523	104542200	2677	104542075
chrX:104547692-104548954	chrX	104547692	104548954	1262	104548443
chrX:104630840-104636989	chrX	104630840	104636989	6149	104633429
chrX:104654584-104657217	chrX	104654584	104657217	2633	104655760
chrX:104672099-104678122	chrX	104672099	104678122	6023	104674685
chrX:104823744-104824918	chrX	104823744	104824918	1174	104824475
chrX:104889804-104895934	chrX	104889804	104895934	6130	104892383
chrX:104904301-104910378	chrX	104904301	104910378	6077	104906890
chrX:104914565-104917259	chrX	104914565	104917259	2694	104917157
chrX:104946421-104950291	chrX	104946421	104950291	3870	104949006
chrX:105039585-105041514	chrX	105039585	105041514	1929	105040469
chrX:105073045-105079149	chrX	105073045	105079149	6104	105075630
chrX:105079461-105082420	chrX	105079461	105082420	2959	105082063
chrX:105807986-105808775	chrX	105807986	105808775	789	105808113
chrX:106487873-106489918	chrX	106487873	106489918	2045	106489717
chrX:106573139-106579290	chrX	106573139	106579290	6151	106575730
chrX:107376057-107379968	chrX	107376057	107379968	3911	107378611
chrX:107584166-107587784	chrX	107584166	107587784	3618	107586030
chrX:107885132-107891264	chrX	107885132	107891264	6132	107887712
chrX:107943564-107949681	chrX	107943564	107949681	6117	107946022
chrX:107953578-107956660	chrX	107953578	107956660	3082	107956177
chrX:107986077-107991597	chrX	107986077	107991597	5520	107988671
chrX:108385718-108391964	chrX	108385718	108391964	6246	108388304
chrX:108542109-108548255	chrX	108542109	108548255	6146	108544697
chrX:108819239-108825669	chrX	108819239	108825669	6430	108821819
chrX:109019329-109025469	chrX	109019329	109025469	6140	109021901
chrX:109066647-109072737	chrX	109066647	109072737	6090	109069225
chrX:109073368-109077591	chrX	109073368	109077591	4223	109075388
chrX:109083336-109089721	chrX	109083336	109089721	6385	109085912
chrX:109204187-109209355	chrX	109204187	109209355	5168	109205894
chrX:109314861-109319740	chrX	109314861	109319740	4879	109317488
chrX:109329815-109335969	chrX	109329815	109335969	6154	109332406
chrX:109895462-109901628	chrX	109895462	109901628	6166	109898059
chrX:110090709-110096813	chrX	110090709	110096813	6104	110093277
chrX:110467115-110470029	chrX	110467115	110470029	2914	110469686
chrX:110640008-110646163	chrX	110640008	110646163	6155	110642606
chrX:110816764-110822773	chrX	110816764	110822773	6009	110819345
chrX:110898394-110904467	chrX	110898394	110904467	6073	110900979
chrX:111572554-111575647	chrX	111572554	111575647	3093	111575141
chrX:111588704-111594727	chrX	111588704	111594727	6023	111591287
chrX:111638219-111639587	chrX	111638219	111639587	1368	111638574
chrX:111802868-111805496	chrX	111802868	111805496	2628	111805439
chrX:111992911-111996809	chrX	111992911	111996809	3898	111995552
chrX:112240676-112246853	chrX	112240676	112246853	6177	112243284
chrX:112349406-112352285	chrX	112349406	112352285	2879	112350452
chrX:112431732-112434681	chrX	112431732	112434681	2949	112434321
chrX:112545803-112549488	chrX	112545803	112549488	3685	112548389
chrX:112914386-112917445	chrX	112914386	112917445	3059	112916970
chrX:112922900-112926233	chrX	112922900	112926233	3333	112925480
chrX:113197149-113203387	chrX	113197149	113203387	6238	113199748
chrX:113206631-113212667	chrX	113206631	113212667	6036	113209110
chrX:113337822-113343853	chrX	113337822	113343853	6031	113340415
chrX:113691946-113698365	chrX	113691946	113698365	6419	113694511
chrX:113731898-113736484	chrX	113731898	113736484	4586	113732582
chrX:113819206-113821963	chrX	113819206	113821963	2757	113821780
chrX:113857756-113861745	chrX	113857756	113861745	3989	113860339
chrX:114121940-114128258	chrX	114121940	114128258	6318	114124407
chrX:114720516-114726531	chrX	114720516	114726531	6015	114723103
chrX:114830697-114836732	chrX	114830697	114836732	6035	114833288
chrX:114938785-114943635	chrX	114938785	114943635	4850	114939851
chrX:115080436-115086611	chrX	115080436	115086611	6175	115083031
chrX:116046900-116052919	chrX	116046900	116052919	6019	116049486
chrX:116063903-116068483	chrX	116063903	116068483	4580	116066484
chrX:116514614-116520629	chrX	116514614	116520629	6015	116517196
chrX:116741683-116742108	chrX	116741683	116742108	425	116741754
chrX:116941312-116947286	chrX	116941312	116947286	5974	116943867
chrX:116964806-116970835	chrX	116964806	116970835	6029	116967404
chrX:117179372-117180568	chrX	117179372	117180568	1196	117180444
chrX:117252288-117256465	chrX	117252288	117256465	4177	117254882
chrX:117422044-117422837	chrX	117422044	117422837	793	117422696
chrX:117462212-117467517	chrX	117462212	117467517	5305	117464780
chrX:117594771-117596939	chrX	117594771	117596939	2168	117594960
chrX:117727933-117733746	chrX	117727933	117733746	5813	117730520
chrX:117757179-117763331	chrX	117757179	117763331	6152	117759768
chrX:117827446-117831479	chrX	117827446	117831479	4033	117830027
chrX:117873996-117880023	chrX	117873996	117880023	6027	117876587
chrX:117938942-117944158	chrX	117938942	117944158	5216	117941424
chrX:119435468-119441493	chrX	119435468	119441493	6025	119438056
chrX:120046403-120052518	chrX	120046403	120052518	6115	120048974
chrX:120385253-120391208	chrX	120385253	120391208	5955	120387654
chrX:120827144-120833523	chrX	120827144	120833523	6379	120829622
chrX:121531198-121537361	chrX	121531198	121537361	6163	121533794
chrX:121695487-121697899	chrX	121695487	121697899	2412	121697302
chrX:121797171-121803618	chrX	121797171	121803618	6447	121799727
chrX:122038141-122043110	chrX	122038141	122043110	4969	122039273
chrX:122191815-122193451	chrX	122191815	122193451	1636	122192210
chrX:122254270-122254818	chrX	122254270	122254818	548	122254449
chrX:122357875-122365678	chrX	122357875	122365678	7803	122360341
chrX:122394375-122396339	chrX	122394375	122396339	1964	122395247
chrX:122492456-122496673	chrX	122492456	122496673	4217	122495052
chrX:122527221-122528500	chrX	122527221	122528500	1279	122528063
chrX:122615875-122619649	chrX	122615875	122619649	3774	122618422
chrX:122921056-122923781	chrX	122921056	122923781	2725	122922976
chrX:123004800-123007699	chrX	123004800	123007699	2899	123007389
chrX:123529007-123533449	chrX	123529007	123533449	4442	123531595
chrX:124104425-124110535	chrX	124104425	124110535	6110	124106991
chrX:124751493-124757642	chrX	124751493	124757642	6149	124754076
chrX:125363294-125366018	chrX	125363294	125366018	2724	125365924
chrX:125510365-125515187	chrX	125510365	125515187	4822	125512950
chrX:125608955-125614969	chrX	125608955	125614969	6014	125611537
chrX:125700025-125705976	chrX	125700025	125705976	5951	125702296
chrX:125788696-125789723	chrX	125788696	125789723	1027	125789391
chrX:126104124-126110137	chrX	126104124	126110137	6013	126106712
chrX:126185970-126191252	chrX	126185970	126191252	5282	126187811
chrX:126229456-126235427	chrX	126229456	126235427	5971	126232049
chrX:126562776-126565121	chrX	126562776	126565121	2345	126564268
chrX:126579865-126580903	chrX	126579865	126580903	1038	126580760
chrX:126801395-126803642	chrX	126801395	126803642	2247	126802590
chrX:126848926-126849305	chrX	126848926	126849305	379	126849244
chrX:127050833-127054873	chrX	127050833	127054873	4040	127053409
chrX:127116697-127122729	chrX	127116697	127122729	6032	127119289
chrX:127250463-127256492	chrX	127250463	127256492	6029	127253053
chrX:127263999-127264872	chrX	127263999	127264872	873	127264840
chrX:127431284-127435103	chrX	127431284	127435103	3819	127433838
chrX:128349380-128350665	chrX	128349380	128350665	1285	128350292
chrX:128443807-128447168	chrX	128443807	128447168	3361	128446379
chrX:128537351-128541105	chrX	128537351	128541105	3754	128539879
chrX:128669036-128675512	chrX	128669036	128675512	6476	128671606
chrX:128942684-128945727	chrX	128942684	128945727	3043	128945243
chrX:129853650-129859360	chrX	129853650	129859360	5710	129856233
chrX:130447510-130453653	chrX	130447510	130453653	6143	130450095
chrX:130567667-130573661	chrX	130567667	130573661	5994	130570259
chrX:131003043-131005315	chrX	131003043	131005315	2272	131004435
chrX:131123218-131129243	chrX	131123218	131129243	6025	131125801
chrX:131152272-131158295	chrX	131152272	131158295	6023	131154856
chrX:131245544-131251574	chrX	131245544	131251574	6030	131248133
chrX:131378334-131384369	chrX	131378334	131384369	6035	131380926
chrX:131471473-131473969	chrX	131471473	131473969	2496	131473044
chrX:132156145-132162158	chrX	132156145	132162158	6013	132158735
chrX:132244038-132250171	chrX	132244038	132250171	6133	132246621
chrX:132284468-132290617	chrX	132284468	132290617	6149	132287061
chrX:132316306-132318139	chrX	132316306	132318139	1833	132316464
chrX:132445801-132452124	chrX	132445801	132452124	6323	132448230
chrX:132864976-132867642	chrX	132864976	132867642	2666	132867568
chrX:132880627-132883498	chrX	132880627	132883498	2871	132883216
chrX:133036157-133042660	chrX	133036157	133042660	6503	133038750
chrX:133108418-133111381	chrX	133108418	133111381	2963	133111005
chrX:134044163-134050309	chrX	134044163	134050309	6146	134046755
chrX:134056636-134061322	chrX	134056636	134061322	4686	134059225
chrX:135257829-135263951	chrX	135257829	135263951	6122	135260382
chrX:135659516-135665667	chrX	135659516	135665667	6151	135662102
chrX:135724485-135727696	chrX	135724485	135727696	3211	135727082
chrX:135935860-135941866	chrX	135935860	135941866	6006	135938357
chrX:136296924-136297906	chrX	136296924	136297906	982	136297728
chrX:136440268-136446301	chrX	136440268	136446301	6033	136442860
chrX:136977130-136983272	chrX	136977130	136983272	6142	136979717
chrX:137074722-137080869	chrX	137074722	137080869	6147	137077311
chrX:137764937-137767833	chrX	137764937	137767833	2896	137767522
chrX:138796055-138802138	chrX	138796055	138802138	6083	138798653
chrX:138957440-138961589	chrX	138957440	138961589	4149	138958609
chrX:139373543-139376280	chrX	139373543	139376280	2737	139375288
chrX:139433954-139435691	chrX	139433954	139435691	1737	139434823
chrX:139670315-139676461	chrX	139670315	139676461	6146	139672903
chrX:139989004-139995163	chrX	139989004	139995163	6159	139991594
chrX:140235156-140238689	chrX	140235156	140238689	3533	140237750
chrX:140268384-140273350	chrX	140268384	140273350	4966	140269466
chrX:141223613-141227157	chrX	141223613	141227157	3544	141226204
chrX:141249668-141251692	chrX	141249668	141251692	2024	141251398
chrX:141284433-141288621	chrX	141284433	141288621	4188	141287026
chrX:141421202-141427246	chrX	141421202	141427246	6044	141423807
chrX:141537173-141543099	chrX	141537173	141543099	5926	141539742
chrX:141564879-141568413	chrX	141564879	141568413	3534	141567463
chrX:141678544-141682087	chrX	141678544	141682087	3543	141681131
chrX:141702692-141705921	chrX	141702692	141705921	3229	141705278
chrX:141799232-141803971	chrX	141799232	141803971	4739	141801822
chrX:142121412-142123603	chrX	142121412	142123603	2191	142121725
chrX:142152961-142155966	chrX	142152961	142155966	3005	142155315
chrX:142385590-142391622	chrX	142385590	142391622	6032	142388183
chrX:142790279-142793513	chrX	142790279	142793513	3234	142792860
chrX:142907901-142910637	chrX	142907901	142910637	2736	142909342
chrX:143351968-143354311	chrX	143351968	143354311	2343	143352255
chrX:143440888-143442639	chrX	143440888	143442639	1751	143442011
chrX:143762305-143768395	chrX	143762305	143768395	6090	143764887
chrX:144194287-144196920	chrX	144194287	144196920	2633	144196875
chrX:144753887-144755619	chrX	144753887	144755619	1732	144753923
chrX:146227925-146234095	chrX	146227925	146234095	6170	146230531
chrX:146289274-146293261	chrX	146289274	146293261	3987	146289479
chrX:147142048-147148161	chrX	147142048	147148161	6113	147144600
chrX:147408811-147410975	chrX	147408811	147410975	2164	147409703
chrX:148123449-148129475	chrX	148123449	148129475	6026	148126057
chrX:148176895-148182510	chrX	148176895	148182510	5615	148178703
chrX:148258816-148259502	chrX	148258816	148259502	686	148259106
chrX:148299760-148305864	chrX	148299760	148305864	6104	148302337
chrX:148325525-148331603	chrX	148325525	148331603	6078	148328054
chrX:148346941-148353036	chrX	148346941	148353036	6095	148349494
chrX:148358732-148360298	chrX	148358732	148360298	1566	148359927
chrX:148775864-148782141	chrX	148775864	148782141	6277	148778440
chrX:149178166-149184185	chrX	149178166	149184185	6019	149180757
chrX:149821205-149824961	chrX	149821205	149824961	3756	149821415
chrX:150066124-150071624	chrX	150066124	150071624	5500	150068697
chrX:150103795-150105362	chrX	150103795	150105362	1567	150105032
chrX:150168900-150172075	chrX	150168900	150172075	3175	150171491
chrX:150400339-150401206	chrX	150400339	150401206	867	150401046
chrX:150417926-150421451	chrX	150417926	150421451	3525	150418026
chrX:151142001-151143603	chrX	151142001	151143603	1602	151143479
chrX:151366731-151368865	chrX	151366731	151368865	2134	151367279
chrX:151654853-151657870	chrX	151654853	151657870	3017	151657447
chrX:152235997-152242028	chrX	152235997	152242028	6031	152238581
chrX:152608866-152610379	chrX	152608866	152610379	1513	152609144
chrX:152674480-152678582	chrX	152674480	152678582	4102	152677073
chrX:152835297-152841440	chrX	152835297	152841440	6143	152837884
chrX:154665132-154667982	chrX	154665132	154667982	2850	154667711
chrX:154842796-154848933	chrX	154842796	154848933	6137	154845380
chrX:155157415-155163333	chrX	155157415	155163333	5918	155160008
chrX:155182346-155186123	chrX	155182346	155186123	3777	155184934
chrX:155189655-155193492	chrX	155189655	155193492	3837	155192258
chrX:155299575-155305601	chrX	155299575	155305601	6026	155302167
chrX:155481357-155487841	chrX	155481357	155487841	6484	155483967
chrX:155516016-155522048	chrX	155516016	155522048	6032	155518608
chrX:155700620-155703831	chrX	155700620	155703831	3211	155703203
chrX:155722805-155728823	chrX	155722805	155728823	6018	155725406
chrX:155851655-155855419	chrX	155851655	155855419	3764	155854234
chrX:155901520-155903230	chrX	155901520	155903230	1710	155902957
chrX:155930717-155936823	chrX	155930717	155936823	6106	155933291
chrX_KI270881v1_alt:116931-121080	chrX_KI270881v1_alt	116931	121080	4149	119523
chrY:2801748-2805542	chrY	2801748	2805542	3794	2804332
chrY:2805566-2811745	chrY	2805566	2811745	6179	2808146
chrY:3026852-3032994	chrY	3026852	3032994	6142	3029435
chrY:3591767-3595341	chrY	3591767	3595341	3574	3591957
chrY:3916974-3920064	chrY	3916974	3920064	3090	3919536
chrY:4913129-4915967	chrY	4913129	4915967	2838	4915631
chrY:4948913-4954938	chrY	4948913	4954938	6025	4951504
chrY:5041086-5047139	chrY	5041086	5047139	6053	5043699
chrY:5080484-5082755	chrY	5080484	5082755	2271	5082471
chrY:5606144-5612199	chrY	5606144	5612199	6055	5608760
chrY:5696108-5697218	chrY	5696108	5697218	1110	5696200
chrY:6145599-6149500	chrY	6145599	6149500	3901	6148204
chrY:6289968-6294886	chrY	6289968	6294886	4918	6291363
chrY:6430640-6433598	chrY	6430640	6433598	2958	6433223
chrY:6500500-6502345	chrY	6500500	6502345	1845	6501476
chrY:6524554-6526235	chrY	6524554	6526235	1681	6526218
chrY:6768986-6774880	chrY	6768986	6774880	5894	6771576
chrY:6950794-6954798	chrY	6950794	6954798	4004	6951269
chrY:7129816-7134598	chrY	7129816	7134598	4782	7132392
chrY:7154111-7160133	chrY	7154111	7160133	6022	7156694
chrY:7190018-7196118	chrY	7190018	7196118	6100	7192579
chrY:7249559-7255513	chrY	7249559	7255513	5954	7252146
chrY:7510224-7511897	chrY	7510224	7511897	1673	7511523
chrY:7524759-7526233	chrY	7524759	7526233	1474	7525497
chrY:7570056-7576073	chrY	7570056	7576073	6017	7572642
chrY:7705151-7711267	chrY	7705151	7711267	6116	7707630
chrY:8026569-8029465	chrY	8026569	8029465	2896	8029156
chrY:8096459-8102572	chrY	8096459	8102572	6113	8099049
chrY:8134318-8140335	chrY	8134318	8140335	6017	8136906
chrY:8305697-8310147	chrY	8305697	8310147	4450	8308281
chrY:8453440-8457769	chrY	8453440	8457769	4329	8456023
chrY:8475923-8478030	chrY	8475923	8478030	2107	8477060
chrY:8501361-8503979	chrY	8501361	8503979	2618	8503924
chrY:8943048-8949182	chrY	8943048	8949182	6134	8945634
chrY:9837738-9840659	chrY	9837738	9840659	2921	9840312
chrY:9848533-9850444	chrY	9848533	9850444	1911	9849577
chrY:9961614-9967750	chrY	9961614	9967750	6136	9964198
chrY:10108460-10113087	chrY	10108460	10113087	4627	10109549
chrY:10160072-10166217	chrY	10160072	10166217	6145	10162656
chrY:10214924-10216086	chrY	10214924	10216086	1162	10215971
chrY:10238177-10241246	chrY	10238177	10241246	3069	10240759
chrY:11223337-11228527	chrY	11223337	11228527	5190	11225908
chrY:11268002-11274133	chrY	11268002	11274133	6131	11270590
chrY:11403833-11405796	chrY	11403833	11405796	1963	11405287
chrY:11856619-11861094	chrY	11856619	11861094	4475	11857705
chrY:11988612-11994466	chrY	11988612	11994466	5854	11991205
chrY:11997582-12003592	chrY	11997582	12003592	6010	12000166
chrY:12008133-12011695	chrY	12008133	12011695	3562	12009964
chrY:12168314-12171235	chrY	12168314	12171235	2921	12170901
chrY:12518397-12523999	chrY	12518397	12523999	5602	12520989
chrY:12624027-12630236	chrY	12624027	12630236	6209	12626615
chrY:12847480-12853663	chrY	12847480	12853663	6183	12850033
chrY:12985911-12992021	chrY	12985911	12992021	6110	12988496
chrY:13130498-13136521	chrY	13130498	13136521	6023	13133087
chrY:13179085-13185115	chrY	13179085	13185115	6030	13181676
chrY:13263829-13269552	chrY	13263829	13269552	5723	13266100
chrY:13514407-13518036	chrY	13514407	13518036	3629	13517005
chrY:13559272-13565292	chrY	13559272	13565292	6020	13561860
chrY:13740720-13746742	chrY	13740720	13746742	6022	13743305
chrY:13770703-13776733	chrY	13770703	13776733	6030	13773297
chrY:13776832-13782972	chrY	13776832	13782972	6140	13779440
chrY:13845924-13852081	chrY	13845924	13852081	6157	13848510
chrY:13967375-13971979	chrY	13967375	13971979	4604	13969950
chrY:14024193-14030198	chrY	14024193	14030198	6005	14026765
chrY:14094279-14099477	chrY	14094279	14099477	5198	14096869
chrY:14267272-14269997	chrY	14267272	14269997	2725	14269863
chrY:14561090-14564289	chrY	14561090	14564289	3199	14563629
chrY:14570605-14576724	chrY	14570605	14576724	6119	14573184
chrY:14613440-14617402	chrY	14613440	14617402	3962	14616035
chrY:14702164-14705057	chrY	14702164	14705057	2893	14704749
chrY:14885070-14888679	chrY	14885070	14888679	3609	14885128
chrY:14889374-14891179	chrY	14889374	14891179	1805	14890163
chrY:14911382-14915985	chrY	14911382	14915985	4603	14913971
chrY:14971157-14973816	chrY	14971157	14973816	2659	14973754
chrY:15010366-15013440	chrY	15010366	15013440	3074	15012939
chrY:15047720-15053744	chrY	15047720	15053744	6024	15050276
chrY:15106167-15109034	chrY	15106167	15109034	2867	15108708
chrY:15145879-15148885	chrY	15145879	15148885	3006	15146053
chrY:15153009-15159054	chrY	15153009	15159054	6045	15155487
chrY:15526253-15530077	chrY	15526253	15530077	3824	15528834
chrY:15585009-15590972	chrY	15585009	15590972	5963	15587582
chrY:15671727-15672386	chrY	15671727	15672386	659	15671885
chrY:15683486-15684704	chrY	15683486	15684704	1218	15683527
chrY:15710312-15712034	chrY	15710312	15712034	1722	15710388
chrY:15722321-15728344	chrY	15722321	15728344	6023	15724905
chrY:15742349-15748477	chrY	15742349	15748477	6128	15744929
chrY:15786191-15791877	chrY	15786191	15791877	5686	15788773
chrY:15942637-15947106	chrY	15942637	15947106	4469	15943565
chrY:16018431-16024581	chrY	16018431	16024581	6150	16021021
chrY:16043695-16045183	chrY	16043695	16045183	1488	16043817
chrY:16114698-16120742	chrY	16114698	16120742	6044	16117295
chrY:16217866-16224003	chrY	16217866	16224003	6137	16220449
chrY:16505909-16506524	chrY	16505909	16506524	615	16506262
chrY:16734161-16737841	chrY	16734161	16737841	3680	16734672
chrY:16854970-16857715	chrY	16854970	16857715	2745	16855291
chrY:16969674-16974339	chrY	16969674	16974339	4665	16972246
chrY:17060920-17066963	chrY	17060920	17066963	6043	17063512
chrY:17321257-17322562	chrY	17321257	17322562	1305	17322351
chrY:17427698-17430697	chrY	17427698	17430697	2999	17430264
chrY:17589769-17590627	chrY	17589769	17590627	858	17590485
chrY:17664318-17668712	chrY	17664318	17668712	4394	17665276
chrY:17955764-17961792	chrY	17955764	17961792	6028	17958301
chrY:18005968-18011451	chrY	18005968	18011451	5483	18007798
chrY:18074724-18078206	chrY	18074724	18078206	3482	18077214
chrY:18191509-18197658	chrY	18191509	18197658	6149	18194096
chrY:19108923-19115061	chrY	19108923	19115061	6138	19111506
chrY:19115063-19118558	chrY	19115063	19118558	3495	19117275
chrY:19185148-19191254	chrY	19185148	19191254	6106	19187718
chrY:19214706-19219217	chrY	19214706	19219217	4511	19216543
chrY:19219217-19219429	chrY	19219217	19219429	212	19219262
chrY:19285839-19287066	chrY	19285839	19287066	1227	19286491
chrY:19334010-19336657	chrY	19334010	19336657	2647	19336312
chrY:19373283-19379312	chrY	19373283	19379312	6029	19375873
chrY:19413656-19419018	chrY	19413656	19419018	5362	19415583
chrY:19467513-19473668	chrY	19467513	19473668	6155	19470111
chrY:19506634-19510217	chrY	19506634	19510217	3583	19506671
chrY:19580508-19586611	chrY	19580508	19586611	6103	19583057
chrY:19624465-19630268	chrY	19624465	19630268	5803	19626729
chrY:19640842-19644416	chrY	19640842	19644416	3574	19643482
chrY:19684951-19690855	chrY	19684951	19690855	5904	19687451
chrY:19792396-19797638	chrY	19792396	19797638	5242	19794958
chrY:19834098-19840237	chrY	19834098	19840237	6139	19836690
chrY:19987885-19994008	chrY	19987885	19994008	6123	19990455
chrY:20380425-20384600	chrY	20380425	20384600	4175	20383152
chrY:20382300-20386697	chrY	20382300	20386697	4397	20383152
chrY:20457288-20463400	chrY	20457288	20463400	6112	20459867
chrY:20473017-20475821	chrY	20473017	20475821	2804	20475598
chrY:20503800-20505007	chrY	20503800	20505007	1207	20504146
chrY:20614861-20620934	chrY	20614861	20620934	6073	20617440
chrY:20626006-20628148	chrY	20626006	20628148	2142	20628106
chrY:20822282-20827017	chrY	20822282	20827017	4735	20823590
chrY:20851759-20855785	chrY	20851759	20855785	4026	20854336
chrY:20914303-20917340	chrY	20914303	20917340	3037	20916897
chrY:20919912-20926008	chrY	20919912	20926008	6096	20922432
chrY:20944133-20950163	chrY	20944133	20950163	6030	20946716
chrY:21005916-21011937	chrY	21005916	21011937	6021	21008503
chrY:21047755-21053791	chrY	21047755	21053791	6036	21050355
chrY:21123535-21129642	chrY	21123535	21129642	6107	21126112
chrY:21155840-21160116	chrY	21155840	21160116	4276	21158421
chrY:21438190-21441639	chrY	21438190	21441639	3449	21440757
chrY:21984205-21987266	chrY	21984205	21987266	3061	21986789
chrY:22226942-22230214	chrY	22226942	22230214	3272	22229528
chrY:22339612-22345645	chrY	22339612	22345645	6033	22342203
chrY:22494516-22500403	chrY	22494516	22500403	5887	22496781
chrY:22539320-22545462	chrY	22539320	22545462	6142	22541909
chrY:22773255-22777990	chrY	22773255	22777990	4735	22775875
chrY:22847221-22850788	chrY	22847221	22850788	3567	22849830
chrY:23258083-23264121	chrY	23258083	23264121	6038	23260675
chrY:23379645-23384596	chrY	23379645	23384596	4951	23381030
chrY:23593494-23596555	chrY	23593494	23596555	3061	23596078
chrY:23730432-23732414	chrY	23730432	23732414	1982	23732208
chrY:23956871-23959834	chrY	23956871	23959834	2963	23959463
chrY:24110496-24115735	chrY	24110496	24115735	5239	24112243
chrY:24294421-24300439	chrY	24294421	24300439	6018	24297004
chrY:24406998-24411734	chrY	24406998	24411734	4736	24409618
chrY:24480969-24484536	chrY	24480969	24484536	3567	24483578
chrY:24876137-24882178	chrY	24876137	24882178	6041	24878732
chrY:25110418-25116543	chrY	25110418	25116543	6125	25113000
chrY:25159937-25164695	chrY	25159937	25164695	4758	25162373
chrY:25175396-25181411	chrY	25175396	25181411	6015	25177982
chrY:25442108-25447549	chrY	25442108	25447549	5441	25444699
chrY:25601030-25606488	chrY	25601030	25606488	5458	25602861
chrY:25606487-25611449	chrY	25606487	25611449	4962	25607931
chrY:25669108-25672585	chrY	25669108	25672585	3477	25671587
chrY:25687148-25687386	chrY	25687148	25687386	238	25687287
chrY:25703764-25706505	chrY	25703764	25706505	2741	25706237
chrY:25774516-25780625	chrY	25774516	25780625	6109	25777093
chrY:25864812-25868264	chrY	25864812	25868264	3452	25867313
chrY:25907609-25913800	chrY	25907609	25913800	6191	25910248
chrY:25959476-25965462	chrY	25959476	25965462	5986	25962034
chrY:25968504-25974388	chrY	25968504	25974388	5884	25970769
chrY:26013714-26019855	chrY	26013714	26019855	6141	26016302
